--------------------------------------------------------------------------------------------------------------------------------------------------------------------------------------------------------------------------------------------------------------------------------------------------------------------------------------------------------------------------------------------------------------------------------------------------------------------------------------------------------------------------------------------------------------------------------------------------------------------------------------------------------------------------------------------------------------------------------------------------------------------------------------------------------------------------------------------------------------------------------------------------------------------------------------------------------------------------------------------------------------------------------------------------------------------------------------------------------------------------------------------------------------------------------------------------------------------------------------------------------------------------------------------------------------------------------------------------------------------------------------------------------------------------------------------------------
--------------------------------------------------------------------------------------------------------------------------------------------------------------------------------------------------------------------------------------------------------------------------------------------------------------------------------------------------------------------------------------------------------------------------------------------------------------------------------------------------------------------------------------------------------------------------------------------------------------------------------------------------------------------------------------------------------------------------------------------------------------------------------------------------------------------------------------------------------------------------------------------------------------------------------------------------------------------------------------------------------------------------------------------------------------------------------------------------------------------------------------------------------------------------------------------------------------------------------------------------------------------------------------------------------------------------------------------------------------------------------------------------------------------------------------------------------
--------------------------------------------------------------------------------------------------------------------------------------------------------------------------------------------------------------------------------------------------------------------------------------------------------------------------------------------------------------------------------------------------------------------------------------------------------------------------------------------------------------------------------------------------------------------------------------------------------------------------------------------------------------------------------------------------------------------------------------------------------------------------------------------------------------------------------------------------------------------------------------------------------------------------------------------------------------------------------------------------------------------------------------------------------------------------------------------------------------------------------------------------------------------------------------------------------------------------------------------------------------------------------------------------------------------------------------------------------------------------------------------------------------------------------------------------------
--------------------------------------------------------------------------------------------------------------------------------------------------------------------------------------------------------------------------------------------------------------------------------------------------------------------------------------------------------------------------------------------------------------------------------------------------------------------------------------------------------------------------------------------------------------------------------------------------------------------------------------------------------------------------------------------------------------------------------------------------------------------------------------------------------------------------------------------------------------------------------------------------------------------------------------------------------------------------------------------------------------------------------------------------------------------------------------------------------------------------------------------------------------------------------------------------------------------------------------------------------------------------------------------------------------------------------------------------------------------------------------------------------------------------------------------------------
---------------------------------------------------------o----------------------------------------------------------------------Xooo-----------------------oooooo---------------------------------------------------Xoooo----------------------oooooo---------------------------------------------------Xoooo----------------------oooooo---------------------------------------------------Xoo-------------------------Xoooo--------------------------------------------------oooooo--------------------------------------------------------------------------------------------------------------------------------------------------------------------------------------------------------------------------oooooo----------------------oooooo--------------------------------------------------oooooo----------------------oooooo------------------------------------oo-------------------------------------------------------------------------------------------------Xoooo-----------------------ooooo----------------------------------------------------oooo------------------------oooo---------------------------------------------------Xoo-------------------------ooooo----------------------------o----------------------ooooo----------------------oooooo-----------------------ooooo---------------------------------------------------ooooo------------------------oooo---------------------------------------------------Xoooo-------
------SSS-----------XXX-------------------XXX-------------------------XXX-----------S-----SS-------------X--------------------XXXXX-----------------------XXXXXXX-------SSS---SSS-----------XXX------------------XXXXXXXX--------------------XXXXXXX--------SSS---SSS--------------------------------XXXXXXXX--------------------XXXXXXX--------SSS---SSS-----------XX-------------------XXXX-------------------------XXXXXXX-------SSS---SSS-----------XXX------------------XXXXXX---------------SS------------XXX-----------------------------------------------XXX-----------------SS------------XXX-------------------XXX-------------------------XXX-----------------SSS-----------XXX------------------XXXXXXXX--------------------XXXXXX-X-------SSS---SSS-----------XXX-------------------XXXXXXX---------------------XXXXXX--------SSS---SS------------XXX-------------------XXX---------------------------------------SSS---SS------------XXX-----SS-----------XXXXX----------S--------------XXXXX--------SS--------------------------SQS----------X---X--------------------XXXXX----X--------SSS---SSS-------------------SSS-----------XXX-----------SS-------------XXXXX--------SSS---SSS-----------XXX--------------------XXXXX----------------------XXXXXX---------------------o--XXXX--------SSS----------------------------------------XXXXX-------------------XXX---XXX--------SSS----S------------XX------S-------------XXXXX---------
----------------------------------------------------------------------------------------------------------------------------------------------------------------------------------------------------------------------------------------------------------E-------------------------o-----------------------------------------------------------------------------------o---------------------------E---------------------------E---------------------------------------------------------------------------------------------------------------------------------------------------------------------------------------------------------------------------------------------------------------------------------------------------------------------E-------------------------o-----------------------------E---------------------------E-------------------------o------------------------------------------------------------------------------------------------------o------------------------------------E-------------------E-------E------------------oo--------------------------oo----o------------------------------E---------------------------E---------------------------E---------------------------E------------------------E--E-------------------------------------------------------E---------------------------o------------------o-----E--E------------------o------------------------------------o---------------------------E---
----------------------------------------------------------------------------------------------------------X-----------------------------XXX-------------------------X-------------------------X----------------------------XXXXX---------------<>----XXXXXXX----------------------XXXX------------------E------XXXX----------------------XXXXXXX----------------------XXXX------------------------XXXXXX----------------------XXXXXX----------------------------------------------------XXX---------------------------------------------------------------------------------------------------------------------------------------------------------------------X-------------------------------------------------------XXX-------------------------XXX-----------------------X---------------------------XXXXX-------------------------XXXX----------------------XXXX--------------------------------------------------------o--------------------------------------------------XXXXXXX--------------------XXXXXXXX--------------------XXXXXXXX--------------------XXXXXXXX--------------------XXXXXXXX---------------------XXXXX----------------------XXXXXXXX--------------------XXXXXXXX----------------------XXXX----------------------XXXXXXXX---------------------XXXXXXX--------------------XXXXXXXX---------------------XXXXX----------------------XXXXXXXX--------------------XXXXXXXX----------------------XXXX-----------------<>----XXXXXXX
---oo----------------------------E---------------------------E-------------------------oo----------------------------E---------------------------E-------------------------oo--------------------------------------------------------E---------[]--------------ooo---------------------------E-----------------------------------------------------o-----------------------------E---------------------------E-------------------------oo----------------------------E----------E--------------oo--------------------------oo----------------------------E-------------------------oo----------------------------E-----------------------------------------------------oo----------------------------E---------------------------E-------------------------oo----------------------------E---------------------------E-------------------------oo-----------------------------------------------------------------------------XX---oo--------------------------------------------------------E--------------------------------------o----------------------------------------------------------------------o-----------------------------E-----------------------------------------------------oo------------------------------------------------------------------------------------E-------------------------oo----------------------------------------------------------------------------------------------------------------E---------[]-----------
----------------XXXX--XXXX------<>---------XXXXXXX-XX-------<>---------XXXXXXX-----------------oo---XXXX---XXX------<>---------XXXXXXX----------<>---------XXXXXXX-----------------oo---XXXX---XXX------<>-----oo--XXXXXX-----------<>-----Xo--XXXXXX------------------oo---XXXX------------<>-----oo--XXXXXX-----------------XXX--XXXXXX-----------------ooo---XXXX------------<>-----oo--XXXXXX-----------<>-----oo--XXXXXX-----------------ooo---XXXX---XXX------<>---------XXXXXXX----------------------XXXXX-XXXXXX----------------XXXXX--XXX------<>---------XXXXXXX-X--------------------XXXX--XXXX-X----<>---------XXXXXXX---------------------XXXXXXX------------------o---XXXX--XXXX-X----<>---------XXXXXXX----------<>---------XXXXXXX-----------------oo---XXXX---XX-------<>-----o---XXXXXX-----------<>-----X---XXXXXXX----------------ooo---XXXX---XXX-------------X---XXXXXXX-XXX----X-----------E-----------------------ooo---XXXX---XX-------------Xoo--XXXXX------------<>-----oo--XXXXX------------------ooo--XXXXX------------------XXX--XXXXX-------------------X-XXXXXX-------------------ooo---XXXX------------<>----ooo--XXXXX------------<>-----oo--XXXXX------------------ooo---XXXX------------------Xoo--XXXXX-----------------XXXXX-XXXXXX-----------<>-----oo--XXXXX------------------ooo---XXXX------------------Xoo--XXXXX-------------------oo--XXXXX------------------ooo---XXXX------------<>-----oo--XXXXXX-------
-------------XXX----------------[]-------XX-----------------[]-----------------------------------XX-----------------[]--------------------------[]----------------------------------E-------------------[]--------------------------[]----------------------------------E-------------------[]---------------------------E----------------------------------E-------------------[]--------------------------[]----------------------------------E-------------------[]----------------------------------XXX-----------------------XXXXXX----------------[]---XX--XX-------------------------XXXX----------------[]---XX--XX------------------E------------------------------------------------------[]--------------------------[]----------------------------------E-------------------[]--------------------------[]----------------------------------E--------------------E---XXXXXXX--------------X--------XXXXXX--------------------------------------------E---------------o----------[]---------------o-----------E------E--------------------E--------------------------------------------------------------E-------------------[]------E-------------------[]----------------------------------E--------------------E---------------o-----------E---------------o----------[]----------------------------------E-----------------------------------------------------------------------------------E-------------------[]----------------------
-------------XX-----------------[]--XXX--X------------------[]--XXX------------X---------------XXXX-----------------[]-----XXX--------XXXX------[]----------------XXXX------------XXXXXX----------------[]-----XXX-------XXXXX------[]------XX------XXXXX-------------XXXXXX-------X--------[]-----XXXX------XXXXX------<>--------------XXXXXX------------XXXXXX-----XXX--------[]-----XXXX------XXXXX------[]-----XXX--------XXX-------------XXXXXX----------------[]------XX-------XXXXX-------------X-------------------------XXXX-------------------[]--XXXX---------------------------X--------------------[]--XXXX--------------------<>-------X-------------------------XXXX-----------------[]-------X--------XXXX------[]---------------XXXXX------------XXXXXX----------------[]-----XXX-------XXXXX------[]---------------XXXXX------------XXXXXX----------------<>--XXXX------------------X-----------------------------------XXXXXX----------------<>-----XXX------XXXXXX------[]-----XXX------XXXXXX------<>----XXXXX------XXXXX------<>-------X----XXXXXXXX------<>------------XXXXXXXX------------XXXXXX-----XXX--------[]----XXXXX------XXXXX------[]----XXXX------XXXXXX------------XXXXXX------XX--------<>-----XXX------XXXXXX------<>-------------XXXXXXX------[]-----XXX------XXXXXX------------XXXXXX-------X--------<>-----XXX------XXXXXX--------------XX----XXXXXXXX------------XXXXX--------X--------[]-----XXX-------XXXXX--
--------------------------------[]-XXXX---------------------[]-XXXX-------------------------------------------------[]--------------------------[]------------------------------------------------------[]--------------------------[]------------------------------------------------------[]--------------------------[]--------------------------XX--------------------------[]--------------------------[]------------------------------------------------------[]---------------------------------X-----------------------XXXXX--------------------[]-XXXXX------------------------------------------------[]-XXXXX--------------------[]---XX-------------------------------------------------[]--------------------------[]------------------------------------------------------[]--------------------------[]------------------------------------------------------[]-XXXXX------------------X--------------------E-E----------------------------------[]--------------------------[]--------------------------[]--------------------------[]--------------------------[]------------------------------------------------------[]--------------------------[]------------------------------------------------------[]--------------------------[]--------------------------[]------------------------------------------------------[]----------------------------------------------------------------------------------[]----------------------
XXXXXXXXXX------------------XXXXXXXXXXX-----------------XXXXXXXXXXX-----------------XXXXXXXXXX------------------XXXXXXXXXXX-----------------XXXXXXXXXXX-----------------XXXXXXXXX-------------------XXXXXXXXX-------------------XXXXXXXXXXX-----------------XXXXXXXXX-------------------XXXXXXXXXX------------------XXXXXXXXX-------------------XXXXX-X---------------------XXXXXXXXXX------------------XXXXXXXXXX------------------XXXXXXXX--------------------XXXXXXXXXXX-----------------XXXXXXXXXXX-----------------XXXXXXXXXXX-----------------XXXXXXXXXXX-----------------XXXXXXXXXXX-----------------XXXXXXXXXXX-----------------XXXXXXXXXX------------------XXXXXXXXXX------------------XXXXXXXXXXX-----------------XXXXXXXXXXX-----------------XXXXXXXXX-------------------XXXXXXXXXX------------------XXXXXXXXXXX-----------------XXXXXXXXX-------------------XXXXXXXXXXX-----------------XXX--XXXXXX----------XXXXXXXXXXX--XX--------------------XXXXXXXX--------------------XXXXXXXXXX------------------XXXXXXXX--------------------XXXXXXXX--------------------XXXXXX----------------------XXXXXXXX--------------------XXXXXXXXXX------------------XXXXXXXXX-------------------XXXXXXXXX-------------------XXXXXXXXX-------------------XXXXXXXXX-------------------XXXXXXXXX-------------------XXXXXXXXX-------------------XXXXXXXX--------------------XXXXXX----------------------XXXXXXXX--------------------XXXXXXXXXX------------------
