--------------------------------------------------------------------------------------------------------------------------------------------------------------------------------------------------------------------------------------------------------------------------------------------------------------------------------------------------------------------------------------------------------------------------------------------------------------------------------------------------------------------------------------------------------------------------------------------------------------------------------------------------------------------------------------------------------------------------------------------------------------------------------------------------------------------------------------------------------------------------------------------------------------------------------------------------------------------------------------------------------------------------------------------------------------------------------------------------------------------------------------------------------------------------------------------------------------------------------------------------------------------------------------------------------------------------------------------------------------------------------------------------------------------------------------------------------
--------------------------------------------------------------------------------------------------------------------------------------------------------------------------------------------------------------------------------------------------------------------------------------------------------------------------------------------------------------------------------------------------------------------------------------------------------------------------------------------------------------------------------------------------------------------------------------------------------------------------------------------------------------------------------------------------------------------------------------------------------------------------------------------------------------------------------------------------------------------------------------------------------------------------------------------------------------------------------------------------------------------------------------------------------------------------------------------------------------------------------------------------------------------------------------------------------------------------------------------------------------------------------------------------------------------------------------------------------------------------------------------------------------------------------------------------------
--------------------------------------------------------------------------------------------------------------------------------------------------------------------------------------------------------------------------------------------------------------------------------------------------------------------------------------------------------------------------------------------------------------------------------------------------------------------------------------------------------------------------------------------------------------------------------------------------------------------------------------------------------------------------------------------------------------------------------------------------------------------------------------------------------------------------------------------------------------------------------------------------------------------------------------------------------------------------------------------------------------------------------------------------------------------------------------------------------------------------------------------------------------------------------------------------------------------------------------------------------------------------------------------------------------------------------------------------------------------------------------------------------------------------------------------------------
--------------------------------------------------------------------------------------------------------------------------------------------------------------------------------------------------------------------------------------------------------------------------------------------------------------------------------------------------------------------------------------------------------------------------------------------------------------------------------------------------------------------------------------------------------------------------------------------------------------------------------------------------------------------------------------------------------------------------------------------------------------------------------------------------------------------------------------------------------------------------------------------------------------------------------------------------------------------------------------------------------------------------------------------------------------------------------------------------------------------------------------------------------------------------------------------------------------------------------------------------------------------------------------------------------------------------------------------------------------------------------------------------------------------------------------------------------
---------------------------------------------------------o-------------ooo------------------------------------------------------Xoo------------------------oooooo---------------------------------------------------Xooo------------------------Xoooo----------------------------o---------------------oooooo----------------------Eooooo---------------------------------------------------Xoooo----------------------oooooo--------------------------------------------------oooooo-----------------------Xoooo----------------------------------------------------------------o---------------------------------------------------------------------oooooo----------------------ooooo----------------------------------------------------ooooo----------------------oooooo---------------------------------------------------Xoooo----------------------oooooo----------------------------------------------------------------------------------------------------------------------------------------oooo-----------------------Xoooo--------------------------------------------------Eooooo---------------------------------------------------ooooo------------------------Eooo---------------------------------------------------ooooo------------------------oooo---------------------------------------------------Xoooo-----------------------ooooo-----------------------ooooo---o-----------------------------------------------Xoooo-------
-------S------------XXX-------------------XXX------------------------XXXXX----------S-----SSS-----------XXX-------------------XXXXX-----------------------XXXXXX--------SSS---SSS-----------XXX------------------XXXXX------------------------XXXXXX--------SSS---SSS-----------XXX------------------XXXXXXX----------------------XXXXXX--------SSS---SSS-----------XXX-------------------XXXXX------------------------XXXXX--------SSS---SS---------------------------------XXXXXXXX---------------------XXX-----------------SS------------XXX-------------------XXX-------------------------XXX-----------------SS------------XXX-------------------XXXXX-----------------------XXXXX---------SS----SSS-----------XXX-------------------XXXXX----------------------XXXXXXX--------SSS---SS------------XX-------------------XXXXXXXX--------------------XXXXXXX--------SSS---SSS-----------?X----------------------------------S-----SSS-------------------SSS--------------------------------------------------------------------XXXX---------SSS---------------------------------------XXXXXX--------SSS-------------------------------------XX---XXX---------------------o--------------SSS---SS----------------------------------XXXXXX-------------------XXo--------------SSS-------------------------S-------------XXXXX---------SS--------------XXXX--------SS--------XXX----XXXX-------SSS-------------------------SSS------------XXXXX--------
----------------------------------------------------------------------------------------------------------------------------------------------------------------------E-------------------------------------------------------------------------------------------------------------------------------------------E-----------------------------------------------------o-----------------------------E---------------------------E-------------------------E-----------------------------------------------------------------------------------------------------------------------------------------------------------------------------------------------------------------------------------------------------------------------------------------E---------------------------E-------------------------o---------------------------E-----------------------------E-------------------------------------------------------------------------------------------------------------E------------------o------------------------------------E---------------------------E-------------------------------------------------------o------------------oo----o---------------------oo-----------------------------------E---------------------------E------------------oo----o--E---------------------------E---------------------------E------------------------E--E-------------------------------------------------------E---------------------------E---
----------------------------------------------------------------------------------------------------------------------------------------X---------------------------XXX-----------------------X---------------------------XXXXX-----------------------XXXXXX----------------------XXXX------------------E----XXXXXXX---------------------XXXXXXX----------------------X-XX------------------------XXXXX----------------------XX-XXXX---------------------XXXXX--------------------------XXX-------------------------XXX---------------------------------------------------------------------------------------------------------------------------------------------------------------------------------------------------------------------------XXXXX-----------------E------XXXXX----------------------X-XX-----------------------XXXXXXX---------------------XXXXXXX----------------------X----------------------------------------------------------------------------------XXXXXX---------------------XXXXXXXX--------------------XXXXXXXX--------------------XXXXXXXX--------------------XXXXXXXX----------------------XXXX----------------------XXXXXXXX---------------------XXXXXXX---------------------XXXXX----------------------XXXXXXXX--------------------XXXXXXXX--------------------XXXXXXXX--------------------XXXXXXXX--------------------XXXXXXXX--------------------XXX-XXXX--------------------XXXXXXXX--------------------XXXXXXXX
---oo--------------------------------------------------------E-------------------------oo----------------------------E---------------------------E-------------------------oo----------------------------E---------------------------E-------------------------oo----------------------------E-----------------------------------------------------oo----------------------------E-----------------------------------------------------oo----------------------------E---------------------------E-------------------------oo--------------------------------------------------------E-------------------------oo----------------------------E---------------------------E-------------------------oo----------------------------E---------------------------E-------------------------oo----------------------------E---------------------------E-------------------------oo-----------------------------------------------------ooo----------------------------------------------------------------------------------------------------------------------------------------------------------------------------------------------------------------------------------------------------------------------------------------------------------------------------------------------------------------------------E--------------------------------------------------------------------------------------------------------------------------------------
----------------XXXXX-XXXX-X---------------XXXXXXX----------<>---------XXXXXXX-----------------oo---XXXX---XXX------<>---------XXXXXXX----------<>---------XXXXXXX-----------------oo---XXXX---XXX------<>-----oo--XXXXXX-----------<>-----oo--XXXXXX-----------------ooo---XXXX------------<>-----o---XXXXXX-----------<>-----oo--XXXXXX-----------------ooo---XXXX---XX-------<>-----oo--XXXXXX-----------------XXXX-XXXXXX------------------oo---XXXX------------<>---------XXXXXXX----------<>---------XXXXXXX----------------------XXXXX--XXXXX----------XX---XXXXXXX-XXX------<>---------XXXXXXX----------------------XXXXX--XXXXX----<>---------XXXXXXX----------<>---------XXXXXXX-----------------oo---XXXX---XXX------<>---------XXXXXX-----------<>-----X---XXXXXX-----------------ooo---XXXX---XX-------<>-----oo--XXXXXX-----------<>-----oo--XXXXXX------------------oo---XXXX---XX-----X-------XX----------------------------o----XX-------------------ooo---XXXX-------------------o---XXXXX------------<>----Xoo--XXXXXX-----------------ooo--XXXXX-------------E-----X---XXXXXX-----------------ooo--XXXXX------------------XXXXXXXXX--------------E-----oo--XXXXX------------------ooo---XXXX-------------E----Xoo--XXXXXX------------------o---XXXX-------------------ooo--XXXXX------------<>----ooo--XXXXXX-----------------ooo--XXXXX------------------XXo--XXXX-------------------ooo--XXXXX------------<>----ooo--XXXXX--------
-------------XX------------------E---XX--XX-----------------[]------------------------------------------------------[]--------------------------[]----------------------------------E-------------------[]--------------------------[]----------------------------------E-------------------[]--------------------------[]----------------------------------E-------------------[]---------------o-----------E----------------------------------E-------------------[]--------------------------[]-----------------------------------XX------------------E---XXXXXXX----------------[]---XX--XX--------------------------XX-----------------[]--------------------------[]------------------------------------------------------[]--------------------------[]----------------------------------E-------------------[]--------------------------[]---------------------------------------------------XX------XXXXXXXX-----------------------XX--------------------------E--------------------E--------------------------[]---------------------------E------E-------------------<>---------------o-----------E------E-----------------------------------------------<>----------------------------------E-------------------<>---------------------------E---------------------------E------E-------------------[]-----------------------------------------------------------------------------------E------E-------------------[]------E---------------
-----------XXXX-----------------<>--XXXX--------------------[]---X-------------XXX-------------XXXX-----------------[]-----XXXX-------XXXX------[]---------------XXXXX-------------XXXXX----------------[]-----XXX-------XXXXX------[]----XXXXX------XXXXX------------XXXXXX-----XXX--------[]------XX------XXXXX-------[]-----XXX------XXXXXX------------XXXXXX------XX--------[]-----XXX------XXXXXX------<>--------------XXXXXX------------XXXXXX------XX--------[]-------X--------XXXX------[]---X------------XXXX----------------------------------<>--XXXX--------------------[]--XXXX------------------------------------------------[]----------------XXXX------[]--XXX------------XXX-------------XXXXX----------------[]------XX-------XXXX-------[]-------X-------XXXXX------------XXXXXX----------------[]----XXXXX------XXXXX------[]-----XXX------XXXXXX-------------XXXXX-------------XXX----XXXXX--------------------------XXXX-----------------<>----XXXXX-----XXXXXX------<>------XX----XXXXXXXX------[]-----XXX------XXXXXX------<>---XXXXXX--------XXX------[]------XX------XXXXXX------<>----XXXXX------XXXXX------<>------------XXXXXXXX------[]----XXXX------XXXXXX------------XXXXXX-----XXX--------[]-----XXX------XXXXXX------<>-----XXX----XXXXXXXX------<>----XXXXX-------XXXX------[]----XXXXX-----XXXXXX------<>----XXXX-----XXXXXXX--------------XX------XXXXXX------<>----XXXXX-----XXXXX-------[]----XXXXX------XXXXX--
--------------------------------[]-XXXXX--------------------[]--XXX-------------------------------------------------[]--------------------------[]------------------------------------------------------[]--------------------------[]------------------------------------------------------[]--------------------------[]------------------------------------------------------[]--------------------------[]------------------------------------------------------[]--------------------------[]--XXX-------------------------------------------------[]-XXXXX--------------------[]-XXXXX------------------------------------------------[]--XX----------------------[]--XXX-------------------------------------------------[]--------------------------[]------------------------------------------------------[]--------------------------[]---------------------------------------------------XX----XXXXX-----------E-E----------------------------------[]--------------------------[]--------------------------[]--------------------------[]--------------------------[]--------------------------[]--------------------------[]--------------------------[]------------------------------------------------------[]--------------------------[]--------------------------[]--------------------------[]--------------------------[]------------------------------------------------------[]--------------------------[]----------------------
XXXXXXXXXXX-----------------XXXXXXXXXXX-----------------XXXXXXXXXXX-----------------XXXXXXXXXX------------------XXXXXXXXXX------------------XXXXXXXXXXX-----------------XXXXXXXXXX------------------XXXXXXXXXX------------------XXXXXXXXXX------------------XXXX--X---------------------XXXXXXXXXX------------------XXXXXXXXX-------------------XXXXXXXX--------------------XXXXXXXXX-------------------XXXXXXXXXX------------------XXXXXXXXX-------------------XXXXXXXXXX------------------XXXXXXXXXXX-----------------XXXXXXXXXXX-----------------XXXXXXXXXXX-----------------XXXXXXXXXXX-----------------XXXXXXXXXXX-----------------XXXXXXXXXXX-----------------XXXXXXXXXXX-----------------XXXXXXXXXX------------------XXXXXXXXXXX-----------------XXXXXXXXXXX-----------------XXXXXXXXX-------------------XXXXXXXXX-------------------XXXXXXXXXXX-----------------XXXXXXXXX-------------------XXXX-XXXXXX----------XXXXXXXXXXXXXXXXX----------------XXXXXXXXXXX-------------------XXXXXXXXX-------------------XXXXXXXXX-------------------XXXXXXXX--------------------XXXXXXXXX-------------------XXXXXXXX--------------------XXXXXX----------------------XXXXXXXXX-------------------XXXXXXXX--------------------XXXXXXXXX-------------------XXXXXXXX--------------------XXXXXXXXX-------------------XXXXXXXXX-------------------XXXXXXX---------------------XXXXXX----------------------XXXXXXXXX-------------------XXXXXXXXX-------------------
