--------------------------------------------------------------------------------------------------------------------------------------------------------------------------------------------------------------------------------------------------------------------------------------------------------------------------------------------------------------------------------------------------------------------------------------------------------------------------------------------------------------------------------------------------------------------------------------------------------------------------------------------------------------------------------------------------------------------------------------------------------------------------------------------------------------------------------------------------------------------------------------------------------------------------------------------------------------------------------------------------------------------------------------------------------------------------------------------------------------------------------------------------------------------------------------------------------------------------------------------------------------------------------------------------------------------------------------------------------------------------------------------------------------------------------------------------------
--------------------------------------------------------------------------------------------------------------------------------------------------------------------------------------------------------------------------------------------------------------------------------------------------------------------------------------------------------------------------------------------------------------------------------------------------------------------------------------------------------------------------------------------------------------------------------------------------------------------------------------------------------------------------------------------------------------------------------------------------------------------------------------------------------------------------------------------------------------------------------------------------------------------------------------------------------------------------------------------------------------------------------------------------------------------------------------------------------------------------------------------------------------------------------------------------------------------------------------------------------------------------------------------------------------------------------------------------------------------------------------------------------------------------------------------------------
-------------------------------------------------------------------------------------------------------------------------------------------------------------------------------------------------------------------------------------------------------------------------------------------------------------------------------------------------------------------------------------------------------------------------------------------------------------------------------------------------------------------------------------------------------------------------------------------------------------------------------------------------------------------------------------------------------------------------------------------------------------------------------------------------------------------------------------------------------------------oo-----------------------------------------------------------------------------------------------------------------------------------------------------------------------------------------------------------------------------------------------------------------------------------------------------------------------------------------------------------------------------------------------------------------------------------------------------------------------------------------------------------------------------------------------------------------------------------
-------------------------------------------------------------------------------------------------------------------------------------------------------------------------------------------------------------------------------------------------------------------------------------------------------------------------------------------------------------------------------------------------------------------------------------------------------------------------------------------------------------------------------------------------------------------------------------------------------------------------------------------------------------------------------------------------------------------------------------------------------------------------------------------------------------------------------------------------------------------XX-----------------------------------------------------------------------------------------------------------------------------------------------------------------------------------------------------------------------------------------------------------------------------------------------------------------------------------------------------------------------------------------------------------------------------------------------------------------------------------------------------------------------------------------------------------------------------------
---------------------------------------------------------oo------------ooo-----------------------------------------------------oooooo----------------------oooooo--------------------------------------------------oooooo----------------------oooooo---------------------------------------------------ooooo-----------------------Xoooo----------------------------o----------------------ooooo----------------------oooooo---------------------------------------------------Xoooo--------------------------------------------------------------------------------------------oo-------------------------------------------------------------------------------------------------oo-----------------------------------------------------ooooo-----------------------oooooo--------------------------------------------------oooooo----------------------oooooo--------------------------------------------------------------------------------------------------------------------------------------oooooo-----------------------ooooo---------------------------------------------------ooooo------------------------oooo---------------------------------------------------Xoooo-----------------------ooooo--------------------------oo---o-----------------------------------------------Xoo-o-----------------------ooooo-----------------------ooooo---o---------------------------------------------------------------------------ooooo-------
------SS------------XXX-------------------------XXX-------------------XXXX----------SS----SSS-----------XX-------------------XXXXXX-----------------------XXXXXXX-------SSS---SSS-----------XXX-------------------XXXXXX----------------------XXXXX---------SSS---SS------------XXX-------------------XXXXXXX-------S------------XXXXXXX--------SSS---SSS-----------XXX--------------------XXXXXX--------------------XXXXXXX--------SSS---SS------------XXX-------------------XXXXXXX-------S-----SS----------------------------------XXX-----------------SSS-----------XXX-------------------XXX-----------------SS------------XXX-------------------XXX-------------------------XXXX----------S-----SS------------XX-------------------XXXXXXX----------------------XXXXXX--------SSS---SSS-----------XXX-------------------XXXXXX----------------------XXXXXXX-------SSS---SSS-----------XXX---------------------------------SSS---SS------------??------SSS---------------------------------------XXXXXX---------------------o----X---------SSS---SS-------------X---------------------XXXXX--------SS---------------XXX--------SSS-------------------------SS-------------XXXX-------------------X----XXXXX--------S-----------Xo--------------SSS---SSS------------X------S------------XXXXXX----------------------XXXXXX---------------------Xo---XXX--------SSS---SSS-----------XX------SS---------------------------------------XXXXXX---------
----------------------------------------------------------------------------------------------------------------------------------------------------------------------E-------------------------------------------------------E---------------------------E-------------------------o---------------------------E---------------------------E---------------------------E---------------------------E-E-----------------E---------E-----------------------------------------------------E-----------------------------------------------------------------------------------------------------------------------------------------------------------------------------------------------------------------------------------------------------------------------------------------E-------------------------------------------------------E---------------------------E-------------------------------------------------------------------------------------------------------------E-----------------------------E----------------oo-----------------------------------o---------------------------E-------------------------------------------------------o---------------------------E----------------------------------------------oo-----------------------------------o---------------------------E-----------------------------E----------------oo----o------------------------------E---------------------------E-------------------------------
----------------------------------------------------------------------------------------------------------X-----------------------------XXX-------------------------XXX-----------------------X-----------------------------XXX-------------------------XXX-----------------------X-------------------------XXXXXXXX---------------<>---XXXXXXXX----------------------XXXX------------------E---XXXXXXXX----------------------XXXXXX----------------------X---------------------------XXXXXX--------------------------------------------------------------------------------------------------------------------------------------------------------------------------------------------------------------------------------------------------------XX--------------------------XXX-----------------------X---------------------------XXXXXX---------------------XXXXXXX------------------------------XX------------------------------------------------------------------------XXXXXXXX--------------------XXXXXXXX--------------------XXXXXXXX---------------------XXXXX----------------------XXXXXXXX--------------------XXXXXXXX---------------------XXXXX-----------------------XXXXXXX--------------------XXXXXXXX---------------------XX--XXX----------------------XXXX-----------------------XXXXXXX---------------<>---XXXXXXXX--------------------XXX-XXXX----------------------XXXX----------------------XXXXXXXX---------------<>----XXXXXXX
---oo--------------------------------------------------------E-------------------------oo----------------------------E---------------------------E-------------------------oo----------------------------E---------------------------E-------------------------oo--------------------------------------------------------E---------[]--------------oo----------------------------E---------------------------E-------------------------------------------------------E-------------------------oo------------------------------------------------------oo----------------------------E-------------------------oo----------------------------E---------------------------E-------------------------ooo---------------------------E---------------------------E-------------------------oo----------------------------E---------------------------E-------------------------oo-------------------------XX---------------------------oo----------------------------------------------------------------------------------------------------------------------------------------------------------------------------------------------------------------------------------------------------------------------------------------------------------------------------------------------------------------------------E---------[]----------------------------------------------------------------------------------------------------E---------[]-----------
----------------XXXX--XXXX-----------------XXXXXX-XXXX------<>---------XXXXXXX-----------------oo---XXXX---XXX------<>---------XXXXXXX----------<>---------XXXXXXX-----------------oo---XXXX---XXX------<>---------XXXXXXX----------<>---------XXXXXX------------------oo---XXXX---XX-------<>-----oo--XXXXXX-----------<>-----oo--XXXXX-------------------oo---XXXX------------<>-----oo--XXXXXX-----------<>----XXX--XXXXXX-----------------ooo---XXXX---XX-------<>-----oo--XXXXXX------------------oo---XXXX---XXX-------E---------XXXXXXX----------------------XXXXX-XXXXXX----<>----XX---XXXXXXX----------------------XXXXX-XXXXXX----<>---------XXXXXXX-XX-------<>---------XXXXXXX-----------------oo---XXXX---XXX------<>---------XXXXXXX----------<>---------XXXXXXX-----------------oo---XXXX---XXX------<>---------XXXXXX-----------<>---------XXXXXX------------------oo---XXXX---XXX---XXX----------E-------------------------o---XXXX---XXX------------ooo--XXXXX------------------XXX--XXXXXX-----------------XXX--XXXXX------------------ooo---XXXX-------------------oo--XXXXX------------------XXo--XXXXX------------------ooo---XXXX------------------ooo--XXXXXX----------------XXXXX-XXXXX-------------------X-X-XXXX-------------------ooo---XXXX------------------ooo--XXXXXX-----------<>----XXX--XXXXX-------------------XXXXXXX--------------------ooo---XXXX------------------ooo--XXXXX------------<>----XXX--XXXXXX-------
------------XXX------------------E---XX--XX-----------------[]----------------------------------E-------------------[]--------------------------[]------------------------------------------------------[]--------------------------[]----------------------------------E-------------------[]--------------------------[]----------------------------------E-------------------[]--------------------------[]------------------------------------------------------[]-----------------------------------XX-----------------<>---XX--XX--------------------------XX-----------------[]---XXX-XXX-------------------------XX-----------------[]---XX--XX-----------------[]----------------------E------------XX-----------------[]--------------------------[]----------------------------------E-------------------[]--------------------------[]---------------------------------------------------XXX------EXXXXXX-----------E-----------XXX-------------------------E-------------------<>---------------o-----------E---------------o------------------E-------------------<>---------------------------E----------------------------------E--------------------E------E--------------------E---------------o----------------------------------------------E-------------------<>------E-------------------[]--------------------------------------------------------------E---------------------------E-------------------[]----------------------
-----------X-XX-----------------<>--XXXX-X------------------[]---X-------------XXX-------------XXXXX----------------[]----------------XXXX------[]-----XXX--------XXXX------------XXXXXX----------------[]-------X--------XXXX------[]------XX-------XXXXX------------XXXXXX----------------[]-----XXXX-----XXXXXX------[]-----XXX------XXXXX-------------XXXXXX-----XXX--------[]-----XXX------XXXXX-------[]--------------XXXXXX------------XXXXXX----------------[]-----XXXX-------XXXX-------------XXXX-----------------[]--XXXX---------------------------X-XX-----------------[]--XXXX---------------------------X-XX-----------------[]--XXXX--------------------[]----------------XXXX-------------XXXX-----------------[]-------X---------X--------[]---------------XXXXX-------------XXXXX----------------[]--------------XXXXXX------[]--------------XXXXXX-------------XXXXX------------XXXX-------------------------------------X------------------<>----XXXXX------XXXX-------[]-------X------XXXXXX------<>-------------XXXXXX-------------XXXXXX------XX--------[]-----XXX------XXXXXX------<>-----XXX-----XXXXXXX------------XXXXX-----------------<>----XXXXX------XXXXX------<>-------------XXXXXXX------<>------------XXXXXXX-------------XXXXXX----------------[]----XXXXX------XXXXX------[]------XX------XXXXX---------------------XXXXXXXX------------XXXXXX-----XXX--------<>----XXXXX------XXXX-------[]-----XXX------XXXXX---
--------------------------------[]-XXXXX--------------------[]--XXX-------------------------------------------------[]--------------------------[]------------------------------------------------------[]--------------------------[]------------------------------------------------------[]--------------------------[]------------------------------------------------------[]--------------------------[]------------------------------------------------------[]------------------------------------------------------[]-XXXXX------------------------------------------------[]-XXXXX------------------------------------------------[]-XXXXX--------------------[]------------------------------------------------------[]---X------------------E---[]------------------------------------------------------[]--------------------------[]---------------------------------------------------XXX------X-------------EE----------------------------------[]--------------------------[]--------------------------[]------------------------------------------------------[]--------------------------[]------------------------------------------------------[]--------------------------[]--------------------------[]------------------------------------------------------[]--------------------------[]----------------------------------------------------------------------------------[]--------------------------[]----------------------
XXXXXXXXXXX-----------------XXXXXXXXXXX-----------------XXXXXXXXXXX-----------------XXXXXXXXXX------------------XXXXXXXXXXX-----------------XXXXXXXXXX------------------XXXXXXXXX-------------------XXXXXXXXXXX-----------------XXXXXXXXXXX-----------------XXXXXXXXX-------------------XXXXXXXXX-------------------XXXXXXXXXXX-----------------XXXXXXXXX-------------------XXXXXXXXXX------------------XXXXXXXXXX------------------XXXXXXXX--------------------XXXXXXXXXXX-----------------XXXXXXXXXX------------------XXXXXXXXXXX-----------------XXXXXXXXXXX-----------------XXXXXXXXXXX-----------------XXXXXXXXXXX-----------------XXXXXXXXXXX-----------------XXXXXXXXXXX-----------------XXXXXXXXXX------------------XXXXXXXXXXX-----------------XXXXXXXXXXX-----------------XXXXXXXXXX------------------XXXXXXXXXXX-----------------XXXXXXXXXXX-----------------XXXXXXXXXX------------------XXX--XXXXXX----------XXXXXXXXXXXXXXXXX------------------XXXXXXXX--------------------XXXXXXXXX-------------------XXXXXXXXX-------------------XXXXXXXX--------------------XXXXXXXXX-------------------XXXXXXXX--------------------XXXXXXXXX-------------------XXXXXXXXX-------------------XXXXXXX---------------------XXXXXX----------------------XXXXXXXX--------------------XXXXXXXXX-------------------XXXXXXXXXX------------------XXXXXX----------------------XXXXXXX---------------------XXXXXXXX--------------------XXXXXXXXXX------------------
