--------------------------------------------------------------------------------------------------------------------------------------------------------------------------------------------------------------------------------------------------------------------------------------------------------------------------------------------------------------------------------------------------------------------------------------------------------------------------------------------------------------------------------------------------------------------------------------------------------------------------------------------------------------------------------------------------------------------------------------------------------------------------------------------------------------------------------------------------------------------------------------------------------------------------------------------------------------------------------------------------------------------------------------------------------------------------------------------------------------------------------------------------------------------------------------------------------------------------------------------------------------------------------------------------------------------------------------------------------------------------------------------------------------------------------------------------------
--------------------------------------------------------------------------------------------------------------------------------------------------------------------------------------------------------------------------------------------------------------------------------------------------------------------------------------------------------------------------------------------------------------------------------------------------------------------------------------------------------------------------------------------------------------------------------------------------------------------------------------------------------------------------------------------------------------------------------------------------------------------------------------------------------------------------------------------------------------------------------------------------------------------------------------------------------------------------------------------------------------------------------------------------------------------------------------------------------------------------------------------------------------------------------------------------------------------------------------------------------------------------------------------------------------------------------------------------------------------------------------------------------------------------------------------------------
---------------------------------------------------------------------------------------------------------------------------------------------------------------------------------------------------------------------------------------------------------------------------------------------------------------------------------------------------------------------------------------------------------------------------------------------------------------------------------------------------------------------------------------------------------------------------------------------------------------------------------------------------------------------------------------------------------------------------------------------------------------------------------------------------------------------------------------oo---------------------------------------------------------------------------------------------------------------------------------------------------------------------------------------------------------------------------------------------------------------------------------------------------------------------------------------------------------------------------------------------------------------------------------------------------------------------------------------------------------------------------------------------------------------------------------------------------------------
--------------------------------------------------------------------------------------------------------------------------------------------------------------------------------------------------------------------------------------------------------------------------------------------------------------------------------------------------------------------------------------------------------------------------------------------------------------------------------------------------------------------------------------------------------------------------------------------------------------------------------------------------------------------------------------------------------------------------------------------------------------------------------------------------------------------------------------------------------------------------------------------------------------------------------------------------------------------------------------------------------------------------------------------------------------------------------------------------------------------------------------------------------------------------------------------------------------------------------------------------------------------------------------------------------------------------------------------------------------------------------------------------------------------------------------------------------
------------------------------------------------------------------------oooo----------------------------------------------------Xo-------------------------oooooo--------------------------------------------------oooooo----------------------oooooo---------------------------------------------------Xoooo-----------------------Xoooo---------------------------------------------------Xoooo----------------------oooooo--------------------------------------------------oooooo--------o-------------oooooo---------------------------------------------------------------------------------------------------------------------------------------X------------o--------------Xoo---------------------------------------------------Eoooooo----------------------oooooo--------------------------------------------------oooooo---------------------Eoooooo-------------------------------------------------------------------------------Xoooo-----------------------ooooo---------------------------------------------------Xoooo------------------------oo--------------------------oooo------------------------oo-o-----------------------ooooo------------------------oooo---------------------------------------------------ooooo------------------------oooo----------------------------o----------------------Xoooo-----------------------ooooo------------------------oo----------------------------------------------------oooooo-------
------SSS-----------XXX-------------------XXX-------------------------XXX-----------SSS--SSSS-----------XXX------------------XXXX------------------------XXXXXXXX-------SSS---SS-------------X--------------------XXXXX-----------------------XXXXXX--------SSS---SS-------------X-------------------XXXXX------------------------XXXXXXX-------SSS---SS---------------------------------XXXXXXX---------------------XXXXXXXX-------SSS---SSS-----------XXX------------------XXXXXXXX--------------------XXXXXXXX-------------SS------------XXX-------------------XXX---------------------------------------------SSS-----------XXX------------------XXXX------------------------XXXXXX---------SSS---SS------------?X-------------------XXXXXXXX---------------------XXXXX---------SSS---SSS-----------XXX-------------------XXXXXXX--------------------XXXXXXXX--------------S----------------ooo-SSS---SS------------XX------SSS------------XXXX----------------------XXXXXX---------SSS---SSS------------------------------------XX---------SS-----------X--------------SS--------------X-----------SSS----------------XX--------------------XXXXXXX---------------------o--------------SSS----S--------------------S------------o---XXX--------S----------XXX---XXX--------SS----SSS-----------XXX------------------XXXXXX------------------------XXXXX---------------------o--------------SSS------------------X-------------------XXXXXXX--------
----------------------------------------------------------------------------------------------------------------------------------------------------------------------E-------------------------o---------------------------------------------------------E-------------------------o-------------------E-----------------------------------E---------------------------E---------------------------E-----------------------------E-------------------------o-----------------------------------------------------------------------------------------------------------------------------------------------------------------------------------------------------------------------------------------------------------------------------------------E-----------------------------------------------------o-----------------------------E---------------------------E--------------------o------XX------------------------------------------------------------------------------------------------------------E-------------------E----E--E------------------oo-------E---------------------------E---------------------------E---------------------------E------------------oo-----------------------------------o------------------oo----E--E-------------------------------------------------------o---------------------------E-E----------------o-----o---------------------oo-------E---------------------------o---------------------------E---
----------------------------------------------------------------------------------------------------------------------------------------XXX-------------------------XXXX----------------------X-----------------------------XXX----------------------XXXXXXX----------------------XXXX------------------------XXXXXX---------------------XXXXXXX---------------------XXXXX-----------------<>----XXXXXXX----------------------XXXXXX----------------------XXXX-------------------------XXXX---------------------------------------------------------------------------------------------------------------------------------------------------------------------X-----------------------------------------------------X-----------------------------XXX-------------------------X-X-----------------------X-XX-----------------------XXXXXXX----------------X----XXXXXXX------------------XXX--------------------------------------------------------XXXXXXX--------------------XXXXXXXX---------------------XXXXX----------------------XXXXXXXX--------------------XXXXXXXX--------------------XXXXXXXX--------------------XXXXXXXX--------------------XXXXXXXX--------------------XXXXXXXX---------------------XXXXX----------------------XXXXXXXX---------------------XX-XXXX----------------------XXXX-----------------<>---XXXXXXXX--------------------XXXXXXXX--------------------XXXXXXXX----------------------XXXX-----------------------XXXXXXX
---oo----------------------------------------------------------------------------------oo----------------------------E---------------------------E-------------------------oo----------------------------E---------------------------E-------------------------oo----------------------------E----------X----------------E-------------------------oo----------------------------E---------[]----------------E-------------------------oo----------------------------E-----------------------------------------------------oo----------------------------E-----------------------------------------------------oo----------------------------E----------E----------------E-------------------------oo----------------------------E---------------------------E-------------------------oo----------------------------E---------------------------E----------X-------------------------------------XX---oo--------------------------------------------------------E-------------------------oo----------------------------E----------E----------------------------------------------------------------------------------------------------E-----------------------------------------------------oo----------------------------------------------------------------------------------------------------------------E---------[]----------------------------------------------------------------------------------------------------E----------------------
----------------XXXXX-XXXX-X----------XX---XXXXXXX-XXX-----------------XXXXXXX-----------------oo---XXXX---XXX------<>---------XXXXXXX----------<>---------XXXXXXX-----------------oo---XXXX---XX-------<>---------XXXXXXX----------<>-----o---XXXXXX-----------------ooo---XXXX------------<>-----oo--XXXXXX-----------<>-----oo--XXXXXX-----------------ooo---XXXX------------<>-----oo--XXXXXX-----------<>-----oo--XXXXXX-----------------ooo---XXXX---XX-------<>---------XXXXXXX-----------E---------XXXXXXX----------------------XXXX--XXXX-X----<>---------XXXXXXX----------------XX---XXXXXX--XXX------------------XXXX--XXXX------<>---------XXXXXXX----------<>---------XXXXXXX-----------------oo---XXXX---XXX------<>---------XXXXXXX----------<>---------XXXXXXX----------------ooo---XXXX---XXX------<>-----X---XXXXXX-----------<>-----o---XXXXXX-----------------------------------------------o---XXXX---XXX------------ooo--XXXXX------------<>-----oo--XXXXXX-----------------ooo---XXXX------------<>----Xoo--XXXXX------------<>-----oo--XXXXX------------------ooo--XXXXX------------------ooo--XXXXX------------<>-----X---XXXXXX------------E-----o---XXXXX------------------ooo---XXXX-----------------XXXX--XXXXX-------------------o---XXXX-------------------ooo---XXXX------------<>----Xoo--XXXXXX----------------------XXXXX-------------E----ooo--XXXXX------------------ooo---XXXX------------<>-----oo--XXXXXX-------
---------------------------------E---XXXXXXX-----------------E-------XX---------------------------------------------[]--------------------------[]------------------------------------------------------[]--------------------------[]----------------------------------E-------------------[]--------------------------[]----------------------------------E-------------------[]--------------------------[]----------------------------------E-------------------[]--------------------------<>----------------------------------XXX-----------------[]---XX--XXX-----------------E---XXXXXXX------------------------XXXX----------------[]--------------------------[]------------------------------------------------------[]--------------------------[]----------------------------------E-------------------[]--------------------------[]------------------------X--------XXXXX------------------------XXXX-----------------E---------------o----------[]----------------------------------E-------------------[]---------------o----------[]--------------------------<>----------------------------------E-------------------[]--------------------------<>----------------------------------E------------------------------------o-----------E----------------------------------E-------------------[]---------------------------E--------------------------<>----------------------------------E-------------------[]----------------------
-----------XXXX-----------------<>--XXXX--------------------<>--XXX---------------------------XXXXXX----------------[]-----XXX---------XXX------[]---------------XXXXX------------XXXXXX----------------[]-----XXX-------XXXXX------[]------XX-------XXXXX------------XXXXXX------XX--------[]-----XXX------XXXXXX------[]----XXXXX------XXXXX------------XXXXXX-----XXX--------[]-----XXX-------XXXX-------[]-----XXX-------XXXXX------------XXXXXX----------------[]-----XXX-------XXXXX------[]----------------XXXX-------------XXXX-----------------[]--XXXX--------------------<>--XXXX---------------------------X--------------------[]---X-----------XXX--------[]---X-------------XXX-------------XXXXX----------------[]---------------XXXXX------[]---------------XXXXX------------XXXXXX----------------[]-------X------XXXXXX------[]------XX------XXXXXX----X--------------------------------------X------------------<>----XXXXX-----XXXXXX------[]-----XXX------XXXXXX------------XXXXXX-----XXX--------[]-----XXX------XXXXX-------[]----XXXX--------XXXX------[]----XXXXX-----XXXXXX------<>----XXXXX------XXXXX------[]------XX------XXXXXX------[]-----XXX------XXXXXX------------XXXXXX----------------<>------XX----XXXXXXXX------<>-----XXX-----XXXXXXX------------XXXXXX-----XXX--------[]-----XXX------XXXXXX------<>-------X-----XXXXXXX------[]----XXXX-------XXXXX-----------XXXXXXX----------------[]-----XXX------XXXXXX--
--------------------------------[]-XXXXX--------------------[]-XXXX-------------------------------------------------[]-XXX----------------------[]------------------------------------------------------[]--------------------------[]------------------------------------------------------[]--------------------------[]------------------------------------------------------[]--------------------------[]------------------------------------------------------[]--------------------------[]------------------------------------------------------[]-XXXXX--------------------[]-XXXXX------------------------------------------------[]--XXX---------------------[]--XXX-------------------------------------------------[]--------------------------[]------------------------------------------------------[]--------------------------[]------------------------X---------------------oooo--------------------------------[]--------------------------[]------------------------------------------------------[]--------------------------[]--------------------------[]--------------------------[]--------------------------[]--------------------------[]------------------------------------------------------[]--------------------------[]------------------------------------------------------[]--------------------------[]--------------------------[]------------------------------------------------------[]----------------------
XXXXXXXXXX------------------XXXXXXXXXXX-----------------XXXXXXXXXXX-----------------XXXXXXXXX-------------------XXXXXXXXXXX-----------------XXXXXXXXXXX-----------------XXXXXXXXXX------------------XXXXXXXXXX------------------XXXXXXXXXXX-----------------XXXXXXXXX-------------------XXXXXXXXXX------------------XXXXXXXXXX------------------XXXXXXXXX-------------------XXXXXXXXXX------------------XXXXXXXXXX------------------XXXXXXXXX-------------------XXXXXXXXXX------------------XXXXXXXXXX------------------XXXXXXXXXXX-----------------XXXXXXXXXXX-----------------XXXXXXXXXXX-----------------XXXXXXXXXXX-----------------XXXXXXXXXXX-----------------XXXXXXXXXXX-----------------XXXXXXXXXX------------------XXXXXXXXXXX-----------------XXXXXXXXXXX-----------------XXXXXXXXX-------------------XXXXXXXXXX------------------XXXXXXXXXX------------------XXX--XXXXXX-------------XXXXXXXXXXXXXX------------------XXXXXXXXX-------------------XXXXXXXXXX------------------XXXXXXXXX-------------------XXXXXXXXX-------------------XXXXXXXXX-------------------XXXXXXXXX-------------------XXXXXXXXX-------------------XXXXXXXXXX------------------XXXXXXXXX-------------------XXXXXXXX--------------------XXXXXX----------------------XXXXXXX---------------------XXXXXXXX--------------------XXXXXXXXXX------------------XXXXXXXXX-------------------XXXXXXXXX-------------------XXXXXXXX--------------------XXXXXXXXXX------------------
