--------------------------------------------------------------------------------------------------------------------------------------------------------------------------------------------------------------------------------------------------------------------------------------------------------------------------------------------------------------------------------------------------------------------------------------------------------------------------------------------------------------------------------------------------------------------------------------------------------------------------------------------------------------------------------------------------------------------------------------------------------------------------------------------------------------------------------------------------------------------------------------------------------------------------------------------------------------------------------------------------------------------------------------------------------------------------------------------------------------------------------------------------------------------------------------------------------------------------------------------------------------------------------------------------------------------------------------------------------------------------------------------------------------------------------------------------------
--------------------------------------------------------------------------------------------------------------------------------------------------------------------------------------------------------------------------------------------------------------------------------------------------------------------------------------------------------------------------------------------------------------------------------------------------------------------------------------------------------------------------------------------------------------------------------------------------------------------------------------------------------------------------------------------------------------------------------------------------------------------------------------------------------------------------------------------------------------------------------------------------------------------------------------------------------------------------------------------------------------------------------------------------------------------------------------------------------------------------------------------------------------------------------------------------------------------------------------------------------------------------------------------------------------------------------------------------------------------------------------------------------------------------------------------------------
--------------------------------------------------------------------------------------------------------------------------------------------------------------------------------------------------------------------------------------------------------------------------------------------------------------------------------------------------------------------------------------------------------------------------------------------------------------------------------------------------------------------------------------------------------------------------------------------------------------------------------------------------------------------------------------------------------------------------------------------------------------------------------------------------------------------------------------------------------------------------------------------------------------------------------------------------------------------------------------------------------------------------------------------------------------------------------------------------------------------------------------------------------------------------------------------------------------------------------------------------------------------------------------------------------------------------------------------------------------------------------------------------------------------------------------------------------
--------------------------------------------------------------------------------------------------------------------------------------------------------------------------------------------------------------------------------------------------------------------------------------------------------------------------------------------------------------------------------------------------------------------------------------------------------------------------------------------------------------------------------------------------------------------------------------------------------------------------------------------------------------------------------------------------------------------------------------------------------------------------------------------------------------------------------------------------------------------------------------------------------------------------------------------------------------------------------------------------------------------------------------------------------------------------------------------------------------------------------------------------------------------------------------------------------------------------------------------------------------------------------------------------------------------------------------------------------------------------------------------------------------------------------------------------------
--------------------------------------------X------------oo-------------o-------------------------------------------------------Xoooo----------------------oooooo---------------------------------------------------Xoooo----------------------oooooo----------------------------o----------------------ooooo----------------------oooooo--------------------------------------------------oooooo-----------------------ooooo--------------------------------------------------oooooo------------------------------------------------------------------------------------------------------------------------------------------------------------------ooo------------------------------------------------------X---------------------------ooooo---------------------------------------------------Xoooo----------------------oooooo------------------------------------oo-------------X------------------------------------------------------------------------------------oooo----------------------Eooooo---------------------------------------------------ooooo-----------------------Xoooo----------------------------------------------------oooo-----------------------ooooo---------------------------------------------------Xoooo-----------------------ooooo---------------------------------------------------Xoooo-----------------------ooooo------------------------oooo-------------------------o-o----------------------oooooo-------
--------------------SQX------------------XXXX-------------------------XXX-----------------SSS-----------XXX-------------------XXX-X----------------------XXXXXXXX-------SSS---SSS-----------XXX-------------------XXXXXXX---------------------XXXXXX--------SS----SSS-----------XXX------------------XXXXXXXX---------------------XXXXXX--------SSS---SS-------------X-------------------XXXXXX----------------------XXXXXXXX-------SSS---SSS--------------------------------XXXXXXXX---------------------------XXX-----------SS------------XXX-------------------XXX-----------------SSS-----------XXX-----------------------------------------------XXXX----------S-----SS------------XXX------------------XXXXX-----------------------XXXXXXXX-------SSS---SSS--------------------------------XXXXXXX----------------------XXXXXXX-------SSS---SSS------------X-------------------XXXX---------------------------------------S-----SS------------XX------SSS--------------XXX-----------------------XXXXX--------SSS----------------------------------------XXXXX--------S--------------XXXXXX-------SSSS---S--------------------------------Xo--------------SS-------------XXXXX--------SSS---SS------------XXX------------------XXXXXX---------SS-------------XXXXX--------SSS--------------------------------------XXXXXX---------------------XX--XXXX--------SS-----------o---XXXX-------SSS--------------------------------------XXXXXXX--------
----------------------------------------------------------------------------------------------------------------------------------------------------------------------------------------------------------------------------------------------------------E-----------------------------------------------------E-----------------------------E-------------------------o-------------------------------------------------------E-E---------------------------------------------------------------------------------------------------------------------------------------------------------------------------------------------------------------------------------------------------------------------------------------------------------------------------------------------o---------------------------E-----------------------------E-------------------------o---------------------------------------------------------------------------------------------------------------E-------------------------------------------------------E---------------------------E---------------------------E---------------------------o------------------oo----o--E---------------------------E---------------------------o---------------------------E------------------o------------------------------------E-------------------E-------E------------------o-----o---------------------------E--E---------------------------E-----------------------------E-
---------------------------------------------------------------------------------------------------------------------------------------XXXX------------------------XXXXX----------------------X----------------------------XXXX-----------------------XXXXXX----------------------X-XX-----------------<>----XXXXXXX----------------------XXXXXX----------------------XXXX------------------------XXXXXX----------------E----XXXXXXX----------------------X-XX--------------------------XXX---------------------------------------------------------------------------------------------------------------------------------------------------------------------------------------------------------------------------------------------------------XXX-----------------------XXXX-----------------<>---XXXXXXXX----------------------XXXXX-----------------------XXXX----------------------------------------------------------------------------------------------------------XXXXXXXX--------------------XXXXXXXX--------------------XXXXXXXX--------------------XXXXXXXX--------------------XXXXXXXX----------------------XXXX----------------------XXXXXXXX--------------------XXXXXXXX----------------------XXXX-----------------------XXXXXXX--------------------XXXXXXXX--------------------XXXXXXXX--------------------XXXXXXXX--------------------XXXXXXXX--------------------XXXXXXXX--------------------XXXXXXXX---------------------XXXXXXX
---oo--------------------------------------------------------E-------------------------oo----------------------------E---------------------------E-------------------------ooo---------------------------E---------------------------E-------------------------oo----------------------------E---------[]----------------E-------------------------oo----------------------------E---------------------------E-------------------------oo----------------------------E-------------------------oo--------------------------oo----------------------------E-------------------------oo--------------------------------------------------------E-------------------------oo----------------------------E----------E----------------E-------------------------oo----------------------------E---------[]----------------E-------------------------oo----------------------------E------------------------------------------------XX---oo----------------------------------------------------------------------------------------------------------------------------------------------------------------------------------------------------------------------------------------------------------o-----------------------------E-----------------------------------------------------------------------------------------------------------------------------------------------------------------------E---------------------------E----------------------
----------------XXXXX-XXXX-------E----------XXXXXX-X--------<>---------XXXXXXX-----------------oo---XXXX---XXX------<>---------XXXXXX-----------<>---------XXXXXXX-----------------oo---XXXX---XXX------<>---------XXXXXX-----------<>----XX---XXXXXX-----------------Xoo---XXXX---XXX------<>-----oo--XXXXXX-----------<>-----X---XXXXXX------------------oo---XXXX------------<>----XXX--XXXXXX-----------<>-----oo--XXXXXX------------------oo---XXXX----XX------<>---------XXXXXXX----------------------XXXXX--XXXXX----------------XXXX--XXXXXX----<>----XX---XXXXXXX------------------o---XXXXX--XXXXX----------XX----XXXXX--XXX------<>---------XXXXXXX-----------------oo---XXXX---XXX------<>---------XXXXXXX----------<>---------XXXXXXX----------------ooo---XXXX---XX-------<>-----oo--XXXXXX-----------<>-----oo--XXXXXXX-----------------oo---XXXX------------<>---------XXXXXXX-XX-----------------E-----------------------------XXXX---XXX------------ooo--XXXXX-------------E-----X---XXXXXX-----------------ooo---XXXX-------------E-----oo--XXXXX------------------ooo--XXXXX------------------ooo---XXXX-------------------o---XXXXX------------<>-----oo--XXXXXX-----------------ooo---XXXX------------<>----ooo--XXXXX------------------Xoo--XXXXX------------------ooo---XXXX------------------Xoo--XXXXX-------------------XXXXXXXXX------------------ooo--XXXXX------------<>----ooo--XXXXX------------<>----XXX--XXXXXX-------
------------XXXX----------------<>-------XX-----------------[]---XX--XX---------------------------------------------[]-------X------------------[]------------------------------------------------------[]--------------------------[]----------------------------------E-------------------[]--------------------------[]----------------------------------E-------------------[]--------------------------[]------------------------------------------------------[]----------------------------------XXXX------------------------XXXX----------------[]---XXX-XXX---------------------------------------------E---XXXXXXX----------------[]------------------------------------------------------[]--------------------------[]----------------------------------E-------------------[]--------------------------[]----------------------------------E-------------------[]---EX--XX---------------X--------XXXXXX----------------------XXXXX-----------------E--------------------------<>----------------------------------E-------------------<>---------------o-----------E----------------------------------E--------------------E--------------------------[]----------------------------------E-------------------[]---------------------------E---------------------------E------E-------------------<>---------------------------E---------------------------E--------------------------[]------E-------------------[]----------------------
-----------X-XX-----------------[]--XXX---------------------[]--XXXX---------------------------XXXX-----------------[]---X---X--------XXX-------[]-------X-------XXXXX-------------XXXXX----------------[]-----XXXX------XXXXX------[]------XX------XXXXXX------------XXXXXX-----XXX--------[]-----XXX------XXXXXX------[]--------------XXXXXX------------XXXXXX----------------[]------XX------XXXXXX------[]-----XXX-------XXXXX-------------XXXX------XXX--------[]----------------XXXX-------------XXXX------------------------X-X------------------[]--XXXX---------------------------XXXX-----------------<>--XXXXX-------------------[]--XXX------------X---------------XXXXX----------------[]---X-----------XXX--------[]------XX--------XXXX------------XXXXXX----------------[]-----XXXX-----XXXXX-------[]-----XXX--------XXXX------------XXXXXX------XX--------[]--XXX-------------------X------------------------------------XXXX-----------------<>----XXXXX-----XXXXXX------[]-------X------XXXXXX------<>----XXXXX------XXXX-------[]-----XXX------XXXXXX------<>----XXXX------XXXXXX------------XXXXX------------X----<>------XX-----XXXXXXX------[]-----XXX------XXXXXX-----------XXXXXXX----------------[]----XXXX------XXXXXX------<>-----XXX------XXXXXX------<>---XXXXXX------XXX--------[]-----XXX------XXXXX-------<>------------XXXXXXXX------<>----XXXXX-----XXXXXX------[]----XXXXX------XXXXX------[]--------------XXXXXX--
--------------------------------[]-XXXX---------------------[]-XXXXX------------------------------------------------[]--XXX---------------------[]------------------------------------------------------[]--------------------------[]------------------------------------------------------[]--------------------------[]------------------------------------------------------[]--------------------------[]------------------------------------------------------[]----------------------------------------------------------------------------------[]-XXXXX------------------------------------------------[]-XXXXXX-------------------[]-XXXX-------------------------------------------------[]-XXXX---------------------[]------------------------------------------------------[]--------------------------[]------------------------------------------------------[]-XXXX-------------------X--------------------EEE----------------------------------[]----------------------E---[]--------------------------[]--------------------------[]--------------------------[]------------------------------------------------------[]--------------------------[]------------------------------------------------------[]--------------------------[]--------------------------[]--------------------------[]--------------------------[]--------------------------[]--------------------------[]--------------------------[]----------------------
XXXXXXXXXXX-----------------XXXXXXXXXXX-----------------XXXXXXXXXXX-----------------XXXXXXXXXX------------------XXXXXXXXXXX-----------------XXXXXXXXXX------------------XXXXXXXXX-------------------XXXXXXXXXXX-----------------XXXXXXXXXX------------------XXXXXXXX--------------------XXXXXXXXXX------------------XXXXXXXXXX------------------XXXXXXXXXX------------------XXXXXXXXXXX-----------------XXXXXXXXXXX-----------------XXXXXXXXXX------------------XXXXXXXXXX------------------XXXXXXXXXXX-----------------XXXXXXXXXXX-----------------XXXXXXXXXXX-----------------XXXXXXXXXX------------------XXXXXXXXXXXX----------------XXXXXXXXXXX-----------------XXXXXXXXXX------------------XXXXXXXXXXX-----------------XXXXXXXXXX------------------XXXXXXXXXX------------------XXXXXXXXXX------------------XXXXXXXXXX------------------XXXXXXXXX-------------------XXXXXXXXXXX-----------------XXX--XXXXXX----------XXXXXXXXXXXXXXXXX------------------XXXXXXXXX-------------------XXXXXXXXX-------------------XXXXXXXX--------------------XXXXXXXXX-------------------XXXXXXXXX-------------------XXXXXXXX--------------------XXXXXXXX--------------------XXXXXXXXX-------------------XXXXX-XX--------------------XXXXXXXXX-------------------XXXXXXXXX-------------------XXXXXXXX--------------------XXXXXXXXX-------------------XXXXXXXX--------------------XXXXXXXX--------------------XXXXXXXXX-------------------XXXXXXXXXX------------------
