--------------------------------------------------------------------------------------------------------------------------------------------------------------------------------------------------------------------------------------------------------------------------------------------------------------------------------------------------------------------------------------------------------------------------------------------------------------------------------------------------------------------------------------------------------------------------------------------------------------------------------------------------------------------------------------------------------------------------------------------------------------------------------------------------------------------------------------------------------------------------------------------------------------------------------------------------------------------------------------------------------------------------------------------------------------------------------------------------------------------------------------------------------------------------------------------------------------------------------------------------------------------------------------------------------------------------------------------------------------------------------------------------------------------------------------------------------
--------------------------------------------------------------------------------------------------------------------------------------------------------------------------------------------------------------------------------------------------------------------------------------------------------------------------------------------------------------------------------------------------------------------------------------------------------------------------------------------------------------------------------------------------------------------------------------------------------------------------------------------------------------------------------------------------------------------------------------------------------------------------------------------------------------------------------------------------------------------------------------------------------------------------------------------------------------------------------------------------------------------------------------------------------------------------------------------------------------------------------------------------------------------------------------------------------------------------------------------------------------------------------------------------------------------------------------------------------------------------------------------------------------------------------------------------------
--------------------------------------------------------------------------------------------------------------------------------------------------------------------------------------------------------------------------------------------------------------------------------------------------------------------------------------------o-----------------------------------------------------------------------------------------------------------------------------------------------------------------------------------------------------------------------------------------------------------------------------------------------------------------------------------------------------------------------------------------------------------------------------------------------------------------------------------------------------------------------------------------------------------------------------------------------------------------------------------------------------------------------------------------------------------------------------------------------------------------------------------------------------------------------------------------------------------------------------------------------------------------------------------------------------------------------------------------------------------------------------------------------------------------------------------------------------------
--------------------------------------------------------------------------------------------------------------------------------------------------------------------------------------------------------------------------------------------------------------------------------------------------------------------------------------------------------------------------------------------------------------------------------------------------------------------------------------------------------------------------------------------------------------------------------------------------------------------------------------------------------------------------------------------------------------------------------------------------------------------------------------------------------------------------------------------------------------------------------------------------------------------------------------------------------------------------------------------------------------------------------------------------------------------------------------------------------------------------------------------------------------------------------------------------------------------------------------------------------------------------------------------------------------------------------------------------------------------------------------------------------------------------------------------------------
---------------------------------------------------------oo-------------X------------------------------------------------------oooo------------------------oooooo--------------------------------------------------oooooo-----------------------ooooo--------------------------------------------------oXoooo----------------------oooooo---------------------------------------------------Xoooo----------------------oooooo--------------------------------------------------oooooo------------------------------------oo-------------------------------------------------------------------------------------------------------------------------------------------------------------------------------------Xoo----------------------------------------------------oooooo-----------------------ooooo--------------------------------------------------oooooo------------------------------------------------------------------------------------------------------------oooo-----------------------ooooo-----------------------ooooo-----------------------ooooo------------------------Eo-----------------------------------------------------Xoooo-----------------------ooooo----------------------------------------------------oooo--oo---------------------------------------------------------------------------Xoooo-----------------------ooooo-------------------------ooo---------------------------------------------------Xoooo-------
S-----SSS-----------SXX-------------------XXX---XX-------------------XXXX-----------------SSS-----------XXX------------------XXXXX-----------------------XXXXXXXX-------SSS---SS-------------X-------------------XXXXXX-----------------------XXXXXXX-------SSS---SSS-----------XXX-------------------XXXXX-----------------------XXXXXXX-------SSS---SSS-----------XXX------------------XXXXXX-----------------------XXXXXX--------SSS---SSS-----------XX--------------------XXXXX---------------SS------------XXX-------------------XXX-----------------------------------------------------------XXX-------------------XXX-----------S-----SSS-----------XXX-------------------XXX-------------------------XXX-----------SSS--SSSSS----------XXX------------------XXXXXXXX--------------------XXXXXX---------SSS---SSS-----------XXX------------------XXXXXXX--------------SSS-----------XXX---------------------------------SSSS--SS------------XXX-----SSS------------XXXXXX-------S--------------XXXXXX--------------------XXXXXXX---------------------o--XXXX---------------------X--------------SSS---SSS-----------XX------SS-------------XXXXX-----------------------XXXXX--------SSS-------------------------------------Xo--------------S------------X--------------SSS----S---------------------------------XXXX------------------------o-XXXXX---------------------------XX-------SSS----S---------------------------------XXXXXX---------
------------------------------------------------------------------------------------------------------------------------------------------------------------------------------------------------o-----------------------------E---------------------------E-----------------------------------------------------------------------------------E-----------------------------------------------------E-----------------------------E-------------------------o-------------------------------------------------------------------------------------------------------------------------------------------------------------------------------------------------------------------------------------------------------------------------------------------------------------------------------------------------E-------------------------------------------------------E-------------------------------------------------------------------------------------------------------------E---------------------------E---------------------------E------------------o------------------------------------E---------------------------E---------------------------E---------------------------E---------------------------o------------------oo-----------------------------------E---------------------------o-------------------X-------E------------------o-----o------------------------------E---------------------------o-------------------------------
----------------------------------------------------------------------------------------------------------------------------------------XXX-------------------------XXX-----------------------X-----------------------------XXX----------------<>----XXXXXXX----------------------X-X-------------------------XXXXXX---------------------XXXXXXX----------------------X--------------------------XXXXXXX----------------------XXXXXX----------------------XXXX----------------------------------------------------------------------------------------------------------------------------------------------------------------------------------------------------------------------------------------------------------------------------------------------------------------XXXXXX---------------<>----XXXXXXX----------------------X--------------------<>----XXXXXXX----------------------------------------------XXX--------------------------------------------------------XXXXXXX--------------------XXXXXXXX--------------------XXXXXXXX--------------------XXX-XXXX---------------------XXXXXXX---------------------XXXXX----------------------XXXXXXXX--------------------XXXXXXXX----------------------XXXX----------------------XXX-XXXX---------------------XXXXXXX---------------------XXXXX-----------------<>---XXXXXXXX--------------------XXX-XXXX--------------------XXXXXXXX---------------------XXXXX------------------------XXXXXX
---oo----------------------------------------------------------------------------------oo--------------------------------------------------------E-------------------------oo----------------------------E---------------------------E---------[]--------------oo--------------------------------------------------------E-------------------------oo----------------------------E----------E----------------E-------------------------oo----------------------------E-------------------------oo----------------------------E--------------------------o--------------------------oo----------------------------E-------------------------oo----------------------------E---------------------------E-------------------------oo----------------------------E---------------------------E---------[]--------------oo--------------------------------------[]--------------oo------------------------------------------------------oo--------------------------------------------------------E-----------------------------------------------------------------------------------------------------------------------------------------------------------------------E-------------------------------------------------------------------------------------------------------------------------------------------E---------[]---------------------------------------------------------------------------------------------------------------------------
-----------oo---XXXX---XXX-----------------XXXXXXX-XXX------<>---------XXXXXXX-----------------oo---XXXX--XXXX-X----<>---------XXXXXXX----------<>---------XXXXXXX-----------------oo---XXXX---XX-------<>---------XXXXXXX----------<>-----oo--XXXXXX-----------------ooo---XXXX---XX-------<>----XXX--XXXXXX-----------<>---------XXXXXX-----------------ooo---XXXX---XXX------<>-----oo--XXXXXX-----------<>-----X---XXXXXX-----------------ooo---XXXX------------<>---------XXXXXXX----------------------XXXX--XXXXXX----<>----XX---XXXXXXX-XXX-------------X----XXXX---XXX------------------XXXX---XXXXX----<>----XX---XXXXXXX-----------------oo---XXXX--XXXX------<>---------XXXXXXX----------<>---------XXXXXXX-----------------oo---XXXX--XXXX------<>-----X---XXXXXXX----------<>---------XXXXXX-----------------ooo---XXXX---XXX------<>----XXX--XXXXX------------------------XXXX--XXXXXX--------------E-----------------------ooo---XXXX--XXXX-------E-----oo---XXXX------------<>-----oo--XXXXX------------------Xoo--XXXXXX------------------XXXXXXXXX-------------E----ooo--XXXXX------------------ooo---XXXX------------------ooo--XXXXX------------<>-----oo--XXXXXX-----------------ooo---XXXX-----------XX-----XX---XX---------------------ooo--XXXXX------------------ooo---XXXX------------<>----Xoo--XXXXX------------------XXXXXXXXX-------------------ooo--XXXXX------------------ooo---XXXX-------------E----XXX--XXXXXX-------
---------------------------------E-------XX-----------------[]---XX--XX---------------------------------------------[]--------------------------[]----------------------------------E-------------------[]--------------------------[]----------------------------------E-------------------[]--------------------------[]----------------------------------E-------------------[]--------------------------[]----------------------------------E-------------------[]----------------------------------XXXX----------------[]---XXX-XXX---------------------XXXXXXX-----------------------XXXXX----------------[]---XXX-XXX--------------------------------------------[]--------------------------[]------------------------------------------------------[]--------------------------[]----------------------------------E-------------------[]-----------------------------------XX---------------X--------XXXXXX-------------------------------------------<>--------------------------[]------E-------------------<>---------------o-----------E---------------o----------<>----------------------------------E-------------------<>---------------o----------[]----------------------------------E------------------------------------------------E----------------------------------E-------------------[]---------------------------E--------------------------------------------------------------E-------------------<>----------------------
-----------XXXX-----------------<>--XXX---------------------[]--XXX------------X---------------XXXX-----------------[]---X---X---------XX-------[]-------X--------XXXX------------XXXXXX----------------[]---------------XXXXX------[]-----XXX-------XXXXX------------XXXXXX-----XXX--------[]------XX------XXXXXX------[]--------------XXXXXX------------XXXXXX----------------[]-----XXX-------XXXXX------[]--------------XXXXXX------------XXXXXX------XX--------[]----------------XXXX-------------X-X------------------[]--XXXX------------------------XXXXXX-------------------------XX-------------------[]--XXXX--------------------------XXXXXX----------------[]--XXX---------------------[]----------------XXXX------------XXXXXX----------------[]----------------XXXX------[]------XX-------XXXX-------------XXXXXX-----XXX--------[]--------------XXXXX----------------X----------------X-------------------------E---------XXXXXX----------------[]----XXXXX------XXXXX------[]----XXXXX-----XXXXXX------[]-----XXX------XXXXXX------<>-------------XXXXXXX------[]----XXXX-------XXXXX------------XXXXXX-----XXX--------[]-----XXX------XXXXXX------[]------XX------XXXXXX------<>----XXXXX--------XX---------------------XXXXXXX-------<>----XXXX-------XXXXX------------XXXXXX----------------[]-----XXX------XXXXX-------<>------------XXXXXXXX------------XXXX------XXXXXX-----------XXXXXXX-------X--------[]-----XXX------XXXXXX--
--------------------------------[]-XXXX---------------------[]-XXXX-------------------------------------------------[]--XXX---------------------[]------------------------------------------------------[]--------------------------[]------------------------------------------------------[]--------------------------[]------------------------------------------------------[]--------------------------[]------------------------------------------------------[]---------------------------------X--------------------[]-XXXXX-----------------------XXXXX--------------------------XX--------------------[]-XXXXX------------------------------------------------[]-XXXX---------------------[]------------------------------------------------------[]--------------------------[]------------------------------------------------------[]----------------------------------------------------X--------------------EEE----------------------------------[]--------------------------[]--------------------------[]--------------------------[]--------------------------[]------------------------------------------------------[]----------------------E---[]--------------------------[]------------------------------------------------------[]------------------------------------------------------[]--------------------------[]----------------------------------------------------------------------------------[]----------------------
XXXXXXXXXX------------------XXXXXXXXXXX-----------------XXXXXXXXXXX-----------------XXXXXXXXXX------------------XXXXXXXXXXX-----------------XXXXXXXXXX------------------XXXXXXXXX-------------------XXXXXXXXXXX-----------------XXXXXXXXXX------------------XXXXXXXXX-------------------XXXXXXXXX-------------------XXXXXXXXXXX-----------------XXXXXXXXX-------------------XXXXXXXXXXX-----------------XXXXXXXXXX------------------XXXXXXXXX-------------------XXXXXXXXXXX-----------------XXXXXXXXXXX-----------------XXXXXXXXXXX-----------------XXXXXXXXXXX-----------------XXXXXXXXXXX-----------------XXXXXXXXXXX-----------------XXXXXXXXX-------------------XXXXXXXXXXX-----------------XXXXXXXXXXX-----------------XXXXXXXXX-------------------XXXXXXXXX-------------------XXXXXXXXXXX-----------------XXXXXXXXX-------------------XXXXXXXXXX------------------XXXXXXXXXXX-----------------XXX--XXXXXX----------XXXXXXXXXXXXXXXX-------------------XXXXXXXXX-------------------XXXXXXXXXX------------------XXXXXXXXX-------------------XXXXXXXX--------------------XXXXXXXXX-------------------XXXXXXXX--------------------XXXXXXXXX-------------------XXXXXXXXXX------------------XXXXXXXX--------------------XXXXX-----------------------XXXXXXXX--------------------XXXXXXXX--------------------XXXXXXXXXX------------------XXXXXXXXX-------------------XXXXXX----------------------XXXXXXXX--------------------XXXXXXXXX-------------------
