--------------------------------------------------------------------------------------------------------------------------------------------------------------------------------------------------------------------------------------------------------------------------------------------------------------------------------------------------------------------------------------------------------------------------------------------------------------------------------------------------------------------------------------------------------------------------------------------------------------------------------------------------------------------------------------------------------------------------------------------------------------------------------------------------------------------------------------------------------------------------------------------------------------------------------------------------------------------------------------------------------------------------------------------------------------------------------------------------------------------------------------------------------------------------------------------------------------------------------------------------------------------------------------------------------------------------------------------------------------------------------------------------------------------------------------------------------
--------------------------------------------------------------------------------------------------------------------------------------------------------------------------------------------------------------------------------------------------------------------------------------------------------------------------------------------------------------------------------------------------------------------------------------------------------------------------------------------------------------------------------------------------------------------------------------------------------------------------------------------------------------------------------------------------------------------------------------------------------------------------------------------------------------------------------------------------------------------------------------------------------------------------------------------------------------------------------------------------------------------------------------------------------------------------------------------------------------------------------------------------------------------------------------------------------------------------------------------------------------------------------------------------------------------------------------------------------------------------------------------------------------------------------------------------------
-------------------------------------------------------------------------------------------------------------------------------------------------------------------------------------------------------------------------------------------------------oo----------------------------------------------------------------------------------------------------------------------------------------------------------------------oo------------------------------------------------------------------------------------------------------------------------------------------------------------------------------------------------------------------------------------------------------------------------------------------------------------------------------------------------------------------------------------------------------------------------------------------------------------------------------------------------------------------------------------------------------------------------------oo---------------------------------------------------------------------------------------------------------------------------------------------------------------------------------------------------------------------------------------------------------------------------------------------------------------------------------------------------------------------------------------------------------------------------------------
-------------------------------------------------------------------------------------------------------------------------------------------------------------------------------------------------------------------------------------------------------XX----------------------------------------------------------------------------------------------------------------------------------------------------------------------XX------------------------------------------------------------------------------------------------------------------------------------------------------------------------------------------------------------------------------------------------------------------------------------------------------------------------------------------------------------------------------------------------------------------------------------------------------------------------------------------------------------------------------------------------------------------------------XX---------------------------------------------------------------------------------------------------------------------------------------------------------------------------------------------------------------------------------------------------------------------------------------------------------------------------------------------------------------------------------------------------------------------------------------
---------------------------------------------------------o--------------ooo----------------------------------------------------oooooo----------------------oooooo---------------------------------------------------ooooo----------------------oooooo---------------------------------------------------Xoooo----------------------oooooo---------------------------------------------------ooooo----------------------oooooo--------------------------------------------------oooooo----------------------------------------------------------------oo-------------------------------------------------------------------------------------------------Xoo----------------------------------------------------oooooo----------------------oooooo---------------------------------------------------Xoooo-----------------------Xoooo------------------------------------oo------------ooo-o---------------------------------------------------------------------------------oooo----------------------oooooo------------------------oooo------------------------oooo-------------------------------------------------------------------------------ooooo------------------------oooo------------------------oo-------------------------ooooo----------------------------------------------------Eooo-----------------------Xoooo-------------------------------------------------------o-----------------------ooooo-----------------------Xoooo-------
-------SS-----------XXX-------------------X-----XXX-------------------XXXXX---------SS----SS------------XX-------------------XXXXXX-----------------------XXXXXXX-------SSS---SSS-----------XXX------------------XXXXXXXX---------------------XXXXXX--------SSS---SSS------------X------S------------XXXX------------------------XXXXXXX--------SSS---SS------------XX-------------------XXXXXXXX---------------------XXXXXX--------SSS---SSS-----------XXX------------------XXXXXXXX-------------SSS-----------XXX-----------------------------------------------XXX-----------------SS------------XXX-------------------XXX------------------------XXXX----------------SSSS-----------XXX-------------------XXXXXXX---------------------XXXXXX--------SSS---SSS-----------XXX------------------XXXXXXXX--------------------XXXXXX---------SSS---SSS-----------XX--------------------XXXX--------------------------------------SSSS--SSS-----------XXX-----SSS--------------XX----------------------XXXXXXXX-------SS--------------X----------------------XXo---XX---------SSS-------------------------SSS-----------------------------------X----XXXXX--------SS---------------XXXX-------SS------------------------------------X----XXXXX--------SSS--------------------------------------o--------------SS-----------X--XXX---------SSS-------------------------SS-----S--------------------------------Xo---XXX--------SS------------XXXXXX--------
------------------------------------------------------------------------------------------------------------------------------------------E---------------------------------------------------------------------------------E-----------------------------E-------------------------E-------------------------------------------------------E-E-------------------------E---------------------------E-----------------------------E-------------------------------------------------------------------------------------------------------------------------------------------------------------------------------------------------------------------------------------------------------------------------------------------------------------------E-----------------------------------------------------E---------------------------E-E-------------------------o-----------------------------------------------------------------------------------------------------------------------------------------------------------------------E------------------oo----o------------------------------E---------------------------o------------------------o---------------------------E--E---------------------------E------------------o-----o------------------------------E------------------oo----E--E---------------------------E---------------------------o---------------------------E------------------oo----o--E---------------------------E---
---E------------------------------------------------------------------------------------------------------X-----------------------------XXX-------------------------XXX---------------------------------------------------XXXXXX---------------------XXXXXXX----------------------XXXX------------------------XXXXX----------------<>---XXXXXXXX---------------------XXXXX----------------------XXXXXXXX---------------------XXXXXXX----------------------X-----------------------------XXX-----------------------------------------------------------------------------------------------------------------------------------------------------------------------------------------------------------------------------XXX-------------------------XXX--------------------------------------------<>----XXXXXXX---------------<>---XXXXXXXX----------------------X-XX----------------------------------------------------------------------------------------------------------XXXXXXXX---------------------XXXXXXX--------------------XXXXXXXX--------------------XXX-XXXX--------------------XXXXXXXX---------------------XXXXX-X--------------------XXXXXXXX--------------------XXXXXXXX--------------------XXXXXXXX--------------------XXXXXXXX--------------------XXXXXXXX--------------------XXXXXXXX--------------------XXXXXXXX----------------------XXXXXX--------------------XXXXXXX---------------------XXXXXXXX---------------<>---XXXXXXXX
---ooo-------------------------------------------------------E-------------------------oo----------------------------E---------------------------E-------------------------oo----------------------------E----------X----------------E-------------------------oo--------------------------------------------------------E---------[]--------------------------------------------E---------------------------E-------------------------oo----------------------------E-------------------------oo---------------------------o----------------------------E-------------------------oo--------------------------------------------------------E-------------------------oo----------------------------E---------------------------E-------------------------oo----------------------------E---------[]----------------E---------[]--------------oo----------------------------E-----------------------------------------------XXX---ooo-------------------------------------------------------------------------------------------------------------------------------------------------------------------------------------------------------------------------------------------------------------------------------------------------------------------------------------------------------------------------------------------------------------------------------------------------------------------------------------------E---------[]-----------
----------------XXXXX-XXXX-X---------------XXXXXXXXXXX------<>---------XXXXXXX-----------------oo---XXXX---XXX------<>---------XXXXXX-----------<>---------XXXXXXX-----------------oo---XXXX---XXX------<>-----oo--XXXXXX-----------<>-----X---XXXXXX------------------oo---XXXX------------------XXo--XXXXXX-----------<>-----X---XXXXXX-----------------ooo---XXXX------------<>-----oo--XXXXXX-----------<>----XXX--XXXXXX------------------oo---XXXX--XXXX------<>---------XXXXXXX----------------------XXXXX--XXXXX----------XX----XXXXX--XXX------<>----XX---XXXXXXX----------------------XXXX---XXXXX----------XX---XXXXXXX-XXX------<>---------XXXXXXX-----------------oo---XXXX--XXXX-X----<>---------XXXXXXX----------<>---------XXXXXXX-----------------oo---XXXX---XXX------<>-----oo--XXXXXX-----------<>-----oo--XXXXXX------------------oo---XXXX---XXX------<>---------XXXXXXX--------X-----------E------------------------oo---XXXX---XXX-------------oo---XXXX------------------Xoo--XXXXXX-----------------ooo---XXXX-------------------XXXXXX---------------------ooo---XXXX------------<>----ooo--XXXXX------------------XXXXXXXXXX------------------Xoo--XXXXX-------------E----ooo--XXXXX------------------XXXXXXXXXX------------------ooo---XXXX------------------ooo--XXXXX------------<>----ooo--XXXXX------------<>----ooo--XXXXX------------------ooo---XXXX-------------------X--XXXXXX------------<>-----oo--XXXXXX-------
---------------------------------E-------XX-----------------[]------------------------------------------------------[]--------------------------[]------------------------------------------------------[]--------------------------[]----------------------------------E--------------------E--------------------------[]----------------------------------E-------------------[]--------------------------[]----------------------------------E-------------------[]-----------------------------------XX----------------------XXXXXXX----------------[]---XXX-XXX------------------------XXXX-----------------E---XXXXXXX----------------[]------------------------------------------------------[]--------------------------[]------------------------------------------------------[]--------------------------[]----------------------------------E-------------------[]---XX--XX---------------X--------XXXXXX--------------------------------------------E--------------------------<>---------------o-----------E---------------------------E----------------------------------E-------------------[]------E--------------------E---------------o-----------E--------------------------<>------E--------------------E---------------o-----------E------E--------------------E--------------------------[]--------------------------[]------E---------------------------E--------------------E--------------------------[]----------------------
------------XXX-----------------<>--XXXX-X------------------[]---X-------------XXX-------------XXXXX----------------[]---------------XXXXX------[]----------------XXXX------------XXXXXX----------------[]-----XXX-------XXXXX------[]--------------XXXXXX------------XXXXXX-----XXX--------<>-----XXX------XXXXXX------[]------XX-------XXXXX------------XXXXXX-----XXX--------[]-----XXX------XXXXXX------[]--------------XXXXXX------------XXXXXX----------------[]----------------XXXX--------------------------------------XXXXX-------------------[]--XXXX---------------------------X-X------------------<>--XXXX--------------------[]--XXX------------X---------------XXXX-----------------[]-------X--------XXXX------[]---------------XXXXX------------XXXXXX----------------[]-----XXX-------XXXXX------[]-----XXX------XXXXX-------------XXXXXX----------------[]--XXXX------------------X-----------------------------------XXXXXX----------------<>----XXXXX-----XXXXXX------[]-----XXX------XXXXXX------<>----XXXXX-----XXXXXX------<>------------XXXXXXXX------<>---XXXXXX--------XXX------[]----XXXXX-----------------<>--------------XXXXXX------<>-----XXXX----XXXXXXX------[]----XXXXX-----XXXXX-------<>-------------XXXXXXX------<>----XXXXX------XXXXX------<>----XXXX----XXXXXXX-------[]----XXXX------XXXXXX------[]----XXXXX-------XXXX------------XXXXXX----XXXX--------<>--------------XXXXXX------[]-----XXX-------XXXXX--
--------------------------------[]-XXXX---------------------[]--XXX-------------------------------------------------[]--------------------------[]------------------------------------------------------[]----------------------E---[]------------------------------------------------------[]--------------------------[]------------------------------------------------------[]--------------------------[]------------------------------------------------------[]---------------------------------------------------------XXXXXX-------------------[]-XXXXX------------------------------------------------[]-XXXXX--------------------[]-XXXX-------------------------------------------------[]--------------------------[]------------------------------------------------------[]--------------------------[]------------------------------------------------------[]-XXXXX------------------X----------------------o----------------------------------[]--------------------------[]--------------------------[]--------------------------[]--------------------------[]--------------------------[]--------------------------[]--------------------------[]--------------------------[]--------------------------[]--------------------------[]--------------------------[]--------------------------[]--------------------------[]------------------------------------------------------[]--------------------------[]----------------------
XXXXXXXXXX------------------XXXXXXXXXXX-----------------XXXXXXXXXXX-----------------XXXXXXXXXX------------------XXXXXXXXXXX-----------------XXXXXXXXXXX-----------------XXXXXXXXX-------------------XXXXXXXXXX------------------XXXXXXXXXXX-----------------XXXXXXXXX-------------------XXXXXXXXX-------------------XXXXXXXXXXX-----------------XXXXXXXX--------------------XXXXXXXXXX------------------XXXXXXXXXX------------------XXXXXXXXX-------------------XXXXXXXXXXX-----------------XXXXXXXXXXX-----------------XXXXXXXXXXXX----------------XXXXXXXXXXX-----------------XXXXXXXXXXX-----------------XXXXXXXXXXX-----------------XXXXXXXXXXX-----------------XXXXXXXXXX------------------XXXXXXXXXX------------------XXXXXXXXXX------------------XXXXXXXXX-------------------XXXXXXXXXX------------------XXXXXXXXXXX-----------------XXXXXXXXX-------------------XXXXXXXXXXX-----------------XXX--XXXXXX-------------XXXXXXXXXXXXX-------------------XXXXXXXXX-------------------XXXXXXXXX-------------------XXXXXXXX--------------------XXXXXX----------------------XXXXXXXX--------------------XXXXXXXXX-------------------XXXXXXXX--------------------XXXXXXXX--------------------XXXXXXXXX-------------------XXXXXXX---------------------XXXXXXXX--------------------XXXXXXX---------------------XXXXXXXXX-------------------XXXXXXXXX-------------------XXXXXXX---------------------XXXXXXXX--------------------XXXXXXXXXXX-----------------
