--------------------------------------------------------------------------------------------------------------------------------------------------------------------------------------------------------------------------------------------------------------------------------------------------------------------------------------------------------------------------------------------------------------------------------------------------------------------------------------------------------------------------------------------------------------------------------------------------------------------------------------------------------------------------------------------------------------------------------------------------------------------------------------------------------------------------------------------------------------------------------------------------------------------------------------------------------------------------------------------------------------------------------------------------------------------------------------------------------------------------------------------------------------------------------------------------------------------------------------------------------------------------------------------------------------------------------------------------------------------------------------------------------------------------------------------------------
-----------------------------------------------------------------------------------------------------------------------------------------------------------------------------------------------------------------------------------------------------------------------------------------------------------------------------------------------------------------------------------------------------------------------------------------------------------------------------------------------------------------------------------------------------------------------------------------------------------Q--------------------------------------------------------------------------------------------------------------------------------------------------------------------------------------------------------------------------------------------------------------------------------------------------------------------------------------------------------------------------------------------------------------------------------------------------------------------------------------------------------------------------------------------------------------------------------------------------------------------------------------------------------------------------------------------------------------------------------------------------------------------------------------------------------------------------------------------
--------------------------------------------------------------------------------------------------------------------------------------------------------------------------------------------------------------------------------------------------------------------------------------------------------------------------------------------------------------------------------------------------------------------------------------------------------------------------------------------------------------------------------------------------------------------------------------------------------------------------------------------------------------------------------------------------------------------------------------------------------------------------------------------------------------------------------------------------------------------------------------------------------------------------------------------------------------------------------------------------------------------------------------------------------------------------------------------------------------------------------------------------------------------------------------------------------------------------------------------------------------------------------------------------------------------------------------------------------------------------------------------------------------------------------------------------------
--------------------------------------------------------------------------------------------------------------------------------------------------------------------------------------------------------------------------------------------------------------------------------------------------------------------------------------------------------------------------------------------------------------------------------------------------------------------------------------------------------------------------------------------------------------------------------------------------------------------------------------------------------------------------------------------------------------------------------------------------------------------------------------------------------------------------------------------------------------------------------------------------------------------------------------------------------------------------------------------------------------------------------------------------------------------------------------------------------------------------------------------------------------------------------------------------------------------------------------------------------------------------------------------------------------------------------------------------------------------------------------------------------------------------------------------------------
--------------------------------------------------------------------------------------------------------------------------------------------------------------------------------------------------------------------------------------------------------------------------------------------------------------------------------------------------------------------------------------------------------------------------------------------------------------------------------------------------------------------------------------------------------------------------------------------------------------------------------------------------------------------------------------------------------------------------------------------------------------------------------------------------------------------------------------------------------------------------------------------------------------------------------------------------------------------------------------------------------------------------------------------------------------------------------------------------------------------------------------------------------------------------------------------------------------------------------------------------------------------------------------------------------------------------------------------------------------------------------------------------------------------------------------------------------
----QQQQ-----------E--E---------------------------------------------------------------------SSS?SS----------------------------------------SS---SSSSSSSSSSSSS-------------------------------------------------QQQ-------------------------SS-----------------SS-S-----SS--------------------Q-----Q-------------------SSSS--SSSS--SSS------------------------------------------------SSS------------------------------------------------------------------------S---SSSS-SSSSSSS?---------------------------------------------------------------------------------------------------------QQ--------------SSS--------QQQ----------------------------------------------------Q-QQ------------------------------------------SSS-------EQQQ----------------S------------------------------SSSSSSSS-------------------------------------------------------------------------------------------------------------------------------------------Q---------------SQS----QQQQ----------------------------------------------------------------------------------------------------------------SQS--SSS-----------------SSSSSSS-------------------------Q---------------------------------------------------------------------------------------------------------------------------------------------------------------------------------E------------------------------------------QQQQQ----------------------QQQ------------------------------------------------
---------------------X--X--------------------------------------------------------------------------------------------------------------------------------------------------------------------------------------------------------------------------------------------------------------------------------------------------------------------------------------------------------------------------------------------------------------------------------------------------------------------------------------o-------------------------------------------------------------------------------------------------------------------------------------------------------------------------------------------------------------------------------------------------------------------------------------------------------------------------------------------------------------------------------E-----------------------------------------------------------------------------------------------------------------------------------------------------------------------------------------------------------------------------------------------------------------------------------------------------------------XX-------------------------------------------------------------------------------------------------------------------------------------------------------------------------------------------------------------------------------------
-----------------------------------------------------------------------------------------------------------------------------------------------------------------------------------------------------------------------------------------------------------------------------------------------------------------------------------------------------------------------------------------E----------------------------------------------------------------------------------------------------------------------------------------------------------------------------------------------------------------------------------------------------------------------------------------------------------------------------------------------------------------------------------------------------------------------------------------------------------------------------------------------------<>-----------------------------------------------------------------------------------------------------------------------------------------------------------------------E-----------------------------------------------------------------------------------------------------------------------------------------------------------------------E--------------------------------------------------------------------------------------------------------------------------------------------------------------------------------------------------------
---------------------------------------------------------------------------------------------------------E------------------------------E--o---------------------------------------------------XXS------E------------------------------------E-------E--------------------------------XX------------------------------------------------------------------------------------------------<>-----------------------oo-----------------------------------E--S---------------------------------------------------------------------------E------------------------------------------------------------E--E---------------------------E-----------------------E--------------------------------------------------------E------------------------------E-------------E----------------------------------------------------------------------------------------------E--oo----------------E-----E----[]--------------E-------------------------------------------------------------------------------------------------E------------------------------------------------E--?-<>-------------------------E--?----------------E---------E-------------------------E------------o-----------E-----E------------------------------------------------E----<>-----------------------------------------------------E-----------------------------------------------------------------------------------E-----------------------------------------o----------------E---
---E?QQ--------E--<>------Q-o----------------------------------------E---------------------S?S-QQ-------<>------------------------E----<>--------QQQ-------XX------------------------E---------XXX-S--E<>---QQQQQQ-----------------E-----E--<>---E--<>------------------------------XXXX------QQ-Q--------------------------------Q--Q----------o---------------------------------------[]---E--<>----------XX---------------------X-----------------<>-----E----------------X-X------------o---------------------------------------<>--------------------------------------------------QQ-------<>-<>------------QQQQ----------<>-------------------E--<>----------------EQQQ-----------------------------------<>-----E----------QQQQ---Q-----<>------------<>----<>---------------------S------------Q------Q------------------------X------------S-------<>-------------------<>----<>----[]----o---E----<>---------Q------QQQ-----Q-Q--------------------E??SQQQQ-Q---QQQ-------QQQ--o--------------------<>---o--------------------------------------E----<>----[]-----------S?S----------<>------------------<>--------<>------------Q-----------<>-----------------------<>----<>---------S----------------------------E--------<>----[]----------------<>--------------X-----S-------------<>----------------------------------o---------------------------X--Q--QS-Q----------<>---------Q--QQ-----------------QQQo----------------------<>---
--------------<>--[]-------------------------------E----------------<>-------------o--E-----------------[]-----------------E-----<>----[]----------------XXXXX-------E--------------<>--------XXXX---<>[]-----------------------X-<>----<>--[]--<>--[]----------E-----E------------XXXXX--------------------------------X---------------------------E-------------------E---------------[]--<>--[]--------XXXX-S-------------------------------------[]----<>---------------XX--X---------------------------------------------------[]---E-------------------------------------------------------[]-[]---------------------E----[]------------------<>--[]--------------E----------------------------------------[]----<>-----------------------[]--E---------[]----[]-----------------X-----------------------------------------------XX--------------------[]-------------------[]----[]--E-[]-------<>----[]---------------------------------------------S----------------------------------------E---------[]-------------------------E---------------<>----[]----[]------------------------[]------------------[]---E----[]------------------------[]-------------------E---[]----[]--------------XX---------------------<>---E----[]----[]----------------[]-------E------X------------E------[]------X-------------------------------------------------E-----X---------------X---[]---------------------------E-------------------------<>--[]---
--------------[]--[]------------------------------<>----------------[]-------------X-<>-----------------[]----------------<>-----[]----[]---------------XXXXXX------<>--------------[]------XXXXXX---[][]-----------------------X-[]----[]--[]--[]--[]---------<>----<>-----------XXXXXX--------------------------------X--------------------------<>------------------<>---------------[]--[]--[]-------XXXXX---------------------------------------[]----[]---------------X----X--X-----------------------------------------------[]--<>-------------------------------------------------------[]-[]--------------------<>--<>[]------------------[]--[]-------------<>---------------<>-----------------------[]----[]-----------------------[]-<>---------[]----[]----------------------------------------------------------------XXX--------------------[]-------------------[]----[]--XX[]-------[]----[]---------------------------------------------S---------------------------------------<>---------[]------------------------<>---------------[]----[]----[]------------------------[]------------------[]--<>----[]----------------<>------[]---X--------------<>---[]----[]-------------XXX---------------------[]--<>----[]----[]----------------[]------<>------XX------------------[]----------------------------<>-------------------------<>-----XX--------------X---[]----------------------X---<>-------------------------[]--[]---
------------E-[]--[]---------E-----E----E---------[]-------------E--[]---------EE--X-[]-----------E-E---[]-----------EE---[]--E--[]----[]--------E-----XXXXXXX------[]---E--E--E-E--[]-----XXXXXXX---[][]--------EE-E-----------X-[]-E--[]--[]--[]--[]-------E-[]--E-[]-----------XXXXXX--------------------------------X---------E-EE-----E-E-----[]--------EE-E------[]---------E-----[]--[]--[]-------XXXXX----------EE------------------E-----E--[]----[]------E-EE---XXX---XXE-X------------------------------------E-E--EE-E--[]--[]-----------E----EE---------------E-E-------E--E-----E--[]-[]-E---------EE-E-----[]--[][]---------EE-EE----[]--[]----EE-------[]---------------[]-EE--------E-------EE--[]----[]--------------E--E-----[]-[]----E----[]----[]--------EE-E-----X-------------------EE-------E--E--------E---XXXXX--------------E-E---[]------------EE-EE--[]----[]-XXX[]-------[]----[]------E-----EE-E-----------------------------S-------------------------E-------E-----[]--E--E---[]------------------------[]----E---EE-E---[]E---[]----[]---------------------E--[]---------E--E-----[]--[]----[]--oo-E----E-----[]-E----[]-E-X--------E-E---[]---[]----[]---------E--XXXX---------EE-----E-EE-[]--[]----[]----[]----------E-----[]------[]------XX---EE-E-----------[]------X--E-EE---------------[]-------------------------[]----EXX---EE-E-------X---[]----------------------S---[]-------------------EE-E--[]--[]---
XXXXXXXXXXXXXXXXXXXXXXXXXXXXXXXXXXX-XXXXXXX-XXXXXXXXXXXXXXXXXXX--XXXXXXXXXX-XXXXXXXX-XXXXXXXXXXXXXXXXXXXXXXXXXXXXXXXXXXXXXXXXXXXXXXXXXXXXXXXXXXXXXXXXXXXXXXX--XXXX--XXXXXXXXXXXXXXXXXXXXXXXXXXXX---XXXXXXXXXXXXXXXXXXXXXXXXXXXXXXXXXXXXXXXXXXXXXXXXXXXXXXXXXXXXXXXXXXXXXXXXXXXXXXXXXXXXXXXXXXXXXXXXXXXXXXX-------XXXXX--XXXXXXXXXXXXXXXXXXXXXXXXXXXXXXXXXXXXXXXXXXXXXXXXXXXXXXXXXXXXXXXXXXXXXXXXXXXXXXXXXXXXX--XXXXXXXXXXXXXXXXXXXXXXXXXXXXXXXXXXXXXXXXXXXXXXXXXXXXXXXXXXXXXXXXXXXXXXX--XXXXXXXXXXXX---X-XXXXX-----XXXXXXXXXXXXXXXXXXXXXXXXXXXXX-XXXXXXXXXXXXXXXXXX-X-XXXXXXXXXXXXXXXXXXXXXXXXXXXXXXXXXXXXXXXXXXXXXXXXXXXXXXXXXXXXXXXXXXXXXXXXXXXXXXXXXXXXXXXXXXXXXXXXXXXXXXXXXXXXXXXXXXXXXXXXXXXXXXXXXXXXXXXXXXXXXXXXXXXXXXXXXXXXXXXXXXXXXXXXXXXXXXXX--XXXXXXXXXXXXXXXXXXXXXXXXXXXXXXXXXXXXX-XXXXXXXXXXXXXXXXXXXXXXXXXXXXXXXXXXXXXXXXXX----XXXXXXXXXXXXXXXXXXXXXXXXXXXXXXXXXXXXXXXXXXXXXXXXXXXXXXXXXXXXXXXXXXXXXXXXXXXXXXXXXXXXXXXXXXXXXXXXXXXXXXXXXXXXXXXXXXXXXXXXXXXXXXXXXXXXXXXXXXXXXXXXXXXXXXXXXXXXXXXXXXXXXXXXXXXXXXXX--XXXXXXXXXXXXXXXXXXXXXXXXXXXXXXXXXXXXXXXXXXXXXXXXXXXXXXXXXXXXXXXXXXXXX-XXXXXXXXXXXXXXXXXX--XXXXXXXXXXXXXXXXXXXXXXXXXXXXXX--XXXXXXXXXXXXXXXXXXXXXXXXXXXXXXXXXXXXXXXXXXXXXXXXXX-XX-XXXXXXXXXXXXXXXXXXXXXXXXXXXXXXXXXXXXXXXXXXXXXX-XXXXXXXXXXXXXXX-X--XXXXXXXXXXXXXXXXXXX-XXXXXXXXXXXXXXXXXXXXXXXXXXXXXXXXXXXXX-XXXXX----XXXXXXXXXXXXXXXXXXXXXXXXXXXXXXXXXXXXXXXXXXXXXXXXXXXXXX--XXX--XX--XXXXXXXXXXXXXXX--XXXXXXXXXXXX--XXXXX
