--------------------------------------------------------------------------------------------------------------------------------------------------------------------------------------------------------------------------------------------------------------------------------------------------------------------------------------------------------------------------------------------------------------------------------------------------------------------------------------------------------------------------------------------------------------------------------------------------------------------------------------------------------------------------------------------------------------------------------------------------------------------------------------------------------------------------------------------------------------------------------------------------------------------------------------------------------------------------------------------------------------------------------------------------------------------------------------------------------------------------------------------------------------------------------------------------------------------------------------------------------------------------------------------------------------------------------------------------------------------------------------------------------------------------------------------------------
-----------------------------------------------------------------------------------Q--------------------------------------------------------------------------------------------------------------------------------------------------------------------------------------------------------------------------------------------------------------------------------------------------------------------------------------------------------------------------------------------------------------------------------------------------------------------------------------------------------------------------------------------------------------------------------------------------------------------------------------------------------------------------------------------------------------------------------------------------------------------------------------------------------------------------------------------------------------------------------------------------------------------------------------------------------------------------------------------------------------------------------------------------------------------------------------------------------------------------------------------------------------------------------------------------------------------------------------------------------------------------------------------------------------------------------------------------------------------
---------------------------------------------------------------------------------------------------------------------------------------------------------------------------------------------------------------------------------------------------------------------------------------------------------------------------------------------------------------------------------------------------------------------------------------------------------------------------------------------------------------------------------------------------------------------------------------------------------------------------------------------------------------------------------------------------------------------------------------------------------------------------------------------------------------------------------------------------------------------------------------------------------------------------------------------------------------------------------------------------------------------------------------------------------------------------------------------------------------------------------------------------------------------------SSSSSS-SSSSSS----------------------------------------------------------------------------------------------------------------------------------------------------------------------------------------------------------------------------------------------------------------
--------------------------------------------------------------------------------------------------------------------------------------------------------------------------------------------------------------------------------------------------------------------------------------------------------------------------------------------------------------------------------------------------------------------------------------------------------------------------------------------------------------------------------------------------------------------------------------------------------------------------------------------------------------------------------------------------------------------------------------------------------------------------------------------------------------------------------------------------------------------------------------------------------------------------------------------------------------------------------------------------------------------------------------------------------------------------------------------------------------------------------------------------------------------------------------------------------------------------------------------------------------------------------------------------------------------------------------------------------------------------------------------------------------------------------------------------------
-----------------------------------------------------------------------------------------------------------------------------------------------------------------------------------------------------------------------------------------------------------------------------------------------------------------------------------------------------------------------------------------------------------------------------------------------------------------------------------------------------------------------------------------------------------------------------------------------------------------------------------------------------------------------------------------------------------------------------------------------------------------------------------------------------------------------------------------------------o--oo-----------------------------------------------------------------------------------------------------------------------------------------------------------------------------------------------------------------------------------------------------------------------------------------------------E----------------------------------------------------------------------------------------------------------------------------------------------------------------------------------------------------------------------------------------------------------------------------------------
----SSSSSSS----------------------SS------------E---------------------------------SSS----SSSSSQSS-------------------------------------------S-----------------------------------------------------SSS-------SSQQ-------------------------SSS---?S----------------------------------------Q--------Q-Q---------SSSS-------------SSSSSS-----------S----------------------------------------------------------------------------------------QQQQ-------------------------Q---Q-------------------------?QQQQ-----------------------QQQQQ-----------------SS-----------SQQ-------------------------------------------SSSSSSSS-----------------------S-------------------------------------------------------------------------------------SSS-------------------------Q------------------------SSSSSS---------------------------------------------------------------------------------SSSSSSS----------------------------------------------QQQQ-----------------------QQQ-Q-?------------QQQ-------------------------------------------------------------SSQSSQ-Q------QQ----------------------------------------SSQQ---------------------------------------------SSS----QQQQ-Q-------------------------------------------------Q--QQ-QQQ-------------------------------------------------QQQ----------------------------SSSS-----------------------------SSS-------------------------------------------------?Q?SS-----Q------------SSS---------------------
---------------------------------------------------------------------------------------------------------------------------------------------------------------------------------------------------------------------------------------------E----------------------------------------------------------------------------------------------------------------------------------------------------------------------------------------------------------------------------------------------------------------------------------------------------------------------------------------------------------------------------------------------------------------------------------------------------------------------------------------------------------------------------------------------------------------------------------------------------------------------------------------------------------------------------------------------------------------------------------------------------------------------------------------------------------------------------------------------------------------------------------------------------------------------------------------------------------------------------------------------------------------------------------------------------------------------------------------------------------------------------------------------------------------------------------------------------------
-------------E------------------------------------------------------------------------------------------------------------------------------------------------------------------------------------------------------------------------------<>----------------------------------------------------------------------------------------------------------------------------------------------------------------------------------------------------------------------------------------------------------------------------------------------------------------------------------------------------------E-----------------------------------------------------------------------------------------------------------------------------------------------------------------------------------------------------------------------------------------------------------------------------------------------------------------------------------------------------------------------------------------------------------------------------------------------------------------------------------------------------------------------------------------------------------------------------------------------------------------------------------------------------------------------------------------------------------------------------------------------------------------------------------------------------------------------------------------------
------------<>-------E-----------------XX----------E---------------------------E-------------------------E-----------------------------------oo--------------------------------------------------------------------------E---------------E--[]---------------------E--S------E--------------------------------------------------------------E------------oo--------------------------------------------------------------------------------------------E---------------------E------------------------------------------------------------------------------------------------------E------------------<>------------------------------------------------E---------------oo-----------E----------------------------------------------------------E----------E--------------------------------------------E-------------------E---------------oo---------------------------------------------------E------------------E--o-----------------------------------------------------------------------------------------oo-------------------------------------------------------------------------E--------------------------------------------------------------E---------------------S----------------------------------------------------------E------------------------------------------------------------------E-------------------------------------------------------------------------------------E--------------------------------------E----------
---------E--[]------<>---QQ----SSS-----XX---------<>------E-------------------<>----------SSQS----------<>---QQ-------------------------E------o----XX------------------------------------------X----------QQQQ---Q-----<>---QQ---------<>--[]------<>------------<>-----E--<>----------ooo-----QQ---Q------------XX--------------------o--<>----------E-----E---QQ----------Q-Q-------------<>---------------------------E------------QQQQS----------<>-----QQQ------QQQQ--<>-----------------XX--SQS--<>---------------------SS-----------------E--QQ-----Q-----S?S-----------o--<>---QQ----------E--[]---------Q-------------------------------------<>----------------------<>---<>-----E---------Q---------------------------S----------E--<>---QQQ---<>-----------------------------SSSS----------<>-------QQQQ-------<>----------------------XXXXX--------------------X-------------------<>-----------------<>-------------Q--QQQQ----------<>---QQQ---E--QQQQ-Q------------QQQQ---------XXX-----------E----o----------QQ---------------E----SQQQQQQQQ---Q--Q--------------------E--<>--------------?QQQQQ-Q-Q---QQQ-------Q----------------------X<>--S----SSSSSQQ----E----<>--oQoo-------------E---------XX------E--QQ-Q----------<>----------XX------------------E------E--QQ-----------------QQQ---<>---QQ-------E----------o---------E------Q-Q-----------------Q-------E---------------<>----QQ----Q--QQ-----Q-----QQQ-----E--<>----------
--------<>--[]------[]----------------XXX---------[]-----<>-------------------[]------------------------[]-----------------------------<>------------------------------------------------------XX-----------------------[]--------------[]--[]------[]------------[]----<>--[]-----------------------------------XXX---------------------E-[]----------E----<>-------------------------------[]--------------E-----------<>---------------------------[]--------------------[]-----E----------XXX-------[]---------------------------------------<>--------------------------------[]-----------E--<>--[]----------------E-------E----------------------[]----------------------[]---[]----<>---X------------E--X---XX-------X--------------<>--[]---------[]-------------------------------------------[]------------------[]----------X---------------------------------E--XX------------------[]-----------------[]---E--------------------------[]------------------------------------------XXX-----------<>--------------------------------S---------------------------------------<>--[]------------------------------------------------------------X[]-----------------<>----[]------------------<>---------XX-----------------------[]----------XX-----------------<>-----------------------<>---------[]-----------<>--------------E----<>---------------------------------<>---------------[]---------------------------------<>--[]----------
--------[]--[]------[]---------------XXXX---------[]-----[]-------------------[]------------------------[]-----------------------------[]-----------------------------------------------------XX------------------------[]--------------[]--[]------[]------------[]----[]--[]--------------------------------EXXXXX--------------------<>-[]---------<>----[]-------------------------------[]-------------<>-----------[]---------------------------[]--------------------[]----<><>---<>---XXX-------[]---------------------------------------[]--------------------------------[]----------<>--[]--[]---------------<>--X---<>----------------------[]--------------------<>[]---[]----[]---X-----------<>------XX-------X--------------[]--[]---------[]-------------------------X-----------------[]------------------[]----------X------------------------------------XX---S--------------[]-----------------[]--<><>------------------------[]-----------------------------------------XXXXX----------[]--------------------------------S---------------------------------------[]--[]-----------------------------------------------------------XX[]---S-------------[]----[]------------------[]--------XXX-------------------X---[]----------XXX----------------[]-------------------X---[]---------[]-----------[]-------------<>----[]---------------------------------[]---------------[]---------------------------------[]--[]----------
-----E--[]--[]------[]---------EE---XXXXX--X------[]-E---[]--E--------E-EE----[]------------------------[]---------EE---------E----E---[]----------------------------------E-E-----------E-E---X---------------E--EE----[]-----------E--[]--[]------[]--------E---[]----[]--[]-----------------------EE-E------XXXXX--------------------[]-[]---------[]----[]--------------------E-----E-E--[]-------------[]--E--------[]-------------E-E-----------[]------E-------E-EE--[]----[][]-E-[]----XX---E---[]--------------------E-------E-------EE-[]-----------------------E-E---E--[]--------E-[]--[]--[]--------EE-EE--[]--X---[]-E-E--------E---------[]--------------------[][]E--[]----[]---X----EE-E---[]--X---X--X-----X---EE---------[]--[]---------[]--------EE-EE------------X--EE-E-----------[]-------E-EE-E-----[]----------X-----------------------------------------SSoo-----------[]----EE-E---------[]--[][]-----X----E-E-----------[]------------E-------E-EE----------EE----XXXXXX--SSS-----[]-----------------EE-------------S-------------E-EE----EE-E---E-EE-EE----[]--[]-----------------------------------------E-EE--------------XX[]------------E----[]----[]-------E-E---E-E--[]-------XXXX-------------------X---[]-------E--XXX-------E-EE-E---[]---------E-------------[]---------[]---E-----E-[]-----------E-[]----[]-----------------------E---------[]------------E--[]----------------E-E-----E--E-----[]--[]-----E-EE-
-XXXXXXXXXXXXXXXXXXXXXXXXXXXXXXXXXXXXXXXXXXX-XXXXXXXXXXX-XXXXXXXXXXXXXXXXXXXXXXXXXXXXXXXXXXXXXXXXXXXXXXXXXXXXXXXXXXXXXXXXXXXXXXXXXXXXXXXXXXXXXXXXXXX---XXXXXXXX----XXXXXXXXXXXXXXXXXXXXXXXXXXXXXXXXXXXXXXXXXXXXXXXXXXXXXXXXXXXXXXXXXXXXXXXXXXXXXXXXXXXXXXXXXXXXXXXXXXXXXXXXXXXXXXXXXXX--XXXXXXXXXXXXXXXXXXXXXXXXXXXXXXXX-X-XXXXXXXXXXXXXXXXXXXXXXXXXXXXXXXXXXXXXXXXXX-XXX---XXXXXXXXXXXXXXXXXXXXXXX--XXXXXXXXXXXXXXXXXXXXXXXXXXXXXXXXXXXXXXXXXXXXXXXXXXXXXXXXXXXXXXXXXXXXXXXXXXXXXXXXXXXXXXXXXXXXXXXXXXXXXXXXXXXXXXX-XXXXXXXXXXXXXXXXXXXXXXXXXXXXXXXXXXXXXXXXXXXXXXXXXXXXXXXXXXXXXXXXXXXXXXXXXXXXXXXX--XXXSXXXXXXXXXXXXXXXXXXXXXXXXXXXXXXXXXXXXXXXXXXXXXXXXXXXXXXXXXXXXXXX-XXXXXXXXXXXXXXXXXXXXXXXXXXXXXXXXXXXXXXX--XXXXXXXXXXXXXXXXXXXXXX--XXXXXXXXXXXXXXXXXXXXXXXXXXXXXXXXXXXXXXXXXXXXXXXXXXXXXXXXXXXXXXXXXXXXXXXXXXXXXXXXXXXXXXX-XX--XXXX----XXX------XXXXXXX---XXXXXXXX--XX---XXXXXXXXXXXXXXXXXXXXXXXXXXXXXXXXXXXXXXXXXXXXXXXXXXXXXXXXXXXXXXXXXXXXXXXXXXXXXXXXXXXXXXXXXXXXXXXXXXXXXXXXXXXXXXXX--------XXXXXXXXXXXXXX---XXXXXXXXXXXXXXXXX-XXXXXXXXXXXXXXXXXXXXXXXXXXXXXXXXXXXXXXXXXXXXXXXXXXXXXXX-XXXXXXXXXXXXXXXXXXX-------XXXXXXXXXXXXX-XXXXXXXXXXXXXXXXXXXXXXXXXXXXXXXXXXXXXXXXXXXXXXXXXXXXXXXXXXXXXXXXXXXXXXX----XXXXXXXXXXXXXXXXXX--XX--XXXXXX-XXX---XXXXXXXXXXXXXXXXXXXXXXXXXXXXXXXXX-XXXXXXXXXXXXXXXXXXXXXXXXXXXXXXXXXXXXXXXXXXXXXXXXXXXXXXXXXXXXXXXXX---XXXXXXXXX-XXXXXXXXXXXXXXXXXXXXXXXXXXXXXXXXXXXXXXXXXXXXXXXXXXXXXXXXXXXXX--XXXXXXXXXXXX
