--------------------------------------------------------------------------------------------------------------------------------------------------------------------------------------------------------------------------------------------------------------------------------------------------------------------------------------------------------------------------------------------------------------------------------------------------------------------------------------------------------------------------------------------------------------------------------------------------------------------------------------------------------------------------------------------------------------------------------------------------------------------------------------------------------------------------------------------------------------------------------------------------------------------------------------------------------------------------------------------------------------------------------------------------------------------------------------------------------------------------------------------------------------------------------------------------------------------------------------------------------------------------------------------------------------------------------------------------------------------------------------------------------------------------------------------------------
--------------------------------------------------------------------------------------------------------------------------------------------------------------------------------------------------------------------------------------------------------------------------------------------------------------------------------------------------------------------------------------------------------------------------------------------------------------------------------------------------------------------------------------------------------------------------------------------------------------------------------------------------------------------------------------------------------------------------------------------------------------------------------------------------------------------------------------------------------------------------------------------------------------------------------------------------------------------------------------------------------------------------------------------------------------------------------------------------------------------------------------------------------------------------------------------------------------------------------------------------------------------------------------------------------------------------------------------------------------------------------------------------------------------------------------------------------
--------------------------------------------------------------------------------------------------------------------------------------------------------------------------------------------------------------------------------------------------------------------------------------------------------------------------------------------------------------------------------------------------------------------------------------------------------------------------------------------------------------------------------------------------------------------------------------------------------------------------------------------------------------------------------------------------------------------------------------------------------------------------------------------------------------------------------------------------------------------------------------------------------------------------------------------------------------------------------------------------------------------------------------------------------------------------------------------------------------------------------------------------------------------------------------------------------------------------------------------------------------------------------------------------------------------------------------------------------------------------------------------------------------------------------------------------------
--------------------------------------------------------------------------------------------------------------------------------------------------------------------------------------------------------------------------------------------------------------------------------------------------------------------------------------------------------------------------------------------------------------------------------------------------------------------------------------------------------------------------------------------------------------------------------------------------------------------------------------------------------------------------------------------------------------------------------------------------------------------------------------------------------------------------------------------------------------------------------------------------------------------------------------------------------------------------------------------------------------------------------------------------------------------------------------------------------------------------------------------------------------------------------------------------------------------------------------------------------------------------------------------------------------------------------------------------------------------------------------------------------------------------------------------------------
---------------------------------------------------------------------------E----------------------------------------------------------------------------------------------------------------------------------------------------------------------------------------------------------------------------------------------------------------------------------------------------------------------------------------------------------------------------------------------------------------------------------------------------------------------------------------------------------------------------------------------------------------------------------------------------------------------------------------------------------------------------------------------------------------------------------------------------------------------------------------------------------------------------------------------------------------------------------------------------------------------------------------------------------------------------------------------------------------------------------------------------------------------------------------------------------------------------------------------------------------------------------------------------------------------------------------------------------------------------------------------------------------------------------------------------------------------------
----------------S--------------------------------------------SS------------E--E--------Q-Q-----Q-----------------------SSSS--------------SQ---------------------------XX-QQQ-------Q-----------------------------------------------SSSSSSS-----------------------------------------------------?-QQ-----------------------------------------------------------------------SS-----SQQ-Q----------------------SSS----SSSSSSS---------------------------------------------S-?S?--------------------------------------------------------------------------------------------------------------------------------------------------------------------------------------------------------------------------------------------------------SSSS-------------------------------------------------------------------------------SSSSS-------------------Q-QQQ-Q-----------------------------------------------------------------------------------QQ--------------------------QQQ---------------------------------------------------------------------------------------------------------SS-SSS----------------------------------------Q--QQ-------S-Q----------------------------SS----------------SQ---------------------------------SSSS------QQQ------------SSS----SSS--------------------------------------------SSS--SSSSSSSS?-----------------S----------------------------------------------------SSSSSSSSSSSSSS-S--------------------------------------
-----------------------------------------------------------------------------XXX-X---------------------------------------------------------------------------------------------------------------------------------------------------------------------------------------------------------------------------------------------------------------------------------------------------------------------------------------------------------------------------------------------------------------------------------------------------------------------------------------------------------------------------------------------------------------------------------------------------------------------------------------------------------------------------------------------------------------------------------------------------------------------------------------------------------------------------------------------------------------------------------------------------------------------------------------------------------------------------------------------------------------------------------------------------------------------------------------------------XX-----------------------------------------------------------------------------------------------------------------------------------------------------------------------------------------------------------------------------------------------------------------
----------------------------------------------------------------------------------------------------------------------------------------------------------------------------------------------------------------------------------------------------------------------------------------------------------------------------------------------------------------------------------------------------------------------------------------------------------------------------------------------------------------------------------------------------------------------------------------------------------------------------------------------------------------------------------------------------------------------------------------------------------------------------------------------------------------------------------------------------------------------------------------------------------------------------------------------------------------------------------------------------------------------------------------------------------------------------------------------------------------------------------------------------------------------------------------------------------------------------------------------------------------E---------------------------------------------------------------------------------------------------------------------------------------------------------------------------------------
--------------------------E------------------------------------------------E--------------------------------------E---------------E-------------------------------oo-------------------------------------------------------E----------------------------------------------------------E----------------------------------------------E----------------------------E-----E--------------------------------------------------------------------------------------------------------------------------------------------------o-----------------oo---------------------------------------------------------------------oo-------E-------------------------------E-----------------------------E-----------------------------------------------------------------------------E----------------------------E------------------------------E-E-----------------------------------XX------------------------------------E---------------------------------------------------------------E---------------------------E----------------------------------------------------------------------------------------------------------------------------------------------E--------------------E-------------------------------------------------------------------------------------------------------------------E----------X---S-E------------E----------------------------------------------------------------------E---------------------------------------------
oS-----------------------<>----Q---------------------------------E-S------<>-----------Q-QQ------------------QQQ-<>----S?S-------<>------Q?Q-----------------------------QQ----Q--QQQQ-----------------Q------------------<>--------------------------------o---------E--------------<>---------QQ---E---------------------------E--<>---------------------------<>----<>------E?SQSQQ-----------E---------------------------------------------------E-----------------SSS----------------------------------<>-------------------S-----------------------------E-----E------------------------------------------------------<>------------------------------<>---------------QQ-----------<>-------Q-----------------------E>--------S----------------------------------<>-----------------------E---<>---------------QQQ---<>------<><>-------Q--QQ-------------------Q--XXX-------<>---<>---------------------<>---------------------------------------------Q---QQQ----------<>---QQQX-------------------<>---E-----Q---------------------------------Q----------E------------QQQ-----------------------------------------QQ------------S---------------<>-------------------<>----------QQQ-----------------------------X--------Q---QQQ-------------------E-----E------------------QQ-------E--<>---------XXX--S-------------<>-----------------------------------------------------------------XX--------------------------XXX--------------------
-------------------------[]--------------------------------------E--------[]------E<-----------------------------[]--------------[]---------------------------------------------------------------------------------------[]-----------------------------------------<>---E----------[]-------------<>--------------------------<>--[]---------------------E-----[]----[]---S--------------E---E<>----E<----------------SS--------------------------<>---------------------------------------------E--------[]--------------------------E---------------------<>----<>--------------------E---------------------------------[]-----E------------------------[]----------------------------[]-----------------E-------------E]-------------------------------------------[]---------------------E<>---[]--E-<>---------------[]------[][]--------------------X---<>-------XXXX-------[]---[]---------------------[]--------------------------------------------------------------[]------XX------------------[]--<>-------------------------------------------E-----<>--------------------E-----------------------------------------------------------------[]----XX-------------[]------------------------------------------X---------------------------------<>----<>--------------------------<>--[]--E-----XXXX----------------[]------------------------------------------------E-------E------XXXX-------------------------XXXXX<>-----------------
-------------------------[]--------------------E----------------<>--------[]--<>-<>[-----------------------------[]--------------[]-----------------------------------------<>--------------------------------------------[]-----------------------------------------[]--<>----------[]-------------[]--------------------------[]--[]--------------------<>-----[]----[]---S-------------<>--<>[]---<>S----------------S---------------------------[]--------------------------------------------<>--------[]-------------------------<>---------------------[]----[]-------------------<>---------------------------------[]----<>------------------------[]----------X-----------------[]----------------<>--------------S-------------------------------------------[]--------------------<>[]---[]-<>-[]---------------[]------[][]--------------------X---[]------XXXXX-------[]---[]---------------------[]--------------------------------------------------------------[]------XX------------------[]--[]-------------------------------------------------[]-------------------<>--X-------------o------------------------------------------------[]---XXX----X--------[]----<>------------------------------------X---------------------------------[]----[]--------------------------[]--[]-------XXXXX--SSS-----------[]-----------------------------------------------<>------<>-----XXXXX------------------------XXXXXX[]-----------------
EE-------------EE-E--E---[]---------------E-------------E-EE----[]--------[]--[]-[]X-----------------------------[]-----EE-E-----[]------------------------E----------------[]-----------------------E-EE-EE--------------[]-----------E--------------EE-E-----------[]--[]----------[]------E--E---[]---------------E-EE-E-----[]--[]-----E-----E-EE-----[]--E--[]----[]---S-------------[]--[][]---[]S---E-----------------o------------EE--------[]---------------------------------------E--E-[]-E------[]-E-----------------------[]--------------EE-E---[]----[]-----------E--E----[]-------------E---------EE----E---[]----[]-----X---EE-E-----------[]------------------E--E------[]----------------[]----------E---S-------E----------------------EE-EE-E------[]-----------E-EE--E--[][]---[]-[]-[]--------EE-----[]------[][]--------------------X---[]-E-E--XXXXXEE-----[]---[]-------------E-EE----[]-------------------EE-----E-E-E-----EE-E---X----E-------------[]------XX---EE-E-----------[]--[]-------------------------EE----------------------[]------------EE-----[]--X---------------------------EE----------------E-E-----E-E--E---[]---XXXE--EX--------[]----[]-Eoo-------------E-E-----E----------X--------------------------EE-E-X-[]----[]----EE-E--------E-----E---[]--[]------XXXXXX-E--------------[]--------------------------EE-E---------------E-[]------[]-----XXXXX--SSSSSS---------------XXXXXXX[]-----E-----------
XXXXXXXX--XXXXXXXXXXXXXXXXXX--XXXXXXXXXXXXXXXXXX----XXXXXXXXXXXXXXXXXXXXXXXXXXXXXXXXXXXXXXXXXXXXXXXX-----XXXXXXX-XXXXXXXXXXXXXXXXXXXXXXXXXXXXXX------XXXXXXXXXXXXXX--XXXXXXXXXXXXXXXXXXXXXXXXXX---XXXXXXXXXXXXXXXXXX-XXXXXXXXXXXXXXXXXXXXXXXXXX---XXXXXXXXXXXXXXXXXXXXXXXXXXXXXXXXXX-XXXXXXXXXXXXXXXXXXXXX-XXXX-XXXXXXXXXXXXXXXXXXXXXXXXXXXXXXXXXXXXXXXXXXXXXXXXXXXXXXXXXXXXXXXXXXXXXXXXXXXXXXXXXXXXXXXXXXXXXXXXXXXXXXXXX---XXXXXXXXXXXXXXXX-XXXXXXXXXXXXX-XXXXXXXXXXXXXXXXXXXXXX--X---XXXXXXXXXXXXXXXXXXXXXXXXXXXXX-X--XXXXXXXXXXXXXXXXXXXXX---XXXXXXXXXXXXXXXXXXXXXXXXXXXXXXXXXXXXXXXXXXXXXXXXXXXXXXXXX-XXXXXXXXXXXXXXXXXXXXXXXXXXXXXXXXXXXXXXXXXXXXXXXXXXXXXXXXXXXXXXXXXXXXXXXXXXXXXXXXXXXXXXXXXXXXX-XXXXXXXXXX--X-XXXXXXXXXXXXXXXXXXXXXXXXXXX-XXXXXXXXXXXXXXXXXXXXXXXXXXXXXXXXXXXXXXXXXXXXXXXXXXXXXXXXXXXXXXXXXXXXXXXXXXXXX-XXXXXXXXXXXXXXXXXXXXXXXXXXXXX-XXXXXXXXXXXXXXXXXXXXXXXXXXXXXXXXXXXXXXXXXXXXXXXXXXXXXXXXXXXXXXXX-XXXXXXXXXXXXXXXXXXXXXXXXXXXXXXXXXXXXXXXXXXXXXXXXXXXXXXXXXXXXXXXXXXXXXXXXXXXXXXXXXXXXXXXXXXXX--XXXXX------XXXXXXXXXXXXXXXXXXXXXXXXXX-XXX---XXXXXXXXXXXXXXXXXXXX--------XXXXXXXXX-X-XXXXXXXXXXXXXXXXXXXXXXXXXXXXXXXXXXXXXXXXXXXXXXXXXXXXXXXXXXXXXXXXXXXXXXXXXXXXXXXXXXXXXXXXXXXXXXXXXXXXXXXXXXXXXXXXXXXXXXXXXXXX----XXXXXXXXXXXXXXXXXXXXXXXXXXXXXXXXXXXXXXXXXXXXXXXXXXXXXXXXXXXXXXXX------XXX-XX-XXXXXXXXXXXXXXXXX---XXXXXX--XXXXXXXXXXXXXXXXXXXXXXXXXXXXXXXXXXXXXXXXXXXX--------XXXXXXXXXXXXXXXXXXXXXX-XXXXXXXXXXXXXXXXXXX
