--------------------------------------------------------------------------------------------------------------------------------------------------------------------------------------------------------------------------------------------------------------------------------------------------------------------------------------------------------------------------------------------------------------------------------------------------------------------------------------------------------------------------------------------------------------------------------------------------------------------------------------------------------------------------------------------------------------------------------------------------------------------------------------------------------------------------------------------------------------------------------------------------------------------------------------------------------------------------------------------------------------------------------------------------------------------------------------------------------------------------------------------------------------------------------------------------------------------------------------------------------------------------------------------------------------------------------------------------------------------------------------------------------------------------------------------------------
-----------------------------------------------------------------------------------------------------------------------------------------------------------------------------------------------------------------------------------------------------------------------------------------------------------------------------------------------------------------------------------------------------------------------------------------------------------------------------------------------------------------------Q--------------------------------------------------------------------------------------------------------------------------------------------------------------------------------------------------------------------------------------------------------------------------------------------------------------------------------------------------------------------------------------------------------------------------------------------------------------------------------------------------------------------------------------------------------------------------------------------------------------------------------------------------------------------------------------------------------------------------------------------------------------------------------------------------------------------------------------------------------------------------------------------------------------------------------
---------------------------------------------------------------------------------------------------------------------------------------------------------------------------------------------------------------------------------------------------------------------------------------------------------------------------------------------------------------------------------------------------------------------------------------------------------------------------------------------------------------------------------------------------------------------------------------------------------------------------------------------------------------------------------------------------------------------------------------------------------------------------------------------------------------------------------------------------------------------------------------------------------oo---------------------------------------------------------------------------------------------------------------------------------------------------------------------------------------------------------------------------------------------------------------------------------------------------------------------------------------------------------------------------------------------------------------------------------------------------------------------------------------------------------------------------------------------
---------------------------------------------------------------------------------------------------------------------------------------------------------------------------------------------------------------------------------------------------------------------------------------------------------------------------------------------------------------------------------------------------------------------------------------------------------------------------------------------------------------------------------------------------------------------------------------------------------------------------------------------------------------------------------------------------------------------------------------------------------------------------------------------------------------------------------------------------------------------------------------------------------XX---------------------------------------------------------------------------------------------------------------------------------------------------------------------------------------------------------------------------------------------------------------------------------------------------------------------------------------------------------------------------------------------------------------------------------------------------------------------------------------------------------------------------------------------
-----------------------------------------------------------X--------------------------------------------------------------------------------------------------------------------------------------------------------------------------------------------------------------------------------------------------------------------------------------------------------------------------------------------------------------------------------------------------------------------------------------------------------------------------------------------------------------------------------------------------------------------------------------------------------------------------------------------------------------------------------------------------------------------------------------------------------------------------------------------------------------------------------------------------------------------------------------------------------------------------------------------------------------------------------------------------------------------------------------------------------------------------------------------------------------------------------------------------------------------------------------------------------------------------------------------------------------------------------------------------------------------------------------------------------------------------------------------
----------------------------------XXXX---E-----XX--------------------------E--------Q--------------------------------------------------------------QQQQ--------------------------------------------S--------------------------------------------------------o--------------------------------------------------------------QQQQQ-------------------------QQ?-------------------------------------------------------------------------------------SSS-----S-SSSQQ----------------------------------------------------SSQQ------S---SSSSS----------------SS--SSS-----S--Q----------------SSSSS-----------------------------------------------------SS----------------------------------------------------------------------------------------------------------------------------------------SSSSSSSSS-----------------SQSSS---------------------------Q-Q-------------------------------------------S--------S----------X-----------------------------------------Q-------------------------------QQ----------------------------S-----------------------------------------SSS---------------------------S----------------------------------------------------------------------------------SS----SSS----------------------------------------------------------Q----------------------QQQQ-Q----------------------------------------------------------------------------------------------------------------S?--------------------------------------------
------------------------------------------X----XX--------------------------------------------------------------X-----------------------------------------------------------------------------------------------------------------------------------------------------------------------------------------------------------------------------------------------------------------------------------------------------------------------------------------------------------------------------------------------------------------------------------------------------------------------------------------------------------------------------------------------------------------------------------------------------------------------------------------------------------------------------------------------------------------------------------------------------------------------------------------------------------------------------------------------------------------X----------------------------------------------------------------------------------------------------------------------------------------------------------------------------------------------------------------------------------------------------------------------------------------------------------------------------------------------------------------------------------------------------------------------------------------------------------------------
---------------------------------------------XXX-------------------------------E-----------------------------XXX--------------------------------------------------------------------------------------------------------------------------------------------------------------------------------------------------------------------------------------------------------------------------------------------------------------------------------------------------------------------------------------------------------------------E------------------------------------------------------------------------------------------------------------------------------------------------------------------------------------------------------------------------------------------------------S------------------------------------------------------------------------------------------------------------------------------------------------------------------------------------------------------------------------------------------------------------------------------------------------------------------------------------------------------------------------------------------------------------------------------------------------------------------------------------------------------------------------------------------------------------------------------------------------------------------------------------------------------------
-----------------E-----E--------------------XXXX------------------------------<>----------------------------XXXX-------------------------------------------------E------------------------E---------------------------------------------------------------------E------------------XX----------------------------------------------------E----------E------------E-----------------------E-------E----------------------------------------E--------------------------------------E------------E----------------------------------XSS---------------------------------E-------------------------------E-----------------------E-----------------------------------------------------------E-------------------E----E--------------------------------------------------E-------E----------S--So---------------------------------------------------------------------------------------------------E----------------------------------------------------------------------------------------------------E--?---------------------------------------------------------------------------------------------------------------------------------------------E---------------------------E-----E--------------------------------------------------------X----E---------------E--E--------------------------------------------------------E---------E-------------------E----------------------------------------------------E---------------------E--S---------
----------------<>----<>--------------S----XXX-XX----XXX----------------------[]----o--<>--------Q--QQQ----XXXX-----E-----E--------------------Q--QSQS-------E--<>----E---E--------------<>------------------S----------E--------------------------------------<>-----E-----------EXX------QQ----------------------------EQQQQQQ--------<>-----Q---<>---SS------<>-------------Q--------<>------<>----QQo-----------------------------E--<>-----Q----<>------QQQ----------------<>-----------<>--------------<>---------Q-------XXX-------------------Q-------------<>---------Q---------S----------<>----------------------<>--------------E------------Q---------------------E-----E--<>------------------<>---<>---------Q--E--------X------Q--------X-----------<>------<>--------E----SSS--Q----Q--<>---Q--------Q--------------E---QQQ--E---E--SQQQ-----------------------QQ----------E--<>-----------------------------------------E----------------------QQ---------------------------QSQ---<>-----------------------------------------------------------E---------------E-------------------------Q---------E---E-------------<>------------<>--------------------------<>----<>--------Q-------E--------------------------------------XXX--<>---E--S-------<>-<>---------E?SQQQ----------------------------------------<>--------<>---SS----------E-----------------------<>------XX--------Q-------------<>---------------QS---<>-----E------
----------------[]----[]------------------XXXX-XX--------------------------E--[]-------[]-----------------XXXXX---E<>----<>---------------------------------<>--[]----E--<>--------------[]---------------EE------E----<>--------------------------------------[]----<>----------XXXX---------------X-----------------------------------[]---------[]-----------[]----------------------[]------[]-----------------------------------<>--[]----------[]-------------------------[]-----X-----[]--------------[]----------------XXXX---------------------------------[]---E--------------------------[]----------------------[]-------------<>---------------------------------<>----<>--[]--E---------------[]---[]-----E---?----------XX--S------------XX----------[]------[]--E----<>-----------------[]--------------------------<>-------<>--<>----------------------------------------<>--[]---------------------------------E-E----<>---------------------------------------------------------[]----------------------------------------------------------<>-----E--------<>----------------------------------<>--<>-------------[]------------[]--------------------------[]----[]---------------<>---------E---------------------------XXX---[]--<>----------[]-[]--E----------------------E------E----------------------[]--------[]--------------<>-----------------------[]-----XXX----------------------[]--------------------[]----<>---E--
----------------[]----[]-----------------XXXXX-XX-------------------------<>--[]-------[]----------------XXXXXX--<>[]--X-[]---------------------------------[]<>[]---<>--[]--------------[]----------------------<>----[]------------------X-------------------[]----[]---------XXXXX--------------X-X----------------------------------[]---------[]-----------[]----------------------[]------[]-----------------------------------[]--[]----------[]-<>----------------------[]-----X-----[]--------------[]---------------XXXXX---------------------------------[]--<>--------------------------[]----------------------[]-------------[]----<>---------------------------[]----[]--[]------------------[]---[]----<>-------------XXX---------------XX----------[]------[]-<>----[]-----------------[]----------------------<>--[]-------[]--[]----------------------------------------[]--[]--------------------------------<><>----[]---------------------------------X-----<>----------------[]----------------------------------------------------------[]----<>--------[]----------------------------------[]--[]-------------[]------------[]--------------------------[]----[]---------------[]--------<>--------------------------XXXXX--[]--[]----------[]-<>-<>---------------------<>-----<>----------------------[]-----X--[]--------------[]-----------------------[]----XXXX------------------X---[]--------------------[]----[]--<>--
-E-EE-E-----E---[]----[]----------------XXXXXX-----------E-EE-EE--E-E-----[]--[]----E--[]-----------E---XXXXXXX--[][]--X-[]----------------------EE-----E-E-[][][]---[]--[]--------E--E--[]----------------------[]----[]-------------EE---X-------------------[]----[]--------XXXXXX--------------XXX--------------------E--E----EE----[]-E-EE----[]-E-------E-[]----------------E-----[]------[]----E--------------E---------------[]-E[]----------[]-[]-------E-EE-EE--------[]-----X-----[]--------E--E--[]E-------------XXXXXX--SSSSS-------------EE-E---------[]--[]-E-EE---------------------[]-------E-EE-EE--------[]-------------[]--E-[]---E-E---------------E-E---[]----[]--[]-----------EE-----[]---[]----[]------------XXXX---------------XX---EE-E---[]------[]-[]----[]-----------------[]---E-------EE-------E-[]--[]-E-EE--[]--[]-------E-------E------------------E-----[]--[]-----------EE----E--E-E---------[][]----[]-----EE----------------E---------X-----[]---------EE-E---[]-----------------------------------------------EE-EE------[]----[]--------[]-----------------------E--E-EE----[]--[]-------------[]--E-----EE--[]--------------EE-E-----E--[]----[]---------EE-E--[]--------[]------E-E--E--------E---XXXXXXX--[]--[]-------E--[]-[]-[]---------E-----------[]-----[]----------------------[]--------[]--------------[]-----------E-EE--------[]---XXXXX-------EE-----E-E-X---[]------------E-E-----[]----[]--[]--
XXXXXXXXXXXXXXXXXXXXXXXXXXXX--X-X---QXXXXXXXX-----------XXXXXXXXXXXXXXXXX-XXXXXXXXXXXXXXXXXXXXXXXXXXXXXXXXXXXX---XXXXXXX-XXXXXXXXXX-XXXXXX--XXXXXXXXXXXXXXXXXXXXXXXXXXXX-XXXXXXXXXXXXXXXXXXXXXXXXXXXXXXXXXXXXXXXXXXXXXXXXXXXXXXXXXXXXXXXXXXXXX-XX-X-X-XX-XXXXXXXXXXXXXXXXXXXXXXXXXXX---XXXXXXXXXXXXXXXXXXXXXXXXXXXXXXXXXXXXXXXXXXXXXXXXXXXXXXXXXXXXXXXXXXXXXXXXXXXXXXXXX-XXXXXXXXXXXXXXXXXXXXXXXXXXXXXXXXXXXXXXXXXXXXXXXXX-XXX-X---X-XXXXXXXXXXXXXXXXXXXXXXXXXXXXXXXXXXXXXXXXXXXXXXXXXXX-XXX-XXXXXXXXXXXXXXXXXXXXXXXXXXXXXXXXXXXXX------X---XXXXXXXXXXXXXXXXXXXXXX--XXXXXXXXXXXXXXXXXXXXXXXXXXXXXX--XX--XXXXXXXXXXXXXXXXXXXXXXXXXXXX-XXXXXXXXXXXXXXXXXXXXXXXXX-X-XXXXXXXXXXXXXXXXXXXXXXXXXXXXXXXXXXXXXXXXXXXXXXXXXXXXXXXXXXXXXXXXXXXXXXXX----XXXXXXXXXXXXXXXXXXXXXXXXXXXXXXXXXXXXXXX-XXXXXXXXXXXXXXXXXXXXXXXXXXXXXXXXXXXXXXXXXXXXXXXXXXXXXXX-XXXXXXXXXXXXXXXXXXXXXXXXXXXXXXXXXXXXXXXXXXXXXXXXXXXXXXXXXXXXXXXXXXXXXXXXXXXXX-XXXXX-XXXXXXXXXXXXXXXXXXX-XXXXXX-XXXXXXXXXXXXXXXXX-XXXXXXXXXXXXXXXXXXXXXXXXXXXXXXXXXXXXXXXXXXXXXXXXXXXXXXXX-XXXXXXX-X-XXXXXXXXXXXXXXXXXXXXXXXXXXXXXXXXXXXXXXXXXXXXXXXXXXXXXXXXXXXXXXXXXXXXXXXXXXXXXXXXXXXXXXXXXXXXXXXXXXXXXXXXXXXXXXXXXXXXXXXXXXXXXXXXXXXXXXXXXXXXXXXXXXXXXXXXXXXXXXXXXXXXXXXXXXXXXXXXXXXXXXXXXXXXXXXXX---XXXXXXXXXXXXXXXXXXXXXXXXXXXXXXXXXXXXXXXXXXXX-XXXXXX-XXXXXXXXXX---XXXXXXXXXXXXXXXXXXXX-XXXXXXXXXXXXXXXXXXXXX-XXXXXXXXXXXXXXXXXXXXXXXXXXXX---XXXXXXXXXXXXXXXXXXXXXXXXXXXXXXXXXXXXXXXXXXXXXXXXXXXXXXXX
