--------------------------------------------------------------------------------------------------------------------------------------------------------------------------------------------------------------------------------------------------------------------------------------------------------------------------------------------------------------------------------------------------------------------------------------------------------------------------------------------------------------------------------------------------------------------------------------------------------------------------------------------------------------------------------------------------------------------------------------------------------------------------------------------------------------------------------------------------------------------------------------------------------------------------------------------------------------------------------------------------------------------------------------------------------------------------------------------------------------------------------------------------------------------------------------------------------------------------------------------------------------------------------------------------------------------------------------------------------------------------------------------------------------------------------------------------------
--------------------------------------------------------------------------------------------------------------------------------------------------------------------------------------------------------------------------------------------------------------------------------------------------------------------------------------------------------------------------------------------------------------------------------------------------------------------------------------------------------------------------------------------------------------------------------------------------------------------------------------------------------------------------------------------------------------------------------------------------------------------------------------------------------------------------------------------------------------------------------------------------------------------------------------------------------------------------------------------------------------------------------------------------------------------------------------------------------------------------------------------------------------------------------------------------------------------------------------------------------------------------------------------------------------------------------------------------------------------------------------------------------------------------------------------------------
------o-------------------------------------------------------------------------------------------------------------------------------------------------------------------------------------------------------------------------------------------------------------------------------------------------------------------------------------------------------------------------------------------------------------------------------------------------------------------------------------------------------------------------------------------------------------------------------------------------------------------------------------------------------------------------------------------------------------------------------------------------------------------------------------------------------------------------------------------------------------------------------------------------------------------------------------------------------------------------------------------------------------------------------------------------------------------------------------------------------------------------------------------------------------------------------------------------------------------------------------------------------------------------------------------------------------------------------------------------------------------------------------------------------------------------------------------------
-----XXX------------------------------------------------------------------------------------------------------------------------------------------------------------------------------------------------------------------------------------------------------------------------------------------------------------------------------------------------------------------------------------------------------------------------------------------------------------------------------------------------------------------------------------------------------------------------------------------------------------------------------------------------------------------------------------------------------------------------------------------------------------------------------------------------------------------------------------------------------------------------------------------------------------------------------------------------------------------------------------------------------------------------------------------------------------------------------------------------------------------------------------------------------------------------------------------------------------------------------------------------------------------------------------------------------------------------------------------------------------------------------------------------------------------------------------------------
--------------------------------------------------------------------------------------------------------------------------------------------------------------------------------------------------------------------------------------------------------------------------------------------------------------------------------------------------------------------------------------------------------------------------------------------------------------------------------------------------------------------------------------------------------------------------------------------------------------------------------------------------------------------------------------------------------------------------------------------------------------------------------------------------------------------------------------------------------------------------------------------------------------------------------------------------------------------------------------------------------------------------------------------------------------------------------------------------------------------------------------------------------------------------------------------------------------------------------------------------------------------------------------------------------------------------------------------------------------------------------------------------------------------------------------------------------
---------?--E-----------SSS-o------?-?--E------------SSS-----------------------------------------------------------------?--E-----------SSSS---------?--E-----------SSSS---------Q-Q----------------o--------?--------------SSS----------?-QE------------------------Q-Q-------------------------Q----------------Q------------------------SSSSS---------Q-Q------------SSSS---------?--E------------------------?--E-----------SSS----------?--E------------------------Q-Q----------------o---------------------------o--------?--E-----------SSSS---------?--E------------------------Q-Q----------------o--------?--E---------------o--------?--E-----------SS-----------Q-QQ----------------------?-QQQ-------------------------?--E-----------SSSS---------?--E-----------SSSS---------------SS-------SSSS---------?-------------------------?QQQQE-----------SSSS-------?-QQ?E------------SQQ---------?QQS------------------------?-?E------------------------QQ------------SSSQ------------------------------------?-QS-E------------------------?-QE------------------------Q--------------SSS----------?-?Q------------S-----------?--E------------------------?--E------------------------?--E------------------------?--E----------------------------------------S---------------------------------------?--E------------SSS---------?--E------------------------?---------------------------?--E-----------S------------?--E-----------S---
-----------XX-X------------------------XXXXX------------------------------------------------------XX-----------------------XXXXXX----------------------XXXXX---------------------------------------X-----------XXXXX-----------------------XXXXX----------XX---------------------------------------------------------------------------------------------------------------------------XXXXX-----------------------XXXXX-----------------------XXXXX-------------------------------o------XX--------------X------------------------XXXXXX-------------------------XX-----------X---------------------------------------XXXXX-----------------------XXXXXX---------XX--------------------------XX---------------------------------------XXXXX------------------------XXXX-----------------------------------------------------------------------------------------------------------------------------------------XXX-----------------------XXXXXX-------------------------------------------------------------------------------XXXXX---------XX--------------XX-----------------------------------------------------XXX--------------------------------------XX--------------------------XX-----------XXXXX-----------------------XXXXXX---------------------------------------------------------------------------------X---------------------------XX---------------------------------------------------XXXXXX----------------------XXXXXX---------XX
------------------------------------------------------------------------------------------------------------------------------------------------------------------------------------------------------------------Q---------------------------Q---XXX-----------------------------------------------------------------------------------------------------------------------------------------------------------------------------------------------------------------------------XXX-----------------------------------------------------------------------------------------------------------------------------------------------------------------Q----X------------------------------------------------------------------------------------------------------------------------------------------------------------------------------------------------------------------------------------------------------Q---------------------------Q-----------------------------------------------------------------------------------------------------------------------------------------------------------------------------------------------------------------------------------------------------------Q---------------------------------------------------------------------------------------------------------------------------------------------------------------------------------------------------------------------------------------------
--E--<>-------------------------E---------------------------E-----------------------------E--------------E----------E-------------------E--o--E---------------------E---------E--------------E---------------------------E--------E-E-------------------------E---E-----------------------E---------------E--E------------E------------------------------------------E------------E---------------------------------------------------E---------------------------------------------------------E---------------------------E-----------------------------E---------------------------E--------------E----------E------------------------------------------------------------------------E----------E----------------E----------------------------------------E---------------------------E--------------E------------------------------------E---------------E--E--------E---------------E------------------------------E--------E---E-----------------------E------------------E--------E-------------------------------E------------------------------------------E---------------------------E------------E-------------------------------------------------------E---------------------------E---------------------------------------------E-----------------------------------E----------------E----------E----------------E----------E-----------------------------E-----------------------------------------------------------------------------
-<>--[]---QQQ--------S--------E<>--E?SQQQ-----------E-----E<>--Q--QQQQ----------------E-E<>---QQQ-------<>--------E<>----SQQQ-----E----<>----<>----E?S-QQ----------<>-----E--<>---QQQQ------<>---QQQ--E-E<>--SQQQ-------<>-------<>----E?SQQQ----------------<>--<>---QQQQ------<>----QQ-<>----E--QQQ----<>-<>--------E--<>---QQQ-----------------E-E-E---QQQ----S--<>--------E-E<>--SQQQ-----------E-----E->----SQQQ----------------<>--<>--SQQQ-----E-----E-------E<>---QQQQ----------------E<>-----QQQ-------<>--------E<>----SQQQ-----------E-------E<>---QQQQ------------------E<>---QQQQ------<>-----Q--E<>--E?SQQQ-----------E-----E-E----SQQQ-----------------E-E--E-SQQQQ------<>----QQ--E<>--Q?-QQQ-------<>----QQ--E-><>--SQQQ----<>-----E-----E--<>--SQQQ-----------------E--<>---QQQ-------<>----------E-----QQQQ---------------<>----E?SQ------<>-<>-------<>----E?S-------<>------QQ?--E----E?SQQQ-------<>---QQQ-<>--<>----------Q-----------<>-----QQ----------<>---QQQ-<>------------------S-----------<>--S-QQ----Q-------QQQ--E-E----SQQQ-------<>----QQ--E--<>---QQQ-------<>-----?--E--<>---QQQ-----------------E-E-E--SQQQ-------<>--------E-E<>---QQQQ----------------E-E<>--SQQQ-----------E-----E-E----SQQQ----------<>-----E-E<>---QQQQ----------------E<>--E--QQQ-------<>--------E<>-----QQQ-------<>--------E<>-----QQQ-----------------E-E<>---QQQQ------<>--------E-E<>--SQQQ-----------E-----E-E<>--SQQQ---------------
-[]--[]----------------------<>[]------------------<>----<>[]------------------------<><>[]-------------[]-------<>[]------------------[]----[]-E------------------[]----<>--[]-------------[]-------<><>[]-------------[]-------[]--------------------------[]--[]-------------[]-------[]--------------[]-[]--E----<>--[]----------------------<>[]<>-------------[]-------<><>[]----------------<>----<>[]-------------------E----[]--[]----------------<>-----E<>[]----------------------<>[]---------------[]-------<>[]------------------<>-----E<>[]-----------------------E<>[]-------------[]-------<>[]------------------<>----<><>------------------------<><>---------------[]-------<>[]---------------[]-------<>[>[]----------[]----<>----<>--[]-----------------E----<>-E[]-------------[]-------<><>------------------------[]--------------[]-[]--E----[]--------------[]----------<>-E---------------[]-------[]--[]----------------------[]-----------------[]-------[]------------------------------[]----------------------<><>---------------[]-------<>--[]-------------[]-------<>--[]----------------------<><>[]-------------[]-------<><>[]----------------------<><>[]----------------<>----<><>------------------[]----<><>[]----------------------<>[]---------------[]-------<>[]---------------[]-------<>[]------------------------<><>[]-------------[]-------<><>[]----------------<>----<><>[]-----------------E---
-[]--[]----------------------[][]------------------[]----[][]------------------------[][][]-------------[]-------[][]------------------[]----[][]------------------[]----[]--[]-------------[]-------[][][]-------------[]-------[]--------------------------[]--[]-------------[]-------[]--------------[]-[]-<>----[]<>[]----------------------[][][]-------------[]-------[][][]----------------[]--X-[][]-E----------------<>----[]--[]----------------[]----<>[][]----------------------[][]---------------[]-------[][]------------------[]----<>[][]----------------------<>[][]-------------[]-------[][]------------------[]----[][]------------------------[][]---------------[]-------[]-----------------[]-------[][][]----------[]----[]----[]--[]----------------<>----[][][]-------------[]-------[][]------------------------[]--------------[]-[]-------[]--------------[]----------[][]---------------[]-------[]--[]----------------------[]-----------------[]-------[]------------------------X-----[]----------------------[][]---------------[]-------[]--[]-------------[]-------[]--[]----------------------[][][]-------------[]-------[][][]----------------------[][][]----------------[]----[][]-X----------------[]----[][][]----------------------[][]---------------[]-------[][]---------------[]-------[][]------------------------[][][]-------------[]-------[][][]----------------[]----[][][]----------------<>---
-[]-E[]----E--E-EE-E---------[][]---------E-EE-E---[]----[][]---------E-EE-----EE-E--[][][]------EE-EE--[]-E-----[][]-E------EE-EE-E---[]----[][]---------E-EE-E---[]----[]--[]-------EE-E--[]-EE-E--[][][]-------E-EE--[]-E-E---[]-Q---------E-EE-----EE-E--[]--[]-------E-EE--[]-E--E--[]-Q--------EE--[]-[]-[]----[][][]------EE-EE-----------[][][]-------E--E--[]-------[][][]------EE-E------[]-XX-[][][]------EE-EE-E---[]----[]--[]------EE-EE-E---[]----[][][]------EE-EE------E-E--[][]-E------EE-EE--[]-E-----[][]-E------EE-EE-E---[]----[][][]-------E-EE-E---------[][][]------EE-EE--[]-EE-E--[][]--------EE-EE-----[]----[][]-E------EE-EE-E---------[][]---------E-EE--[]-EE-E--[]-----------EE----[]-E--E--[][][]------EE-EE-----[]----[]-E[]------EE-EE-E---[]----[][][]------EE-EE--[]-------[][]-E------EE-EE-----------[]--------E--E--[]-[]-------[]-----------E--[]----------[][]--------EE-E---[]-------[]--[]-------E-E----E-------[]--EE----EE-EE----[]-------[]--------E-EE-EE--------XX-----[]-------E-EE-E---------[][]-E-------E-EE--[]-E--E--[]-E[]------EE-EE--[]-------[]-E[]-------E-EE-E---------[][][]-------E-EE--XX----E--[][][]------EE-EE--------E--[][][]------EE-EE-----[]----[][]-X------EE-EE-E---[]----[][][]------EE-EE--------E--[][]--------EE-EE--[]-E--E--[][]--------EE-EE--[]-E-----[][]-E------EE-EE-----E-----[][][]------EE-EE--[]-E-----[][][]------EE-EE-E---[]----[][][]-E----EE-EE-E---[]---
XXXXXXXXXXXXXXXXXXXXXXXXXXXX-XXXXXXXXXXXXXXXXXXXXXXXXXXX-XXXXXXXXXXXXXXXXXXXXXXXXXXX-XXXXXXXXXXXXXXXXXXXXXXXXXXXXXXXXXXXXXXXXXXXXXXXXXXXXXXX-XXXXXXXXXXXXXXXXXXXXXXXXXXXXXXXXXXXXXXXXXXXXXXXXXXXXXXX-XXXXXXXXXXXXXXXXXXXXXXXXXXX-XXXXXXXXXXXXXXXXXXXXXXXXXXX-XXXXXXXXXXXXXXXXXXXXXXXXXXXXXXXXXXXXXXXXXXXXXXXXXXXXXXXXXXXXXXXXXXXXXXXXXXXXXXXXXXXXXXXXXXXXXXXXXXXXXXXXXXXXXXX-XXXXXXXXXXXXXXXXXXXXXXXXXXXXXXXXXXXXXXXXXXXXXXXXXXXXXXXXXXXXXXXXXXXXXXXXXXXXXXXXXXX-XXXXXXXXXXXXXXXXXXXXXXXXXXX-XXXXXXXXXXXXXXXXXXXXXXXXXXX-XXXXXXXXXXXXXXXXXXXXXXXXXXX-XXXXXXXXXXXXXXXXXXXXXXXXXXX-XXXXXXXXXXXXXXXXXXXXXXXXXXX-XXXXXXXXXXXXXXXXXXXXXXXXXXXXXXXXXXXXXXXXXXXXXXXXXXXXXXXXXXXXXXXXXXXXXXXXXXXXXXXXXXX-XXXXXXXXXXXXXXXXXXXXXXXXXXXXXXXXXXXXXXXXXXXXXXXXXXXXXXX-XXXXXXXXXXXXXXXXXXXXXXXXXXXXXXXXXXXXXXXXXXXXXXXXXXXXXXX-XXXXXXXXXXXXXXXXXXXXXXXXXXX-XXXXXXXXXXXXXXXXXXXXXXXXXXX-XXXXXXXXXXXXXXXXXXXXXXXXXXXXXXXXXXXXXXXXXXXXXXXXXXXXXXXXXXXXXXXXXXXXXXXXXXXXXXXXXXX-XXXXXXXXXXXXXXXXXXXXXXXXXXX-XXXXXXXXXXXXXXXXXXXXXXXXXXXXXXXXXXXXXXXXXXXXXXXXXXXXXXX-XXXXXXXXXXXXXXXXXXXXXXXXXXXXXXXXXXXXXXXXXXXXXXXXXXXXXXX-XXXXXXXXXXXXXXXXXXXXXXXXXXX-XXXXXXXXXXXXXXXXXXXXXXXXXXX-XXXXXXXXXXXXXXXXXXXXXXXXXXX-XXXXXXXXXXXXXXXXXXXXXXXXXXXXXXXXXXXXXXXXXXXXXXXXXXXXXXX-XXXXXXXXXXXXXXXXXXXXXXXXXXX-XXXXXXXXXXXXXXXXXXXXXXXXXXX-XXXXXXXXXXXXXXXXXXXXXXXXXXX-XXXXXXXXXXXXXXXXXXXXXXXXXXXXXXXXXXXXXXXXXXXXXXXXXXXXXXX-XXXXXXXXXXXXXXXXXXXXXXXXXXXXXXXXXXXXXXXXXXXXXXXXXXXXXXX
