--------------------------------------------------------------------------------------------------------------------------------------------------------------------------------------------------------------------------------------------------------------------------------------------------------------------------------------------------------------------------------------------------------------------------------------------------------------------------------------------------------------------------------------------------------------------------------------------------------------------------------------------------------------------------------------------------------------------------------------------------------------------------------------------------------------------------------------------------------------------------------------------------------------------------------------------------------------------------------------------------------------------------------------------------------------------------------------------------------------------------------------------------------------------------------------------------------------------------------------------------------------------------------------------------------------------------------------------------------------------------------------------------------------------------------------------------------
--------------------------------------------------------------------------------------------------------------------------------------------------------------------------------------------------------------------------------------------------------------------------------------------------------------------------------------------------------------------------------------------------------------------------------------------------------------------------------------------------------------------------------------------------------------------------------------------------------------------------------------------------------------------------------------------------------------------------------------------------------------------------------------------------------------------------------------------------------------------------------------------------------------------------------------------------------------------------------------------------------------------------------------------------------------------------------------------------------------------------------------------------------------------------------------------------------------------------------------------------------------------------------------------------------------------------------------------------------------------------------------------------------------------------------------------------------
--------------------------------------------------------------------------------------------------------------------------------------------------------------------------------------------------------------------------------------------------------------------------------------------------------------------------------------------------------------------------------------------------------------------------------------------------------------------------------------------------------------------------------------------------------------------------------------------------------------------------------------------------------------------------------------------------------------------------------------------------------------------------------------------------------------------------------------------------------------------------------------------------------------------------------------------------------------------------------------------------------------------------------------------------------------------------------------------------------------------------------------------------------------------------------------------------------------------------------------------------------------------------------------------------------------------------------------------------------------------------------------------------------------------------------------------------------
-----------------------------------------------------------------------------------------------------------------------------------------------------------------------------------------------------------------------------------------------------------------------------------------------------------------------------------------------E-----------------------------------------------------------------------------------------------------------------------------------------------------------------------E--------------------------------------------------------------------------------------------------------------------------------------------------------------------------------------------------------------------------------------------------------------------------------------------------------------------------------------------------------------------------------------------------------------------------------------------------------------------------------------------------------------------------------------------------------------------------------------------------------------------------------------------------------------------------------------------------------------------------------------------------------------------------------------------------------------------------------------------------------------------------------------------------------------------------------
--------------------------------------------------------------------------------------------------------------------------------------------------------------------------------------------------------------------------------------------------------------------------------------------------------------------------------------------------------------------------------------------------------------------------------------------------------------------------------------------------------------------------------------------------------------------------------------------------------------------------------------------------------------------------------------------------------------------------------------------------------------------------------------------------------------------------------------------------------------------------------------------------------------------------------------------------------------------------------------------------------------------------------------------------------------------------------------------------------------------------------------------------------------------------------------------------------------------------------------------------------------------------------------------------------------------------------------------------------------------------------------------------------------------------------------------------------
--------------S-----------Q-o----------Q------------SSSS--------------S------------S----------------------------o--------?--Q-----------S------------Q---SSSS------------------------------------------------?--E------------SSS---------?--E------------SSS---------?--E-------------S----------?--E--------SSSS------------?--E----------SSSS-o--------Q-QQ----------------------?-?Q-E------------------------Q-?QSSS---------SQ----------Q-Q-Q--------------o--------?--E------------SSS-------?-QQQE----------SSSS--------------------------------------?-Q-------------SS-------------E-----------SSSS---------QQQ--------------Q----------Q---------------SSS-------?-?--E------------------------Q-Q-----------------------------------------------------?-Q-------------------------?--E------------------------?--E------------------------?--E------------------------Q-Q-------------------------?--E---------------o--------?--E-----------S------------Q-Q----------------o--------Q-Q------------SS-----------?--E-----------SSS----------?--E------------------------Q-Q--------------------------------S--------S-----------?--E------------------------?--E-----------S------------?-QQ---------------o------?-Q-QQ------------------------?--E------------------------?--E-----------S------------?--E-----------S---o--------?--E-----------S------------?-QQ-----------SS--o--------?--E-----------SS-----------?--E-----------S---
-----------------------------------------------------------------------------------------------------------------------------XXX----------------------------------------------------------------------------------XX--------------------------X---------------------------XX-----------------------XXXXX-----------------------XX-X---------------------------XX-----------------------XXXXXX------------------------------------------------------------------------------XXXXXX-------------------------XX------------------------------------------------------XX--------------------------X--------------------------------------------------------------------------------XXXXX--------------------------------------------------------------------------------------------------------------X------------------------XXXXXX-------------------------------------XX---------------------------------------XXXXXX----------------------XXXXXX--o------XX---------------------------X---------------X-----------------------XXXXXX----------------------XXXXXX----------X---------------------------X---------------------------------------XXXXXX---------XX-----------XXXXXX---------XX--------------XX----------XX---------------------------------------XXXXX----------XX--------------XX-----------X-----------XXXXXX----------X--------------XX-----------X--------------XX-----------------------XXXXXX----------X-----------XXXXXX---------XX
------------------------------------------------------------------------------------------------------------------------------Q--------------------------------------------------------------------------------------------------------------------------------------------------------------------------------------------------------XX-------------------------------------------------Q---------------------------------------------------------------------------------------------------------------------------------------------------------------------------------------------------------------------------------------------------------------------------------------------------------------------------------------------------------------------------------------------------------------------------------------------------------------------------------------------------------------------------------------------------Q---XXX-------------------------------------------------------------------------------------------------------------------------------------------------------------------------------------------------------------------------Q---XXX-------------------------------------------------------------------------------------------------------------------------------------------------------------------------------------------------------------------------Q---------------------------Q-------------
--E---E--------------------------------------------E----------E-------------------------E----------------E------------E------------------------------------------E------------E--------------E------------E-----------------------E---------------E-----E-----E-------------------------------E-----------------E---------E-------------------------E----------------E--------E------------------E------------E--------------E---------------------------E-------------------------------------------------------E----------------------------------------E--------------E------------------------------E-----E------------------E------------E--------------E--------E-E-------------------E-------E----------------E----------E----------------E------------E--------------E------------E---------------------------E-----------------E-------------------------------------E--------------E----------E-------------------E--o-------------------------------------------------E------------E--------------E----------E-------------------E-------------------------------------E--------------E------------E-------------------------------------------------------E---------------------------E--------------E----------E----------------E----------------------------------------E-------------------------------------------------------E---------------------------E--------------E----------E---------------------------------------------------
-<>--<>-------------------------------QQQ---------<>------E--<>------QQ--S------E-----E<>--E--QQQ-------<>--------E--<>---QQQQ---Q------------E----E--QQQ-------<>----QQ--E--<>---QQQ-------<>-----Q--E-E<>---QQQQ---------------<>------S-------<>----<>----<>----E?SQQQ-----E-----E-----E--<>--S--------E----<>-----E--<>-----Q--------------?--E<>--E?SQQQ-------<>----E?-<>----E?SQQQ-------<>--------E--<>---QQQ-------<>---QQQ--E<>--Q--QQQQ---Q--<>-----Q--E-E<>---QQQ-----------E-----E----E?SQQQ-------<>---QQQ--E--------------E---------Q--E-E<>---QQQ----Q--<>----QQ--E---E--S-------------<>----<>----E?SQ---------<>---QQQ--E--<>---QQQ-------<>-------<><>--E?SQQQ----------<>-----E<>--E--QQQQ------<>----QQ--E<>--E--QQQ-------<>--------E--<>---QQQQ------<>---QQQ--E-E<>---QQQ-----------------E--<>--SQQQ----------<>-------E<>---QQQQ------<>--------E-E<>---QQQQ------<>-----Q--E<>----SQQQ----------<>-----E-E<>--SQQQ----Q------------E---E---QQQQ------<>---QQQ----E<>---QQQQ------<>--------E<>----SQQQ----------<>-----E-E----SQQQ-----------E-----E-E<>---QQQQ------<>-----Q--E-E<>---QQQQ----------------E-E<>--SQQQ-------------------E<>--SQQQ-----------------E-E<>--SQQQ-------<>-----Q--E<>--E?SQQQ-------<>-----Q--E-E----SQQQ-------------------E<>---QQQQ---Q------------E-E<>--SQQQ-------------------E<>---QQQQ----------------E-E<>--SQQQQ------<>--------E<>----SQQQ-----------------E-E-E--SQQQ---------------
-[]--[]-------------------------------------------[]-----<>--[]----------------<>----<>[]---------------[]-------<>--[]----------------------<>-----------------[]-------<>--[]-------------[]-------<><>[]----------------------[]--------------[]----[]----[]--------------------<>----<>--[]----------<>----[]----<>--[]----------------------<>[]---------------[]-------[]-----------------[]-------<>--[]-------------[]-------<>[]---------------[]-------<><>[]----------------<>----<>-----------------[]-------<>-------------<>-----------<><>[]-------------[]-------<>--<>---------E------[]----[]-----------------[]-------<>--[]-------------[]-------[][]------------------[]----<>[]---------------[]-------<>[]---------------[]-------<>--[]-------------[]-------<><>[]-----------------E----<>--[]----------------[]----<><>[]-------------[]-------<><>[]-------------[]-------<>[]------------------[]----<><>[]----------------------<>--<>-------------[]--------E<>[]-------------[]-------<>[]------------------[]----<><>-------------------E----<><>[]-------------[]-------<><>[]----------------------<><>[]-----------------------E<>[]----------------------<><>[]-------------[]-------<>[]---------------[]-------<><>-------------------E-----E<>[]----------------------<><>[]-----------------E-----E<>[]----------------------<><>[]-------------[]-------<>[]-------------------E----<><><>-----------------E---
-[]--[]-------------------------------------------[]-----[]--[]----------------[]----[][]---------------[]-------[]--[]----------------------[]-----------------[]-------[]--[]-------------[]-------[][][]----------------------[]--------------[]----[]----[]--------------------[]----[]--[]----------[]----[]----[]--[]----------------------[][]---------------[]---<>--[]-----------------[]-------[]--[]-------------[]-------[][]---------------[]-------[][][]----------------[]----[]-----------------[]-------[]-------------[]--X--------[][][]-------------[]-------[]--[]--------<>------[]----[]-----------------[]-------[]--[]-------------[]-------[][]------------------[]----[][]---------------[]-------[][]---------------[]-------[]--[]-------------[]-------[][][]----------------<>----[]--[]----------------[]----[][][]-------------[]-------[][][]-------------[]-------[][]------------------[]----[][][]----------------------[]-E[]-------------[]-------<>[][]-------------[]-------[][]------------------[]----[][]------------------<>----[][][]-------------[]-------[][][]----------------------[][][]----------------<>----<>[][]----------------------[][][]-------------[]-------[][]---------------[]-------[][]-X----------------<>----<>[][]----------------------[][][]----------------<>----<>[][]----------------------[][][]-------------[]-------[][]------------------<>----[][][]----------------<>---
-[]--XX----E-E--EE-E---E------------------E--E----[]-----[]--[]---EE-E---E-E---[]----[][]--------EE-EE--[]-E-----[]--[]-------E-EE-----E-EE--[]-----------E-EE--[]-E-EE--[]--[]------EE-EE--[]----E--[][][]------EE-EE-E---------[]-------E--EE--[]----[]----[]-Q--------EE-EE-----[]----[]-E[]------EE-E[]E---[]----[]-E[]------EE-E-----E------[][]---------E-EE--[]-E-[]--[]-----------E-EE--[]-------[]-E[]-------E-EE--[]-E--E--[][]---------E-EE--[]----E--[][][]------EE-EE-E---[]----[]-----------E-EE--[]----E--[]-----------E-[]--X--E-EE--[][][]------EE-----[]-------[]--[]------E-[]--EE--[]----[]--------E--E-----[]-------[]-E[]----E--E--E--[]-E-E---[][]---------E-EE-E---[]----[][]---------E-EE--[]-EE-E--[][]--------EE-EE--[]-E-EE--[]-E[]------EE-EE--[]----E--[][][]------EE-EE-E---[]----[]--[]------EE-EE-E---[]----[][][]------EE-EE--[]--E-E--[][][]-------E-EE--[]-E--E--[][]--------EE-EE-E---[]----[][][]------EE-EE-E---------[][][]-------E-EE--[]-EE-E--[][][]------EE-EE--[]-E--E--[][]--------EE-EE-E---[]----[][]-E------EE-EE-E---[]----[][][]-------E-EE--[]-EE-E--[][][]------EE-EE-E---------[][][]------EE-EE-E---[]----[][][]-E----EE-EE-E---------[][][]------EE-EE--[]-EE-E--[][]---------E-EE--[]-E--E--[][]-X------EE-EE-E---[]----[][][]------EE-EE-----------[][][]------EE-EE-E---[]----[][][]-E----EE-EE-----------[][][]------EE-EE--[]-E--E--[][]-E------EE-EE-----[]----[][][]-------E-EE-E---[]---
-XX--XX-XXXXXXXXXXXXXXXXXXXXXXXXXXXXXXXXXXXXXXXXXXXXXXXXXXXXXXXXXXXXXXXXXXXXXXXXXXX--XXXXXXXXXXXXXXXXXXXXXXXXXXXXXXXXXXXXXXXXXXXXXXXXXXXXXXX-XXXXXXXXXXXXXXXXXXXXXXXXXXXXXXXXXXXXXXXXXXXXXXXXXXXXXXX-XXXXXXXXXXXXXXXXXXXXXXXXXXX-XXXXXXXXXXXXXXXXXXXXXXXXXXXXXXXXXXXXXXXXXXXXXXXXXXXXXXX-XXXXXXXXXXXXXXXXXXXXXXXXXXX-XXXXXXXXXXXXXXXXXXXXXXXXXXX-XXXXXXXXXXXXXXXXXXXXXXXXXXXXXXXXXXXXXXXXXXXXXXXXXXXXXXX-XXXXXXXXXXXXXXXXXXXXXXXXXXX-XXXXXXXXXXXXXXXXXXXXXXXXXXX-XXXXXXXXXXXXXXXXXXXXXXXXXXX-XXXXXXXXXXXXXXXXXXXXXXXXXXX-XXXXXXX-XXXXXXXXXXXXXXXXXXX-XXXXXXXXXXXXXXXXXXXXXXXXXXX-XXXXXXXXXXXXXXXXXXXXXXXXXX--XXXXXXXXXXXXXXXXXXXXXXXXXXX-XXXXXXXXXXXXXXXXXXXXXXXXXXX-XXXXXXXXXXXXXXXXXXXXXXXXXXX-XXXXXXXXXXXXXXXXXXXXXXXXXXX-XXXXXXXXXXXXXXXXXXXXXXXXXXX-XXXXXXXXXXXXXXXXXXXXXXXXXXX-XXXXXXXXXXXXXXXXXXXXXXXXXXX-XXXXXXXXXXXXXXXXXXXXXXXXXXX-XXXXXXXXXXXXXXXXXXXXXXXXXXX-XXXXXXXXXXXXXXXXXXXXXXXXXXX-XXXXXXXXXXXXXXXXXXXXXXXXXXX-XXXXXXXXXXXXXXXXXXXXXXXXXXXXXXXXXXXXXXXXXXXXXXXXXXXXXXX-XXXXXXXXXXXXXXXXXXXXXXXXXXX-XXXXXXXXXXXXXXXXXXXXXXXXXXXXXXXXXXXXXXXXXXXXXXXXXXXXXXX-XXXXXXXXXXXXXXXXXXXXXXXXXXX-XXXXXXXXXXXXXXXXXXXXXXXXXXX-XXXXXXXXXXXXXXXXXXXXXXXXXXXXXXXXXXXXXXXXXXXXXXXXXXXXXXX-XXXXXXXXXXXXXXXXXXXXXXXXXXX-XXXXXXXXXXXXXXXXXXXXXXXXXXXXXXXXXXXXXXXXXXXXXXXXXXXXXXX-XXXXXXXXXXXXXXXXXXXXXXXXXXX-XXXXXXXXXXXXXXXXXXXXXXXXXXX-XXXXXXXXXXXXXXXXXXXXXXXXXXX-XXXXXXXXXXXXXXXXXXXXXXXXXXX-XXXXXXXXXXXXXXXXXXXXXXXXXXXXXXXXXXXXXXXXXXXXXXXXXXXXXXX
