--------------------------------------------------------------------------------------------------------------------------------------------------------------------------------------------------------------------------------------------------------------------------------------------------------------------------------------------------------------------------------------------------------------------------------------------------------------------------------------------------------------------------------------------------------------------------------------------------------------------------------------------------------------------------------------------------------------------------------------------------------------------------------------------------------------------------------------------------------------------------------------------------------------------------------------------------------------------------------------------------------------------------------------------------------------------------------------------------------------------------------------------------------------------------------------------------------------------------------------------------------------------------------------------------------------------------------------------------------------------------------------------------------------------------------------------------------
-------------------------------------------------------Q------------------------------------------------------------------------------------------------------------------------------------------------------------------------------------------------------------------------------------------------------------------------------------------------------------------------------------------------------------------------------------------------------------------------------------------------------------------------------------------------------------------------------------------------------------------------------------------------------------------------------------------------------------------------------------------------------------------------------------------------------------------------------------------------------------------------------------------------------------------------------------------------------------------------------------------------------------------------------------------------------------------------------------------------------------------------------------------------------------------------------------------------------------------------------------------------------------------------------------------------------------------------------------------------------------------------------------------------------------------------------------------------
--------------------------------------------------------------------------------------------------------------------------------------------------------------------------------------------------------------------------------------------------------------------------------------------------------------------------------------------------------------------------------------------------------------------------------------------------------------------------------------------------------------------------------------------------------------------------------------------------------------------------------------------------------------------------------------------------------------------------------------------------------------------------------------------------------------------------------------------------------------------------------------------------------------------------------------------------------------------------------------------------------------------------------------------------------------------------------------------------------------------------------------------------------------------------------------------------------------------------------------------------------------------------------------------------------------------------------------------------------------------------------------------------------------------------------------------------------
----------------------------------------------------------------------------------------------------------------------------------------------------------------------------------------------------------------------------------------------------------------------------------------------------------------------------------------------------------------------------------------------------------------o---------------------------------------------------------------------------------------------------------------------------------------------------------------------------------------------------------------------------------------------------------------------------------------------------------------------------------------------------------------------------------------------------------------------------------------------------------------------------------------------------------------------------------------------------------------------------------------------------------------------------------------------------------------------------------------------------------------------------------------------------------------------------------------------------------------------------------------------------------------------------------------------------------------------------------------------------------------------------------------------------------------------------------------
---------------------------------------------------------------------------------------------------------------------------------------------------------------------------------------------------------------------------------------------------------------------------------------------------------------------------------------------------------------------------------------------------------------------------------------------------------------------------------------------------------------------------------------------------------------------------------------------------------------------------------------------------------------------------------------------------------------------------------------------------------------------------------------------------------------------------------o----------------------------------------------------------------------------------------------------------------------------------------------------------------------------------------------------------------------------------------------------------------------------------------------------------------------------------------------------------------------------------------------------------------------------------------------------------------------------------------------------------------------------------------------------------------------------------------------------------------------
---------------------------------------------------SSSSS-------------------------------------Q-Q----------------------------E------------------------?---SSSS-----SSSSS----------?-------------SSSSSo--------?--E------------------------QQQQ------------------------Q-Q----S--------------------?--E----------SSSSS---------?--E------------SSS-------------SSSS----SSSSSSS---------?--E---------SSSSSS---------QQ-Q------------------------QQQQ------------------------?-QE-----------SSS----------?--E-----------SSSSo------?QQQSQ------------------------Q-Q-------------------------?--E------------------------?--E----------SSSSS---------------SS--------SQ-o--------QQQE-----------SSSS---------?--E------------------------Q-Q---SS------------------------------------------------?S-E-----------SSS----------?--E-----XX-----------------Q-Q-----------------------------------------------------?-?E-----------SSSS---------?--E------------------------QQQ-------------------------?--E------------------------?--E-----------SSS----------?---------------------------?-QQ------------------------?--E------------------------?--E----------------------------------------------------?---------------------------?--E------------------------?--E------------------------Q-Q-------------------------?--------------SS---------?QQQQ-------------------------?--E------------SSS---------?--E-------------SS---------------------SSSSSSS
----------------------------------------------------------------------X-------------------------------------------------------XX--------------------------XX---------------------------------------------------QXXXX----------XX---------------------------------------------------------------------XXX--------------------------X----------------------------------------------------XXXXX--------------------------XX------------------------------------------------------X------------------------XXXXXX-------------------------XX----------XX-----------------------------------------XXX-----------------------XXXXXX-----------------------------------------------------X------------------------XXXXX--------------------------------------------------------------------------------XXXX-----------------------XXXXX--------------------------------------XX---------------------------------------XXXXXX----------------------XXXXX---------------------------------------X-------------XXX-----------------------XXXXXX----------X--------------X------------X--------------XX----------XX-----------XXXXXX----------------------XXXXX-------------------------------------------------------------------------------XXXXXX----------------------XXXXXX--o------XX------------------------------------------------------------------------------------------------X-X-------------------------X-X-----------------------------------------
------------------------------------------------------------------------------------------------------------------------------------------------------------------------------------------------------------------------------------------------------------------------------------------------------------------------------------------------------------------------------------------Q---------------------------Q---------------------------------------------------------------------------------------------------------------Q---------------------------------------------------------------------------------------------------------------------------------------------------------------------------------------------------------------------------------------------------------------------------------------------------------------------------------------------------------------------------Q---------------------------------------------------------------------------------------------------------------Q--------------------------------X----------------------------X-----------------------------------------------------------------------------------------------------------------------------------------------------------------Q---XXX-------------------------------------------------------------------------------------------------------------------------------------------------------------------------------
-----------------------o----------------------------E--o----E---------------------------E----------------E----------------------------------------E---------------------------------------E-----------------------------------------E----------------E---------------------------E------------E-----------------------E-E-------------------E--o------E-----------E-----------E---E-----------E-----------E------------------E------------E--------------E--------E---E--------------E--?-------E-------------------E-----E-E----------------E---------------------------E------------E-----------E--E------------------------------E------------------------E----------E----------------E----------E-----------------------------E--------------E----------E-----------------------------E-----------------------E-------------------------------E--------------E----------E---------------------------E---------------------------E--------------------------------------------E----------E-----------------------------E--------------E------------E---------------------------E--------------E------------------------------E---------E-------------------------E---------------------------E---------------------------E-------------------E---------E------------------------------------------E-------------------------------------------------------E--------E---------------E--S------------------------E-----E-----E---------------E-----E---
-------Q--QQQ------------------------QQQQ----------<>-----E<>-----QQQ-----------------E<>--E?SQQQ-------<>--------E-E-----QQQ----<>-----E-----E--<>---QQQQ------<>--------E-E----SQQQ----<>-----E-------E<>--SQQQQ----------------E<>--E?SQQQ-------<>----E?----E-----QQQQ------<>-----Q--E-E<>---QQQ----------------<>-E---?S--------E----<>-----E--<>----QQ----<>----------<>--<>--SQQQ----<>-------ES-<><>--E?SQQQ-------<>--------E--<>--SQQQ-------<>---QQQ-<>--<>--SQQQ-------<>---QQQ--E<>---?SQQQ-----E----<>----<>----E?SQQQ-------<>-----Q--E----E--QQQQ------<>-----Q--E--<>---QQQ----<>-<>--------E---E--S-QQ-----E----<>-----E----E--QQQ-------<>---QQQ--E<>--E?SQQQ-------<>--------E<>--E?SQQQ-----------------E--<>---QQQQ------<>---QQQ--E<>--E--QQQ-----------------E--<>---QQQ-----------E----<>----E?SQQQ-----------E-------E<>---QQQQ------<>-----Q--E<>--Q--QQQ-------<>--------E<>----SQQQ----------<>-----E<>--E?SQQQ-----------------E---E---QQQQ------<>----QQ--E<>-----QQQ-----------E-----E-E<>--SQQQ-------<>----------E<>---QQQQ----------------E-E<>---QQQQ------<>----QQ--E<>----SQQQ-----E----<>-----E--<>--SQQQ-----------------E<>-----QQQQ------<>-----Q--E<>-----QQQ-----------------E<>--E?SQQQ----------<>-------E<>--SQQQ-----------------E-E-----QQQ-------<>-----Q--E-E-----QQQ----------------------S?SQ---------<>---QQQ-<>----E?SQQQ----<>-----E-----------?SQ------<>----<>----<>------Q-------<>----<>---
------------------------------E--------------------[]----<>[]------------------------<>[]---------------[]-------<><>------------[]----<>----<>--[]-------------[]-------<><>------------[]----<>----<><>[]----------------------<>[]---------------[]-------<><><>-------------[]-------<><>[]-----------------E----[]<>------------<>----[]----<>--[]----------[]----------[]--[]----------[]----------[][]---------------[]-------<>--[]-------------[]-------[]--[]-------------[]-------<>[]------------------[]----[]-E---------------[]-------<>-----------------[]-------<>--[]----------[]-[]-------<>--<>----------<>----[]----<>-----------------[]-------<>[]---------------[]-------<>[]------------------------<>--[]-------------[]-------<>[]------------------------<>--[]----------------<>----[]--------------------<>-----E<>[]-------------[]-------<>[]---------------[]-------<>[]------------------[]----<>[]-------------------E----<>--<>-------------[]-------<>[]------------------<>----<><>[]-------------[]-------<><>[]----------------------<><>[]-------------[]-------<>[]------------------[]----<>--[]-----------------E----<>[]---------------[]-------<>[]------------------------<>[]------------------[]-----E<>[]----------------------<><]---------------[]-------<><>-------------------------E-----------------[]-------[]--------------[]----<>-----E--------------[]----[]----[]--------------[]----[]---
-----------------------------<>--------------------[]----[][]------------------------[][]---------------[]---<>--[][]------------[]----[]----[]--[]-------------[]-------[][]------------[]----[]----[][][]----------------------[][]---------------[]-------[][][]-------------[]-------[][][]----------------<>----[][]------------[]----[]----[]--[]----------[]----------[]--[]----------[]----------[][]---------------[]-------[]--[]-------------[]-------[]--[]-------------[]-------[][]------------------[]----[]-----------------[]-------[]-----------------[]-------[]--[]----------[]-<>-------[]--[]----------[]----[]----[]-----------------[]-------[][]---------------[]-------[][]------------------------[]--[]-------------[]-------[][]------------------------[]--[]----------------[]----[]--------------------[]----<>[][]-------------[]-------[][]---------------[]-------[][]------------------[]----[][]------------------<>----[]--[]-------------[]-------[][]------------------[]----[][][]-------------[]-------[][][]----------------------[][][]-------------[]-------[][]------------------[]----[]--[]----------------<>----[][]---------------[]-------[][]------------------------[][]------------------[]----<>[][]----------------------[][][]-------------[]-------[][]------------------------<>-----------------[]-------[]--------------[]----[]----<>--------------[]----[]----[]--------------[]----[]---
------E----E--E-EE-----E-----[]-----------E-EE-E---[]----[][]--------EE-EE-----------[][]---------E-EE--[]-E-[]--[][]-E------EE-EXX----[]-XX-[]--[]---------EE--[]-E-E---[][]---------E-E[]----[]----[][][]------EE-EE-E---------[][]---------E-EE--[]-E-----[][][]------EE-EE--[]--E-E--[][][]------EE-EE-----[]----[][]---E-----E--[]-E--[]----[]-E[]------EE--[]----------[]-E[]------EE--[]----------[][]---------E-----[]-E-----[]--[]-------E-E---[]----E--[]--[]-------E-----[]-------[][]--------EE-EE-E---[]----[]-----------E-EE--[]-E--E--[]-----------E-EE--[]-EE-E--[]-E[]------EE--[]-[]-------[]--[]------EE--[]E---[]----[]----------EE-EE--[]--E-E--[][]---------E-EE--[]-E-E---[][]---------E-EE-E---E-----[]--[]-------E-EE--[]--E-E--[][]-E------EE-EE-----------[]--[]------EE-EE-E---[]----[]-X---------E-EE-E---[]----[][][]-------E-EE--[]--E-E--[][]--------EE-EE--[]-E-----[][]-E------EE-EE-E---[]----[][]---------E-EE-E---[]----[]--[]-------E-EE--[]-EE-E--[][]-E------EE-EE-----[]----[][][]------EE-EE--[]-------[][][]-------E-EE-----------[][][]------EE-EE--[]-EE-E--[][]-E------EE-EE-----[]----[]--[]-------E-EE-E---[]----[][]-E-------E-EE--[]-EE-E--[][]--------EE-EE-----E-----[][]--------EE-EE-E---[]----[][][]-E----EE-EE-E---------[][][]-------E--E--[]-E--E--[][]-E------EE-EE-----------[]-----------E-----[]-------[]--------E-EE--[]----[]----[]-------EE-EE--[]----[]----[]----------EE--[]----[]---
XXXXXXXXXXXXXXXXXXXXXXXXXXXX-XXXXXXXXXXXXXXXXXXXXXXXXXXX-XXXXXXXXXXXXXXXXXXXXXXXXXXX-XXXXXXXXXXXXXXXXXXXXXXXXXXX-XXXXXXXXXXXXXXXXXXXXXXXXXXXXXXXXXXXXXXXXXXXXXXXXXXXXXXX-XXXXXXXXXXXXXXXXXXXXXXXXXXX-XXXXXXXXXXXXXXXXXXXXXXXXXXXXXXXXXXXXXXXXXXXXXXXXXXXXXXXXXXXXXXXXXXXXXXXXXXXXXXXXXXX-XXXXXXXXXXXXXXXXXXXXXXXXXXX-XXXXXXXXXXXXXXXXXXXXXXXXXXX-XXXXXXXXXXXXXXXXXXXXXXXXXXX-XXXXXXXXXXXXXXXXXXXXXXXXXXXXXXXXXXXXXXXXXXXXXXXXXXXXXXX-XXXXXXXXXXXXXXXXXXXXXXXXXXX-XXXXXXXXXXXXXXXXXXXXXXXXXXX-XXXXXXXXXXXXXXXXXXXXXXXXXXXXXXXXXXXXXXXXXXXXXXXXXXXXXXX-XXXXXXXXXXXXXXXXXXXXXXXXXXXXXXXXXXXXXXXXXXXXXXXXXXXXXXXXXXXXXXXXXXXXXXXXXXXXXXXXXXX-XXXXXXXXXXXXXXXXXXXXXXXXXXX-XXXXXXXXXXXXXXXXXXXXXXXXXXX-XXXXXXXXXXXXXXXXXXXXXXXXXXXXXXXXXXXXXXXXXXXXXXXXXXXXXXX-XXXXXXXXXXXXXXXXXXXXXXXXXXXXXXXXXXXXXXXXXXXXXXXXXXXXXXX-XXXXXXXXXXXXXXXXXXXXXXXXXXX-XXXXXXXXXXXXXXXXXXXXXXXXXXX-XXXXXXXXXXXXXXXXXXXXXXXXXXX-XXXXXXXXXXXXXXXXXXXXXXXXXXX-XXXXXXXXXXXXXXXXXXXXXXXXXXX-XXXXXXXXXXXXXXXXXXXXXXXXXXX-XXXXXXXXXXXXXXXXXXXXXXXXXXX-XXXXXXXXXXXXXXXXXXXXXXXXXXX-XXXXXXXXXXXXXXXXXXXXXXXXXXX-XXXXXXXXXXXXXXXXXXXXXXXXXXX-XXXXXXXXXXXXXXXXXXXXXXXXXXXXXXXXXXXXXXXXXXXXXXXXXXXXXXX-XXXXXXXXXXXXXXXXXXXXXXXXXXX-XXXXXXXXXXXXXXXXXXXXXXXXXXX-XXXXXXXXXXXXXXXXXXXXXXXXXXX-XXXXXXXXXXXXXXXXXXXXXXXXXXXXXXXXXXXXXXXXXXXXXXXXXXXXXXXXXXXXXXXXXXXXXXXXXXXXXXXXXXX-XXXXXXXXXXXXXXXXXXXXXXXXXXX-XXXXXXXXXXXXXXXXXXXXXXXXXXX-XXXXXXXXXXXXXXXXXXXXXXXXXXX-XXXXXXXXXXXXXXXXXXXXXXXXXXX
