--------------------------------------------------------------------------------------------------------------------------------------------------------------------------------------------------------------------------------------------------------------------------------------------------------------------------------------------------------------------------------------------------------------------------------------------------------------------------------------------------------------------------------------------------------------------------------------------------------------------------------------------------------------------------------------------------------------------------------------------------------------------------------------------------------------------------------------------------------------------------------------------------------------------------------------------------------------------------------------------------------------------------------------------------------------------------------------------------------------------------------------------------------------------------------------------------------------------------------------------------------------------------------------------------------------------------------------------------------------------------------------------------------------------------------------------------------
---------------------------------------------------------------------------------------------------------------------------------------------------------------------------------------------------------------------------------------------------------------------------------------------------------------------------------------------------------------------------------------------------------------------------------------------------------------Q-----------------------------------------------------------------------------------------------------------------------------------------------------------------------------------------------------------------------------------------------------------------------------------------------------------------------------------------------------------------------------------------------------------------------------------------------------------------------------------------------------------------------------------------------------------------------------------------------------------------------------------------------------------------------------------------------------------------------------------------------------------------------------------Q----------------------------------------------------------------------------------------------------------------------------------------------------------------------------------------------------
--------------------------------------------------------------------------------------------------------------------------------------------------------------------------------------------------------------------------------------------------------------------------------------------------------------------------------------------------------------------------------------------------------------------------------------------------------------------------------------------------------------------------------------------------------------------------------------------------------------------------------------------------------------------------------------------------------------------------------------------------------------------------------------------------------------------------------------------------------------------------------------------------------------------------------------------------------------------------------------------------------------------------------------------------------------------------------------------------------------------------------------------------------------------------------------------------------------------------------------------------------------------------------------------------------------------------------------------------------------------------------------------------------------------------------------------------------
-------------------------------------------------------------------------------------------------------------------------------------------------------------------------------------------------------------------------------------------------------------------------------------------------------------------------------------------------------------------------------------------------------------------------------------------------------------------------------------------------------------------------------------------------------------------------------------------------------------------------------------------------------------------------------------------------------------------------------------------------------------------------------------------------------------------------------------------------------------------------------------------------------------------------------------------------------------------------------------------------------------------------------------------------------------------------------------------------------------------------------------------------------------------------------------------------------------------------------------------------------------------------------------------------------------------------------------------------------------------E------------------------------------------------------------------------------------
--------------------------------------------------------------------------------------------------------------------------------------------------------------------------------------------------------------------------------------------------------------------------------------------------------------------------------------------------------------------------------------------------------------------------------------------------------------------------------------------------------------------------------------------------------------------------------------------------------------------------------------------------------------------------------------------------------------------------------------------------------------------------------------------------------------------------------------------------------------------------------------------------------------------------------------------------------------------------------------------------------------------------------------------------------------------------------------------------------------------------------------------------------------------------------------------------------------------------------------------------------------------------------------------------------------------------------------------------------------------------------------------------------------------------------------------------------
-------------------------SS--------------------------SSS------------------------SSSSo--------QQQQ------------------------?--E------------------------Q-Q-------------------------?--E-----------SSS----------?--E------------------------?--E-----------S------------?-Q----------------o--------?--E-----------SSS----------?--E------------------------QQQ-QQ-S---------------------------S--------SSS------------E-------------SS---------?--------------SSQQ------------------------------------------------------QQ---------------------SSSSSSS-----------------------------------------------------------------?---------------------------?--E-----------SSS--------------------------------------?--E-----------SSSS---------?--E------------------------?-QQ----------------------------------------------------?--E------------------------?--E-----------SSS----------?-QE------------------------Q-Q-------------------------?--E------------------------?S-E----------SSSSS------------E---------------o--------Q-Q-----------------------------------------------------?--E-----------SSS----------?--E---------------o--------Q--------------SSSS-------------------------------------?---------------SS----------?--E------------SSS---------Q-----------------------------------------------------------------------------------?--E--------SSSSSSS-----------?-SSS-----SSSS------------Q-Q-------------SS-o--------?--E-----------SSS-
--------------X------------------------------------------------------------------------------------------------------------XXXXXX----------------------------------------------------XXX-----------------------XXXXXX----------------------QXXXXX---------XX--------------------------XX-----------XXXXXX----------------------XXXXX----------XX---------------------------------------------------------------------XXX--------------E-------------------------------------------------------------------------------------------------------------------------------------------------------------------XX--------------X------------------------XXXXXX----------------------------------------------------XXX-----------------------XXXXXX--------------------------X----------XX---------------------------------------XXXXX-----------------------XXXXXX-------------------------XX----------XX-----------------------------------------XXX------------------------XXXX-------------------------XX---------------------------XX----------XX---------------------------------------QXXXX-----------------------XXXXXX-----------------------------------------------------------------XX--------------X---------------------------XX--------------------------------------------------------------------------------------------------------------X--------------------------------------------------------------------------------XXXXXX----------X
----------------------------------------------------------------------------------------------------------------------------------------------------------------------------------------------------------------------------------------------Q---XXX-------------------------XXX---------------------Q---------------------------Q--------------------------------------------------------------------------------------------------<>-----------------------------------------XXX-------------------------------------------------------------------------------------------------------------------------------------------------------------------Q-------------------------------------------------------------------------------------------------------------------XXX-----------------------------------------------------------------------------Q-------------------------------------------------------------------------------------------------------------------------------------------------------------------------------------------------------------------------------------------------------------------------------------------------------------------------------------------------------------------------------------------------------------------------------------------------------------------------------------------------------------------------------------------------------------------------------Q-------------
------E-------------------------E-------------E------------------------------E----------E----------------E----------------------------------------E--------------E--?-----------------------------------E-----------------------------E------------------------------------------E-----------------------------------------------------------------------------------E----------E-------------E-----------E-E-------------------E----[]---------------E--E---------------------XXXX-----------E---------------E-----------------------------------------------------------------------E--------------E----------E-------------------------------------------------------E----------------E------------E-------------------------------------------------------E-------------------------E----------------E----------------------------------------E------------------------------------------E---------------------------E------------E---------------------------E-------------------------E---------------------------------------------------------E-----------------------------------------------------E---------------------------E-----------------------------E--------------E------------------------------------E---------------E--E----------E-------------E---------------------------------------E---------------------E-----E---E---------------------------E------------------------------------------E------------E---------------------
--E--<>---QQQ------------------<>------------<>-----E----------Q--Q-Q-------<>--------E<>--E?-QQQ-------<>--------E-E----SQQQ-----------E-----E-E<>---QQQ-------<>-----Q--E-E<>--SQQQ-----------------E<>--E?SQQQ-----------E-------E<>--SQQQQ------------------E<>---QQQQ------<>-----Q--E-E<>--SQQQ-----------------E-E--E?SQQQ--------------------<>---QQQQ------<>---QQQ--E<>----QQQQ----<>-----E----<><>----S--------E----<>----[]---E--S-------<>-<>----ES-------------XXXX-X----------<>----E---------<>------E??--E---------------E-----E-----E--<>-----------------E-----E--<>---QQQ-------<>---QQQ--E<>--E--QQQ-----------E-----E----E?SQQQ-----------------E<>--E--QQQ-------<>-----Q--E-E<>---QQQQ----------------E<>--E-SQQQ-----------E-----E--<>---QQQQ------<>---QQQ--E<>--E?-QQQQ------<>-----Q--E-E-----QQQ-----------E-----E-E<>--SQQQ-----------E-----E-E<>--SQQQ-------<>-----Q--E-E<>--SQQQ-------<>-----Q--E-E<>---QQQ-----------E-----E-E<>--SQQQ-----------E-----E<>-----QQ------------E-------E<>---QQQQ---Q------------E-E<>---QQQQ-------E--------E-E<>--SQQQ-----------E-----E<>---?SQQQ-----------E-----E<>-----QQQ-----------------E--<>---QQQQ------<>-----Q--E-E<>---QQQ----------------<>-----?SQQ-----<>-<>----E?--E<>--E-SQQQ----<>--------------X-----------------------<>--------------------<>----<>--<>---QQQ-----------------E--<>----QQQ---QQQ-------X--E----Q--Q-Q-------<>---QQQ----E<>--SQQQ---------------
-<>--[]------------------------[]------------[]----<>-----E-----------------[]-------<>[]---------------[]-------<><>------------------<>----<><>[]-------------[]-------<><>[]----------------------<>[]------------------<>----<><>[]-----------------------E<>[]-------------[]-------<><>[]----------------------<><>----------------------------[]-------------[]-------<>[]------------[]----<>----[][]------------<>----[]-X--[]--<>----------[]-[]--E--------------XXX-XX-X----------[]--------------[]----------<>--------------<>----<>----<>--[]----------------<>----<>--[]-------------[]-------<>[]------------------<>----<><>-------------------E----<>[]---------------[]-------<><>[]----------------------<>[]------------------<>----<>--[]-------------[]-------<>[]---------------[]-------<><>------------------<>----<><>[]----------------<>----<><>[]-------------[]-------<><>[]-------------[]-------<><>[]----------------<>----<><>[]----------------<>----<>[]------------------<>----<><>[]----------------------<><>[]-------------<>-------<><>[]----------------<>----<>[]------------------<>----<>[]------------------------<>--[]-------------[]-------<><>[]----------------------[]--------------[]-[]--E----<>[]------------[]--------------------------------------[]--------------E-----[]----[]--[]----------------------<>--[]----------------------<>-----------------[]-------<><>[]---------------------
-[]--[]--------------------X---[]------------[]----[]----<>-----------------[]-------[][]---------------[]-------[][]------------------[]----[][][]-------------[]-------[][][]----------------------[][]------------------[]----[][][]----------------------<>[][]-------------[]-------[][][]----------------------[][]------------------------<>--[]-------------[]-------[][]------------[]----[]----[][]------------[]----[]-X--[]--[]----------[]-<>-<>-------------XXXX-XX-X----------[]--------------[]----------[]--------------[]----[]----[]--[]----------------[]----[]--[]-------------[]-------[][]------------------[]----[][]------------------<>----[][]---------------[]-------[][][]----------------------[][]------------------[]----[]--[]-------------[]-------[][]---------------[]-------[][]------------------[]----[][][]----------------[]----[][][]-------------[]-------[][][]-------------[]-------[][][]----------------[]----[][][]----------------[]----[][]------------------[]----[][][]----------------------[][][]-------------[]-------[][][]----------------[]----[][]------------------[]----[][]------------------------[]--[]-------------[]-------[][][]----------------------[]-E------------[]-[]-<>----[][]------------[]--------------------------------------[]---------------?----[]----[]--[]----------------------[]--[]--------------------X-[]-----------------[]-------[][][]---------------------
-[]--[]------EE-EE--------XX---XX---------E--[]----[]-E--[]--------E--E--E--[]-E-EE--[][]---------E-EE--[]-E-E---[][]--------EE-EE-E---[]----[][][]-------E-EE--[]----E--[][][]------EE-EE-E---------[][]--------EE-EE-E---[]----[][][]-E----EE-EE-E---------[][][]------EE-EE--[]-EE-E--[][][]------EE-EE-E---------[][]---------E-EE-E---------[]--[]-------EE----[]--E-E--[][]-E----E-E---[]----[]-X--[][]--------EE-E[]-E--[]----[]--[]----E--E--[]-[]-[]------------XXXXX-X--X---E-EE-E-[]-------EE-EE--[]----------[]-------EE-E---[]----[]-E--[]--[]------EE-E----E-[]----[]--[]-------EEEE--[]-EE-E--[][]--------EE-EE-E---[]----[][]---------E-EE-E---[]----[][]--------EE-EE--[]-EE-E--[][][]------EE-EE-E---------[][]-E------EE-EE-E---[]----[]--[]-------E-EE--[]--E-E--[][]--------EE-EE--[]-EE-E--[][]-E------EE-EE-E---[]----[][][]------EE-EE-E---[]----[][][]-------E-EE--[]-EE-E--[][][]-------E-EE--[]-E--E--[][][]------EE-EE-E---[]----[][][]------EE-EE-E---[]----[][]--------EE-EE-E---[]----[][][]------EE-EE-----EE-E--[][][]------EE-EE--[]-EE-E--[][][]------EE-EE-----[]----[][]--------EE-EE-E---[]----[][]---------E-EE-E---------[]--[]------EE-EE--[]-EE-E--[][][]------EE-EE-E---------[][]---------E--[]-[]-[]----[][]--------EE-E[]---------------------------------EE---[]----------EE-E------[]-X--[]--[]----E-EE-EE-E---------[]--[]---------EE---------X-[]--------E--E--E--[]----E--[][][]-E----EE-EE----------
XXXXXXXXXXXXXXXXXXXXXXXXXXXXXXXXXX-XXXXXXXXXXXXXXXXXXXXX-XXXXXXXXXXXXXXXXXXXXXXXXXXX-XXXXXXXXXXXXXXXXXXXXXXXXXXX-XXXXXXXXXXXXXXXXXXXXXXXXXXX-XXXXXXXXXXXXXXXXXXXXXXXXXXXXXXXXXXXXXXXXXXXXXXXXXXXXXXX-XXXXXXXXXXXXXXXXXXXXXXXXXXX-XXXXXXXXXXXXXXXXXXXXXXXXXXX-XXXXXXXXXXXXXXXXXXXXXXXXXXXXXXXXXXXXXXXXXXXXXXXXXXXXXXX-XXXXXXXXXXXXXXXXXXXXXXXXXXX-XXXXXXXXXXXXXXXXXXXXXXXXXXX-XXXXXXXXXXXXXXXXXXXXXXXXXXXXXXXXXXXXXXXXXXXXXXXXXXXXXS-XXXXXXXXXXXXXXXXXXXXXXXXXXXX-----XXXXXXXXX-X--XXXXXXXXXX-XXXXXXXXXXXXXXXXXXXXXXXXXXXXXXX--XXXXXXXXXXXXXXXXXXXXXX-XXXXXXXXXXXXXXXXXXXXXXXXXXXXXXXXXXXXXXXXXXXXXXXXXXXXXXX-XXXXXXXXXXXXXXXXXXXXXXXXXXX-XXXXXXXXXXXXXXXXXXXXXXXXXXX-XXXXXXXXXXXXXXXXXXXXXXXXXXX-XXXXXXXXXXXXXXXXXXXXXXXXXXXXXXXXXXXXXXXXXXXXXXXXXXXXXXXXXXXXXXXXXXXXXXXXXXXXXXXXXXX-XXXXXXXXXXXXXXXXXXXXXXXXXXXXXXXXXXXXXXXXXXXXXXXXXXXXXXX-XXXXXXXXXXXXXXXXXXXXXXXXXXX-XXXXXXXXXXXXXXXXXXXXXXXXXXXXXXXXXXXXXXXXXXXXXXXXXXXXXXX-XXXXXXXXXXXXXXXXXXXXXXXXXXX-XXXXXXXXXXXXXXXXXXXXXXXXXXX-XXXXXXXXXXXXXXXXXXXXXXXXXXX-XXXXXXXXXXXXXXXXXXXXXXXXXXX-XXXXXXXXXXXXXXXXXXXXXXXXXXX-XXXXXXXXXXXXXXXXXXXXXXXXXXX-XXXXXXXXXXXXXXXXXXXXXXXXXXX-XXXXXXXXXXXXXXXXXXXXXXXXXXXXXXXXXXXXXXXXXXXXXXXXXXXXXXXXXXXXXXXXXXXXXXXXXXXXXXXXXXXXXXXXXXXXXXXXXXXXXXXXXXXXXXXXXXXXXXXXXXXXXXXXXXXXXXXXXXX--XXX------XXXXX----XXXXXXXX-XXXXXXXXXXXXXXXXXXXXXXXXXX--XXXXXXXXXXXXXXXXXXXXXXXXXXXXXXXXXXXXXXXXXXXXXXXXXXXXXXX-XXXXXXXXXXXXXXXXXXXXXXXXXXX-XXXXXXXXXXXXXXXXXXXXXXXXXXX
