--------------------------------------------------------------------------------------------------------------------------------------------------------------------------------------------------------------------------------------------------------------------------------------------------------------------------------------------------------------------------------------------------------------------------------------------------------------------------------------------------------------------------------------------------------------------------------------------------------------------------------------------------------------------------------------------------------------------------------------------------------------------------------------------------------------------------------------------------------------------------------------------------------------------------------------------------------------------------------------------------------------------------------------------------------------------------------------------------------------------------------------------------------------------------------------------------------------------------------------------------------------------------------------------------------------------------------------------------------------------------------------------------------------------------------------------------------
---------------------------------------------------------------------------------------------------------------------------------------------------------------------------------------------------------------------------------------------------------------------------------------------------------------------------------------------------------------------------Q----------------------------------------------------------------------------------------------------------------------------------------------------------------------------------------------------------------------------------------------------------------------------------------------------------------------------------------------------------------------------------------------------------------------------------------------------------------------------------------------------------------------------------------------------------------------------------------------------------------------------------------------------------------------------------------------------------------------------------------------------------------------------------------------------------------------------------------------------------------------------------------------------------------------------------------------------------------------------------------------------------------------------------------------------------------------------
---------------------------------------------------------------------------------------------------------------------------------------------------------------------------------------------------------------------------------------------------------------------------------------------------------------------------------------------------------------------------------------------------------------------------------------------------------------------------------------------------------------------------------------------------------------------------------------------------------------------------------------------------------------------------------------------------------------------------------oo---------------------------------------------------------------------------------------------------------------------------------------------------------------------------------------------------------------------------------------------------------------------------------------------------------------------------------------------------------------------------------------------------------------------------------------------------------------------------------------------------------------------------------------------------------------------------------------------------------------------------------------------------------------------------------------------------------------------
---------------------------------------------------------------------------------------------------------------E-----------------------------------------------------------------------------------------------------------------------X----------------------------------------------------------------------------------------------------------------------------------------------------------------------------------------------------------------------------------------------------------------------------------------------------------------------------------------------------------------------------------------------------------------------------------------------------------------------------------------XXXX-------------------------------------------------------------------------------------------------------------------------------------------------------------------------------------------------------------------------------------------------------------------------------------------------------------------X-----------------------------------------------------------------------------------X------------------------------------------------------------------------------------------------------------------------------------------------------------------------------------------------------------------------------------------------------------------------------------------------------------
---------------E---------------------------------------------------------------------------------------------E------------------------------------------------------------------------------------------------------------------------------------------------------------------------------------------------------------------------------------------------------------------------------------------------------------------------------------------------------------------------------------------------------------------------------------------------------------------------------------------------------------------------------------------------------------------------------------------------------------------------------------------------------------------------------------------------------------------------------------------------------------------------------------------------------------------------------------------------------------------------------------------------------------------------------------------------------------------------------------------------------------------------------------------------------------------------------------------------------------------------------------------------------------------------------------------------------------------------------------------------------------------------------------------------------------------------------------------
--------------SSS---SSSSSSS--------------------------SQQ-------------------------SSS------------------------SSS----------------------------S-------------------SSSSSSQSQ--------------S------SSSSSSS---------?--E-----XX----------------------S------SSSSSSS------------E--------------S------------------XX-----------------?--E-----------QSQ----------?--E----------SSSSS---------------------SSSSSSS-------------------------SSS-----------------------SSSS--------------------------SSS-------------SS-------SS--SS-------?-Q--E--------SSSSS---------------SS---Q?-----------------?--E---------Q-QQQ----------------------SSSSSSS-------------SSSS-SSSSSSSS---------S------Q------SQSSS-----------?--E------------------------------------SSSSSSS-------------------------SSS---------?-?ESSS---------SSS------------------Q-------SS--------------------------SS-----------?QSSS-----SQSSSS----------?--E------------------------?------------SSSSSS------------E---------------------------------------SSSS---------?--E-S------SSSSSSS---------?--E--------SSSSSSS--------------S------SSSSSSS---------?--E-----------SSSS---------?--E-----------SSSS---------------------S---------------?--E--------SQSSSS----------?--E---------SSSSSS---------?--E--------------S------------------QS------S----------?--E------------SSS---------------------SSSSSSS---------?--E----------SSSSS------------------------SSSS---------?--E----------SSSSS
-------------------------------------------------------------------------------------------------------------------------------------------------------------------------------------XX------------------------XXXXX-------------------------XX--------------------------------------------------------------------------------XXXXX-----------------------XX-XXX------------------------------------------------------------------------------------------------------------XXX--------------------------X------------------------XXXXX------------------------------------------------------XX------------------------------------------------------------------------------------------------------------XXX----------------------------------------------------------------------------------XXX----------------------------------------------------------------------------------X---------------------------X---------------------------X------------------------XXXXX-----------------------------------------------------XXX-------------------------XXX-----------------------------------------------------XXX-----------------------XXXXX------------------------------------------------------X------------------------XXXXXX------------------------XXX-----------------------------------------------------XXX-------------------------XX------------------------XXXXX---------------------------------------------------XXXXX------------
--------------------------------------------------------------------------------------------------------------------------------------------------------------------------------------------------------------------------------------E-----------------------------------------------------------------------------------E-----------------------------------------------------------------------------------------------------------------------------------------------------------------------------------------------------------Q-----------------------------------------------E-------------------------------------------------------E---------------------------------------------------------------------------------------------------------------------------------------------------Q---------------------------------------------------------------------------------------------------------------------------------------------------------------E-------------------------------------------------------E---------------------------E---------------------------E---------------------------E---------------------------E---------------------XXXX----------------XX--oo--------------------------------------------------------------------------------------------------------------------------------------------------------------------------------E---------------------------E---------------------------E---------------------
------E--------------E--------E-------------------------------------------E--S----------------------------------------------------------E-----E-------------------------------------------------E------------------------------------<>---------------------------E------------------------------------------------------<>-----------------------E---------------E---------------E-----------------------E---------------------E--o--E-------------------------------E-----------------E-------------------------------------E---------------------------E-----------------------E--<>---------------------------E--------------------------<>---------------------------E-------------------------------------------------------E-------------------------------------------------------E-----------------E-------------------------------------------------------E--S------E---------------------------E-----------------------E------------------------------<>---------------------------------------------E--o-----<>-----------------------E--<>-----------------E--------<>-----------------------E--<>-----------------E--o-<>--<>-----------------E---------------------------------E---E---------------------------E-----------------E--o------E-----------------E--o------E---------------------------E-----------------E--o------E--------------------------<>-----------------E--o--E--<>-----------------E--o--E--<>-----------------E---
--E--<>---Q-Q-Q-----<>---QQ--<>--------------------------------Q------Q--<>-----E-----E--------QQ-------<>---QQQ-----------------------<>----<>------------------S?-------E-----------Q--------<>-----E----E-SQQQ-----------------E--[]-------Q---------E-----E--<>----QQ----Q------E--------------------E------------E--[]----QQ----------------<>----E?S-------<>-----E-----E--<>----------S------E----<>---------------E----<>----<>------------------------------<>-------Q--------<>--------------------QQ-----E-----E--<>--S-QQQ----------------E--------------S------E----<>--[]----QQ----Q-------QQQ--E--<>-----------------E-----E--[]----QQ----Q-QQ------------<>-----QQQ--Q-Q--?S-------------S-QQQ---QQQ----E-----E--<>-------Q---------E-----E-------------------<>------E--<>-------Q--------<>--------X-----------S------E---------------------E----<>-----E--<>----QQQ---QQQ-QQS------E--<>--S-QQ-----Q---<>-----<>--<>-----------E-----E-----E--[]----QQ----S------E--------------------------<>-----E--[]-----QQ-------S-------<>--[]-------Q--------<>-----E--[]----------S------E----<>--[]-----------E----<>----[]--[]-----------E----<>------------------XXX---S?S-----<>--<>---QQQ-----------E--S--E--<>--S-------------<>-----E--<>----------------<>-----E--<>----------S------E-----E--<>-----------E----<>-----E--<>----------S------E-----E--[]-----------E----<>----<>--[]-----------E----<>----<>--[]-----------E----<>---
-<>--[]-------------[]-------[]------------------------------------------[]----<>----<>-----------------[]-----------------------------[]----[]------<>------------------<>--------------------[]----<>--------------------------<>--[]----------------<>----<>--[]----------------<>-------------------<>-----------<>--[]----------------------[]--------------[]----<>----<>--[]----------------<>----[]--------------<>----[]----[]------------------------------[]----------------[]--------------------------<>----<>--[]-----------------E-----E--XX----------------<>----[]--[]--------------E-------<>--[]----------------<>----<>--[]--------------------------[]--------------------------------------------<>--------[]----------------<>----<>-------------------[]-----<>--[]----------------[]--------XX----------------<>--------------------<>----[]----<>--[]----------------------<>--[]---------------[]-----[]--[]----------------<>----<>--[]----------------<>--------<>----------------[]----<>--[]----------------------[]--[]----------------[]----<>--[]----------------<>----[]--[]----------<>----[]----[]--[]----------<>----[]------------E-------------------[]--[]----------------<>----<>--[]----------------[]----<>--[]----------------[]----<>--[]----------------<>----<>--[]----------<>----[]----<>--[]----------------<>----<>--[]----------<>----[]----[]--[]----------------[]----[]--[]----------<>----[]---
-[]--[]-------------[]-------[]------------------------------------------[]----[]----[]-----------------<>-----------------------------[]----[]------[]------------------[]--------------------[]----[]--------------------------[]--[]----------------[]----[]--[]----------------[]-------------------[]-----------[]--[]-----------------E----[]--------------[]----[]----[]--[]----------------[]----[]--------------[]----[]----[]-------------------<>---------[]----------------[]--------------------------[]----[]--[]----------------<>--------XX----------------[]----[]--[]-------------<>-------[]--[]----------------[]----[]--[]--------------------------[]--------------------------------------------[]--------[]----------------[]----[]-------------------[]-----[]--[]----------------[]--------XX----------------[]--------------------[]----[]----[]--[]----------------------[]--[]---------------[]-----[]--[]----------------[]----[]--[]----------------[]--------[]----------------[]----[]--[]----------------------[]--[]----------------[]----[]--[]----------------[]----[]--[]----------[]----[]----[]--[]----------[]----[]--------XXX-------------------X-[]--[]----------------[]----[]--[]----------------[]----[]--[]----------------[]----[]--[]----------------[]----[]--[]----------[]----[]----[]--[]----------------[]----[]--[]----------[]----[]----[]--[]-----------?----[]----[]--[]----------[]----[]---
-[]--[]----E--EE----[]-------[]--EE-EE-E--EE----------------------EE-E---[]----[]----[]-----------E-----[]-----------------E-E---E-----[]----[]------[]---------E-E------[]-------EE-E---E-EE--[]----[]-----------E-EE-E---------[]--[]---EE-E---E-EE--[]----[]-E[]----E--E-EE-E---[]----E-EE-EE--------[]-----------[]-E[]----E-EE-EE-E---------[]-----------E--[]-E--[]----[]--[]---EE-E---E-E---[]----[]--------E-----[]E---[]----[]--------E--E-EE-E--[]---------[]----E-----E-E---[]--------------E--E-EE-E---[]----[]-E[]----E-E--EE-E---[]--------XX-------E-EE-E---[]----[]-E[]------E------[]-------[]--[]----E-E---E-EE--[]----[]-E[]---------E-E-E------------[]----E-----E-EE---------------------E-EE-E---[]--------[]---EE-E---E-EE--[]----[]-----------E-EE----[]-----[]--[]----E-E--EE-E---[]--------XX----E-EE-EE-E---[]--------------E-E---[]----[]----[]--[]---------EE-----------[]--[]-------E-EE-E--[]-----[]--[]---EE-E---E-E---[]----[]--[]------EE-EE-E---[]--------XXX---E-EE-EE-E---[]----[]-E[]----E----EE-EE--------[]--[]---EE-E---E-EE--[]----[]--[]----E-E---E-EE--[]----[]-E[]---EE-E---XXE---[]----[]--[]---EE-EE--[]-E--[]--------------E--------------XX-[]--[]----E-EE-EE-E---[]----[]--[]------E--EE-E---[]----[]--[]---EE-E--EE-E---[]----[]--[]----E-EE-EE-E---[]----[]--[]----E-EE--XXE---[]----[]-E[]----E-E---E-E---[]----[]-E[]----E-E---XX----[]----[]--[]---EE-E---E-E---[]----[]-E[]----E-E---[]----[]---
-XXXXXXXXXXXXXXXXXXXXXX-XXXX-XXXXXXXXXXXXXXXXXXXXX--XXXXXXX---XXXXXXXXXXXXXXXXXXXXXX-XXXXXXXXXXXXXXXXXXXXXXXXXXXXXXX---XXXXXXXXXXXXXXXXXXXXXXXXXXXXXXXXXXXXXXXXXXXXX-XXX-XXXXXXXXXXXXXXXXXXXXXXXXXXX-XXXXXXXXXXXXXXXXXXXXXXXXXXXXXXXXXXXXXXXXXXXXXXXXXXXXXXX-XXXXXXXXXXXXXXXXXXXXXXXXXXXXXXXXXXXXXXXXXXXXXXXXXXXXXXX-XXXXXXXXXXXXXXXXXXXXXXXXXXXXXXXXXXXXXXXXXXXXXXXXXXXXXXX-XX--XXXXXXXXXXXXXXXXXXXXXXXXXXXXXXXXXXXXXXXXXXXXXXXXXXX-XXXXXXXXXXXXXXXXXXXXXXXXXXXXXXXXXXXXXXXXXXXXXXXXXXXXXXXXXXXXXXXXXXXXXXXXXXXXXXXXXXX-XXXXXXXXXXXXXXXXXXXXXXXXXXXXXX--XX--XXXXXXXXXXXXXXXXXXX-XXXXXXXXXXXXXXXXXXXXXXXXXXX-XX--XXXXXXXXXXXXXXXXXXXXXXX-XXXXXXXXXXXXXXXXXXXXXXX-XXXXXXXXXXXXXXXXXXXXXXXXXXXXXXXXXXXXXXXXXXXXXXXXXXXXXXXXXXXXXXXXXXXXXXXXXXXXXXXXXXXXXXX-XXXXXXXXXXXXXXXXXXXXXXXXXXX-XXXXXXXXXXXXXXXXXXXXXXXXXXXXXXX-XX--XXXXXXXXXXXXXXXXXXXXXXXXXXXXXXXXXXXXXXXXXXXXXXX-XXXXXXXXXXXXXXXXXXXXXXXXXXX-XXXXXXXXXXXXXXXXXXXXXXXXXXX-XXXXXXXXXXXXXXXXXXXXXXXXXXXXXXXXXXXXXXXXXXXXXXXXXXXXXXXXXX--XXXXXXXXXXXXXXXXXXXXXXX-XXXXXXXXXXXXXXXXXXXXXXXXXXXXXXXXXXXXXXXXXXXXXXXXXXXXXXXXXXXXXXXXXXXXXXXXXXXXXXXXXXXXXXXXXXXXXXXXXXXXXXXXXXXXXXXXXXXXXXXXXXXXXXXXXXXXXXXXXXXXXX-------XXXXX-XXXXXXoo-XXXXXXXXXXXXXXXXXXXXXXXXXXXXXXXXXXXXXXXXXXXXXXXXXXXXXXXXXXXXXXXXXXXXXXXXXXXXXXXXXXXXXXX-XX--XXXXXXXXXXXXXXXXXXXXXXX-XXXXXXXXXXXXXXXXXXXXXXXXXXXXXXXXXXXXXXXXXXXXXXXXXXXXXXX-XXXXXXXXXXXXXXXXXXXXXXXXXXX-XXXXXXXXXXXXXXXXXXXXXXXXXXXXXXXXXXXXXXXXXXXXXXXXXXXXXXX
