--------------------------------------------------------------------------------------------------------------------------------------------------------------------------------------------------------------------------------------------------------------------------------------------------------------------------------------------------------------------------------------------------------------------------------------------------------------------------------------------------------------------------------------------------------------------------------------------------------------------------------------------------------------------------------------------------------------------------------------------------------------------------------------------------------------------------------------------------------------------------------------------------------------------------------------------------------------------------------------------------------------------------------------------------------------------------------------------------------------------------------------------------------------------------------------------------------------------------------------------------------------------------------------------------------------------------------------------------------------------------------------------------------------------------------------------------------
-------------------------------------------------------------------------------------------------------------------------------------------------------------------------------------------------------------------------------------------------------------------------------------------------------------------------------------------------------------------------------------------------------------------------------------------------------------------------------------------------------------------------------------------------------------------------------------------------------------------------------------------------------------------------------------------------------------------------------------------------------------------------------------------------------------------------------------------------------------------------------------------------------------------------------Q------------------------------------------------------------------------------------------------------------------------------------------------------------------------------------------------------------------------------------------------------------------------------------------------------------------------------------------------------------------------------------------------------------------------------------------------------------------------------------------------------------------------
--------------------------------------------------------------------------------------------------------------------------------------------------------------------------------------------------------------------------------------------------------------------------------------------------------------------------------------------------------------------------------------------------------------------------------------------------------------------------------------------------------------------------------------------------------------------------------------------------------------------------------------------------------------------------------------------------------------------------------------------------------------------------------------------------------------------------------------------------------------------------------------------------------------------------------------------------------------------------------------------------------------------------------------------------------------------------------------------------------------------------------------------------------------------------------------------------------------------------------------------------------------------------------------------------------------------------------------------------------------------------------------------------------------------------------------------------------
---------------------------E---------------------------------------------------------------------------------------------------------------------------------------------------------------------------------------------------------XXX-------------------------------------------------------------------------------------------------------------------------------------------------------------------------------------------------------------------------------------------------------------------------------------------------------------------------------------------------------------------------------------------------------------------------------------------------------------------------------------------------------------------------------------------------------------------------------------------------------------------------------------------------------------------------------------------------------------------------------------------------------------------------------------------------------------------------------------------X--------------------------------------------------------------------------------------------------------------------------------------------------------------------------------------------------------------------------------------------------------------------------------------------------------------------------------------------------------------------
-------------------------------------------------------E------------------------------------------------------------------------------------------------------------------------------------------------------------------------------------------------------------------------------------------------------------------------------------------------------------------------------------------------------------------------------------------------------------------------------------------------------------------------------------------------------------------------------------------------------------------------------------------------------------------------------------------------------------------------------------------------------------------------------------------------------------------------------------------------------------------------------------------------------------------------------------------------------------------------------------------------------------------------------------------------------------------------------------------------------------------------------------------------------------------------------------------------------------------------------------------------------------------------------------------------------------------------------------------------------------------------------------------------------------------------------------------------
---------?--E----------SSSS--------------------------SSS---------?--E---------SSSSSS--------------------------SS---------?--E--------SSSSSSS---------?--E--------SSSSSSS--------------------------SS---------?--E---------SSSSSS---------?--E--------SSSSSSS------------E-----------SSSS---------------------SSSSSSS---------------------SSSSSSS---------?--E------------SSS---------------------SSSSSSS--------------S----------SSS---------------------SSSS--S------------------------SSSS-------------SS------SSSSSSS----------------------SSSSSS-------------SS------SSSSSSS--------------------------SS---------?--E------------SSS-------------SSS----SSSSSSSS---------------------SSSSSSS---------------------SSSSSSS---------------------------S-------------------------SSS-----------------------SSSSS-------------SSS----SSSSSSSS------------E----------SSSSS------------------------SSSS---------?--E------------SSS---------?--E-----------SSSS---------?--E--------SSSSSSS-------------------S--SSSSSS---------?-?E------------SSS------------E------------SSS------------E-----------SSSS----------------------SSSSSS---------?--E--------SSSSSSS---------?--E-----------SSSS---------?--E--------SSSSSSS---------?--E-----SS-----SSS---------?--E-------------S---------------S------SSSSSSS---------?--E------------SSS---------------------SSSSSSS---------?-?E--------SSSSSS----------?--E------------SSS---------?--E--------SSSSSSS
-----------XXXXXX--------------------------------------------------XXXXX---------------------------------------------------XXXXX-------------------------XXX---------------------------------------------------XXXXXX------------------------XX--------------------------XX---------------------------------------------------------------------------------XXXX-----------------------------------------------------XXX-----------------------------------------------------XXX-------------------------------------------------------------------------------------------------------------XX--------------------------XXX----------------------------------------------------------------------------------X--------------------------------------------------------------------------------------------------------------XXX------------------------X-X----------------------------------------------------XXXXX-----------------------XXXXX------------------------XXXX---------------------------------------------------XXXXX-------------------------XXX-------------------------XXX-----------------------------------------------------XXX------------------------XXXX------------------------XXXX------------------------XXXX-----------------------XXXXXX------------------------XXX-----------------------XXXXXX-------------------------X------------------------XXXXX-----------------------XXXXXX------------------------XXX------------
------E-------------------------------------------------------E-------------------------------------------------------E---------------------------E-------------------------------------------------------E-------------------------------------------------------E-------------------------------------------------------E---------------------------E---------------------------E-----------------------------------------------------------------------------------------------------------------------------------------------------------------------E-------------------------------------------------------E---------------------------E---------------------------E---------------------------E---------------------------------------------------------------------------------------------------------------E---------------------------E---------------------------E---------------------------E-------------------------------------------------------E---------------------------E-------------------------------------------------------------------------------------------------------------------------------------------E-------------------------------------------------------E---------------------------E---------------------------E---------------------------E---------------------------E---------------------------E---------------------------E-------------------------------------------------------E---------------------
-----<>---------------------------------------------E--o-----<>-----------------E---------------------------E--------<>-----------------E-----E--<>-----------E---------------E-----------------E--o--E--<>-----------------E---------E-----------------E-----E--<>-----------------E--o--E---E-----------------E--o--E--<>--------------------------<>-----------------E--o-----<>---------------------------E-----------------E--o----------------------------------E-----------------E--o------------------------E-----E---------------------E-----E--<>---------------------------E-----------------E--o--E--<>-----------------E--o--E--<>-----------------------E--<>-----------------------E--<>-----------------E---------------------------E--o------------------------E--o--E------------------------------<>-----------------------E--<>-----------------E-----E--<>-----------------E--o--E--<>-----------------E--o--E---------------------E--o--E--<>-----------------E--o-----<>---------------------------E--------------------------<>-----------------E--o------E-----------------E--o------E-----------------E-----E--<>-----------------E---------E-----------------E--o-----<>-----------------E--o--E--<>-----------------E-----E--<>-----------------E--o-----<>-----------------------E--<>-----------------E--o--E--<>-----------------E-----E--<>-----------------------E---------------------E--o-----<>-----------------E---
--E--[]----QQ--------S---QQ?-----------------------<>-----E--[]----QQ----------<>----------Q---------------<>-----E--[]----------------<>----<>--[]----------<>-----E-----E--<>----------S-----<>----<>--[]----------------<>-----E--<>----------------<>----<>--[]-----------E----<>----<>--<>----------------<>----<>--[]-----------------E-----E--[]----------S-----<>-----E--[]-----------------E-----E--<>-------Q--------<>--------------------S-Q----------E--<>----------------<>--------------------S-----<>----<>--------------------<>--S-<>--[]-----------------E-----E--<>----------S-----<>----<>--[]----------------<>----<>--[]-----------------E----<>--[]-----------------E----<>--[]-----------E----<>-----E--------------------<>---------------------S----<>----<>---E-----------E-----E-----E--[]----------------------<>--[]----------------<>----<>--[]-----------E----<>----<>--[]-----------E----<>----<>--<>--S-------------<>----<>--[]----------------<>-----E--[]-----Q-----------E-----E--<>-----------------E-----E--[]----------------<>-----E--<>----------------<>-----E--<>----------S-----<>----<>--[]-----------E----<>-----E--<>----------S-----<>-----E--[]----QQ----------<>----<>--[]----------------<>----<>--[]----------------<>-----E--[]-------Q---------E----<>--[]--S--Q----------<>----<>--[]-----------E----<>----<>--[]-----------------E----<>---E--S-------------<>-----E--[]---QQQ----------<>---
-<>--[]--------------------------------------------[]----<>--[]----------------[]--------------------------[]----<>--[]----------------[]----[]--[]----------[]----<>----<>--[]----------------[]----[]--[]----------------[]----<>--[]----------------[]----[]--[]----------<>----[]----[]--[]----------------[]----[]--[]----------------<>----<>--[]----------------[]----<>--[]----------------<>----<>--[]----------------[]--------------------------------<>--[]----------------[]--------------------------[]----[]--------------------[]----[]--[]----------------<>----<>--[]----------------[]----[]--[]----------------[]----[]--[]----------------<>----[]--[]----------------<>----[]--[]----------------[]----<>--------------------[]--------------------------[]----[]--<>----------<>----<>----<>--[]----------------------[]--[]----------------[]----[]--[]----------<>----[]----[]--[]----------<>----[]----[]--[]----------------[]----[]--[]----------------[]----<>--[]----------------<>----<>--[]----------------<>----<>--[]----------------[]----<>--[]----------------[]----<>--[]----------------[]----[]--[]----------<>----[]----<>--[]----------------[]----<>--[]----------------[]----[]--[]----------------[]----[]--[]----------------[]----<>--[]----------------<>----[]--[]----------------[]----[]--[]----------------[]----[]--[]----------------<>----[]--<>----------------[]----<>--[]----------------[]---
-[]--[]--------------------------------------------[]----[]--[]----------------[]--------------------------[]----[]--[]----------------[]----[]--[]----------[]----[]----[]--[]----------------[]----[]--[]----------------[]----[]--[]----------------[]----[]--[]----------[]----[]----[]--[]----------------[]----[]--[]----------------[]----[]--[]----------------[]----[]--[]----------------[]----[]--[]----------------[]--------------------------------[]--[]----------------[]--------------------------[]----[]--------------------[]----[]--[]----------------[]----[]--[]----------------[]----[]--XX----------------[]----[]--[]----------------[]----[]--[]----------------[]----[]--[]-----------?----[]----[]--------------------[]--------------------------[]----[]--[]----------[]----[]----[]--[]----------------------[]--[]----------------[]----[]--[]----------[]----[]----[]--[]----------[]----[]----[]--[]----------------[]----[]--[]----------------[]----[]--[]----------------[]----[]--[]----------------[]----[]--[]----------------[]----[]--[]----------------[]----[]--[]----------------[]----[]--[]----------[]----[]----[]--[]----------------[]----[]--[]----------------[]----[]--[]----------------[]----[]--[]----------------[]----[]--[]----------------[]----[]--[]----------------[]----[]--[]----------------[]----[]--[]----------------[]----[]--[]----------------[]----[]--[]----------------[]---
-[]--[]------EE-EE---------------------E-EE-EE-E---[]----[]--[]----E-EE--E-E---[]--------------E-EE-EE-E---[]----[]-E[]----E-E---E-E---[]----[]--[]----E-E---[]E---[]----[]--[]-------E-EE-E---[]----[]--[]----E-E---E-E---[]----[]--[]---EE-E---E-EE--[]----[]--[]---EE-E---[]-E--[]----[]--[]---EE-E---E-EE--[]----[]-E[]---EE-E---E-EE--[]----[]-E[]----E--E-EE-E---[]----[]-E[]---EE-E---E-EE--[]----[]--[]---EE-E---E-E---[]--------------E----EE-E---------[]--[]---EE-----E-E---[]--------------E-EE--E-E---[]----[]--------E-----E-EE--[]----[]--[]----E-E---E-EE--[]----[]--[]----E----EE-E---[]----[]--XX----E-----E-E---[]----[]--[]---EE-E--EE-EE--[]----[]--[]----E-----E-EE--[]----[]-E[]---EE-E---E-EE--[]----[]--------E--E-EE-E---[]-------------EE-E---E-EE--[]----[]--[]---EE-----[]----[]----[]-E[]----E-------EE--------[]--[]----E-EE-EE-E---[]----[]--[]---EE-E---[]-E--[]----[]--[]---EE-EE--[]-E--[]----[]--[]----E-EE-EE-E---[]----[]-E[]---EE-E---E-E---[]----[]--[]----E-EE-EE-E---[]----[]-E[]------EE-EE-E---[]----[]-E[]---EE-E---E-E---[]----[]--[]---EE-E---E-E---[]----[]-E[]------EE-EE-E---[]----[]-E[]---EE-E---[]-E--[]----[]--[]----E-EE-EE-E---[]----[]-E[]----E-E--EE-E---[]----[]--[]----E-E---E-E---[]----[]--[]------EE-EE-E---[]----[]-E[]---EE-E---E-E---[]----[]--[]----E-EE-EE-E---[]----[]--[]----E-E---E-E---[]----[]-E[]----E----EE-E---[]----[]--[]-------E-EE-E---[]----[]--[]----E-E--EE-E---[]---
XXXXXXXXXXXXXXXXXXXXXXXXXXXXXXXXXXXXXXXXXXXXXXXXXXXXXXXXXXXXXXXXXXXXXXXXXXXXXXXXXXXXXXXX---XXXXXXXXXXXXXXXXXXXXX-XXXXXXXXXXXXXXXXXXXXXXXXXXXXXXXXXXXXXXXXXXXXXXXXXXXXXXX-XX--XX--XXXXXXXXXXXXXXXXXX-XXXXXXXXXXXXXXXXXXXXXXXXXXXXXXXXXXXXXXXXXXXXXXXXXXXXXXXXXXXXXXXXXXXXXXXXXXXXXXXXXXXX-XXXXXXXXXXXXXXXXXXXXXXXXXXX-XXXXXXXXXXXXXXXXXXXXXXXXXXX-XXXXXXXXXXXXXXXXXXXXXXXXXXX-XXXXXXXXXXXXXXXXXXXXXXXXXXX-XX--XXXXXXXXXXXXXXXXXXXXXXXXXXXX-XXXXXXXXXXXXXXXXXXXXXX-XXXXXXXXXXXXXXXXXXXXXXXXXXXXXX---XXXXXXXXXXXXXXXXXXXXXX-XXXXXXXXXXXXXXXXXXXXXXXXXXX-XXXXXXXXXXXXXXXXXXXXXXXXXXX-XX--XXXXXXXXXXXXXXXXXXXXXXXXXXXXXXXXXXXXXXXXXXXXXXXXXXXXXXXXXXXXXXXXXXXXXXXXXXXXXXX-XXXXXXXXXXXXXXXXXXXXXXXXXXX-XXXXXXXXXXXXXXXXXXXXXXXXXXX-XXXXXXXXXXXXXXXXXXXXXXXXXXXXXXXXXXXXXXXXXXXXXXXXXXXXXXXXXXXXXXXXXXXXXXXXXXXXXXXXXXX-XXXXXXXXXXXXXXXXXXXXXXXXXXX-XXXXXXXXXXXXXXXXXXXXXXXXXXXXXXXXXXXXXXXXXXXXXXXXXXXXXXX-XXXXXXXXXXXXXXXXXXXXXXXXXXX-XXXXXXXXXXXXXXXXXXXXXXXXXXX-XXXXXXXXXXXXXXXXXXXXXXXXXXXXXXXXXXXXXXXXXXXXXXXXXXXXXXX-XXXXXXXXXXXXXXXXXXXXXXXXXXXXXXXXXXXXXXXXXXXXXXXXXXXXXXXXXXXXXXXXXXXXXXXXXXXXXXXXXXX-XXXXXXXXXXXXXXXXXXXXXXXXXXX-XXXXXXXXXXXXXXXXXXXXXXXXXXXXXXXXXXXXXXXXXXXXXXXXXXXXXXX-XXXXXXXXXXXXXXXXXXXXXXXXXXXXXXXXXXXXXXXXXXXXXXXXXXXXXXX-XXXXXXXXXXXXXXXXXXXXXXXXXXX-XXXXXXXXXXXXXXXXXXXXXXXXXXX-XXXXXXXXXXXXXXXXXXXXXXXXXXXXXXXXXXXXXXXXXXXXXXXXXXXXXXX-XXXXXXXXXXXXXXXXXXXXXXXXXXX-XXXXXXXXXXXXXXXXXXXXXXXXXXXXXXXXXXXXXXXXXXXXXXXXXXXXXXX
