--------------------------------------------------------------------------------------------------------------------------------------------------------------------------------------------------------------------------------------------------------------------------------------------------------------------------------------------------------------------------------------------------------------------------------------------------------------------------------------------------------------------------------------------------------------------------------------------------------------------------------------------------------------------------------------------------------------------------------------------------------------------------------------------------------------------------------------------------------------------------------------------------------------------------------------------------------------------------------------------------------------------------------------------------------------------------------------------------------------------------------------------------------------------------------------------------------------------------------------------------------------------------------------------------------------------------------------------------------------------------------------------------------------------------------------------------------
---------------------------------------------------------------------------------------------------------------------------------------------------------------------------------------------------------------------------------------------------------------------------------------------------------------------------------------------------------------------------------------------------------------------------------------------------------------------------------------------------------------------------------------------------Q-----------------------------------------------------------------------------------------------------------------------------------------------------------------------------------------------------------------------------------------------------------------------------------------------------------------------------------------------------------------------------------------------------------------------------------Q----------------------------------------------------------------------------------------------------------------------------------------------------------------------------------------------------------------------------------------------------------------------------------------------------------------------------------------------------------------------------------------------------------------------------------------------------------------
-----oo------------------------------------------------------------------------------------------------------------------------------------------------------------------------------------------------------------------------------------------------------------------------------------------------------------------------------------------------------------------------------------------------------------------------------------------------------------------------------------------------------------------------------------------------------------------------------oo------------------------------------------------------------------------------------------------------------------------------------------o----------------------------------------------------------------------------------------------------------------------------------------------------------------------------------------------------------------------------------------------------------------------------------------------------------------------------------------------------------------------------------------------------------------------------------------------------------------------------------------------------------------------------------------------------------------------------------------------------------------------------------------------------------------------------------------------------------------------
-----XXX-----------------------------------------------------------------------------------------------------------------------------------------------------------------------------------------------------------------------------------------------------------------------------------------------------------------------------------------------------------------------------------------------------------------------------------------------------------------------------------------------------------------------------------------------------------------------------XXX-----------------------------------------------------------------------------------------------------------------------------------------X-----------------------------------------------------------------------------------------------------------------------------------------------------------------------------------------------------------------------------------------------------------------------------------------------------------------------------------------------------------------------------------------------------------------------------------------------------------------------------------------------------------------------------------------------------------------------------------------------------------------------------------------------------------------------------------------------XXX--------------------
--------------------------------------------------------------------------------------------------------------------------------------------------------------------------------------------------------------------------------------------------------------------------------------------------------------------------------------------------------------------------------------------------------------------------------------------------------------------------------------------------------------------------------------------------------------------------------------------------------------------------------------------------------------------------------------------------------------------------------------------------------------------------------------------------------------------------------------------------------------------------------------------------------------------------------------------------------------------------------------------------------------------------------------------------------------------------------------------------------------------------------------------------------------------------------------------------------------------------------------------------------------------------------------------------------------------------------------------------------------------------------------------------------------------------------------------------------
---------?--E---------------o--------?--E------------SSS-------------SSS-----SSSSSSS---------?--E-----------SSSS------------E------------SSS------------------------SSSS---------?--E--------SSSSSSS---------?--E------------SS-------------------------SSSS-----------------------SSSSS---------?--E------------------------------------SSSSSSS---------?--E--------SSSSSSS---------------------SSSSSSS---------?--E------------SSS---------------------SSSSSSS----------------------SSSSSS----------------------SSSSSS---------?--E-------------S--------------------------SSS-----------------SQSSS--SQS-Q------------SS------SSSSSSS---------?-----------SSSSSS----------?--E--------SSS--SS--------------S------SSSSSSSo--------Q-?-SSS-----SSSSSSS------------------Q--SSSSSSS---------?-?E------------SSS------------E----------------------------SS----S-SSSSSSS---------------------SS--SSS------------------------SSSS---------?--E--------SSSSSSS---------?--E------------SSS---------?--E----SSS----SSS-------------E--------------S----------------------SSSSSS---------?--E-------------SS------------E------------SSS---------?--E----------SSSSS---------------------SSS-SSS---------------------SSSSSSS---------------------SSSSSSS---------?--E-----------SSSS---------------------SSSSSSS----------------------SSSSSS---------------------SSSSSSS---------?--E---------SSSSSS---------------------SSSSSSS------------E-------------SS
-----------XXXXX-----------------------XXXXX---------------------------------------------------XXXXX-------------------------XXX-------------------------XX--------------------------XXX--------------------------X---------------------------X----------------------------------------------------XXXXX-----------------------------------------------------XXX---------------------------------------------------XXXXX--------------------------------------------------------------------------------------------------E--------XXXX---------------------------------------------------------------------------------------------------------------X--------------------------XXX-----------------------------------------------------XXX-----------------------------------------------------XXX--------------------------XX-----------------------------------------------------XX--------------------------XXX-----------------------XXXXX-----------------------XXXXX-----------------------XXXX------------------------XXXXX---------------------------------------------------XXXXX------------------------X-X------------------------XXXXX-----------------------------------------------------XXX-----------------------------------------------------XXX------------------------------------------------------X----------------------------------------------------XXXXX--------------------------X-------------------------X-XX------------
------------------------------------------------------------------------------------------E-----------------------------------------------------------------------------------E-----------------------------------------------------------------------------------E-------------------------------------------------------E---------------------------E------------------------------------------------------------------------------------------------------------------------------------------------------------------<>---E---------------------------------------------------------------------X---------------------------------------------------------------------E---------------------------------------------------------------Q-------------------E---------------------------E-----------------------------------------------------------------------------------E---------------------------E---------------------------E-----------------------E---E---------------------------E---------------------------E---------------------------E---------------------------E---------------------------E---------------------------E-------------------------------------------------------E---------------------------E---------------------------E-------------------------------------------------------E-------------------------------------------------------E---------------------------E-------------------------------------------------
------E---------------------------------------------E--o------E-----------------------E--<>-----------------E--o------------------------E--o--E---E-----------------E--o-----<>---------------------------------------------------E---E-----------------E--o-----<>-----------------E--o------E-----------------E--o-----<>-----------------------E--<>-----------------E---------E---------------------------------------------E--o-----<>-----------------------E---------------------E---------------------------E--S-[]--<>-----------------E---------------------------E--o-----<>---------------------------E---------------------------E-----------------------E--<>-----------------------E--<>---------------------------E--------------------------<>--------------------------<>--------------------------<>-----------------E--------<>--------------------------<>-----------------E-----E--<>-----------------E--o--E--<>-----------------E----<>--<>-----------------E--o-----<>-----------------------E--<>-----------------E--o--E--<>-----------------E-----E--<>-----------------E--o--E--<>-----------------E--o--E--<>-----------------E--o------E-----------------E--o--E--<>-----------------E-----E--<>-----------------------E--<>-----------------E--o------E--------------------------<>---------------------------E-----------------------E--<>-----------------E-----E--<>-----------------------E---------------------E--o
--E--<>---QQQ-----------E-------E<>--SQQQ----------<>-----E--<>-----------------E----<>--[]----------------<>-----E--------------------<>----<>--<>----------------<>-----E--[]----------S------E-----E---S----QQ----Q-----------<>--<>-----------E----<>-----E--[]----------------<>-----E--<>----------------<>-----E--[]-------Q---------E----<>--[]-------Q--------<>-----E--<>----------S------E-----E--<>--S-------------<>-----E--[]-----------------E----<>--------------------<>--------X-----------S-----<>----[]--[]-----------E----<>-----E--------------------<>-----E--[]-----QQ-------S?S---------<>------Q---S------E-----E--<>------Q---------------<>--[]-----------------E----<>--[]-------Q---------E--S--E--<>-----QQQ--Q-Q----E-----E--[]-----Q----Q------E-----E--[]-----------------E-----E--[]----------------<>-----E--[]----------S------------E--[]----------------<>----<>--[]-----------E----<>----<>--[]-----------E----<>----[]--[]----QQ-----E----<>-----E--[]-----------------E----<>--[]----------------<>----<>--[]-----------E----<>----<>--[]-----------E----<>----<>--[]----------------<>----<>--[]----------------<>-----E--<>----------------<>----<>--[]----------------<>----<>--[]--------------------S-<>--[]----------------<>-----E--<>--------------S-----S--E--[]-----------------E--------<>-----------------E----<>--[]----------------<>----<>--[]-----------------E----<>----E-S-------------<>---
-<>--[]----------------<>-----E<>[]----------------[]----<>--[]----------------<>----[]--[]----------------[]----<>--<>----------------[]----[]--[]----------------[]----<>--[]----------------<>----<>--------------------E-----[]--[]----------<>----[]----<>--[]----------------[]----<>--[]----------------[]----<>--[]----------------<>----[]--[]----------------[]----<>--[]----------------<>----<>--[]----------------[]----<>--[]----------------<>----[]-------------E------[]--------XX----------------[]----[]--[]----------------[]----<>--------------------[]----<>--[]--------------------------[]----------------XX--------[]-----------------E----[]--[]----------------<>----[]--[]----------------<>----<>--[]----------------<>----<>--[]----------------<>----<>--[]----------------<>----<>--[]---------E------[]----<>--[]-----------------E----<>--[]----------------[]----[]--[]----------<>----[]----[]--[]----------<>----[]----[]--[]----------E-----[]----<>--[]----------------<>----[]--[]----------------[]----[]--[]----------<>----[]----[]--[]----------------[]----[]--[]----------------[]----[]--[]----------------[]----<>--[]----------------[]----[]--[]----------------[]----[]--[]----------------------[]--[]----------------[]----<>--[]----------------------<>--[]----------------<>--------[]----------------<>----[]--[]----------------[]----[]--[]----------------------[]--------------------[]---
-[]--[]----------------[]----<>[][]----------------[]----[]--[]----------------[]----[]--[]----------------[]----[]--[]----------------[]----[]--[]----------------[]----[]--[]----------------[]----[]-------------------<>-----[]--[]----------[]----[]----[]--[]----------------[]----[]--[]----------------[]----[]--[]----------------[]----[]--[]----------------[]----[]--[]----------------[]----[]--[]----------------[]----[]--[]----------------[]----[]------------<>------[]--------XX----------------[]----[]--[]----------------[]----[]--------------------[]----[]--[]--------------------------[]---------------XXX--------[]----------------<>----[]--[]----------------[]----[]--[]----------------[]----[]--[]----------------[]----[]--[]----------------[]----[]--[]----------------[]----[]--[]--------<>------[]----[]--[]----------------<>----[]--[]----------------[]----[]--[]----------[]----[]----[]--[]----------[]----[]----[]--[]-----------?----[]----[]--[]----------------[]----[]--[]----------------[]----[]--[]----------[]----[]----[]--[]----------------[]----[]--[]----------------[]----[]--[]----------------[]----[]--[]----------------[]----[]--[]----------------[]----[]--[]----------------------[]--[]----------------[]----[]--[]----------------------[]--[]----------------[]--------[]----------------[]----[]--[]----------------[]----[]--[]----------------------[]--------------------[]---
-[]--[]----E-EE-EE-E---[]----[][][]------EE-EE-E---[]----[]--[]----E-----E-E---[]----[]--[]----E-EE--E-E---[]----[]--[]----E-EE-EE-E---[]----[]--[]---EE-E---E-E---[]----[]-E[]----E-----E-E---[]----[]-----------E-EE-E--[]-----[]--[]---EE-E---[]-E--[]----[]--[]---EE-E---E-EE--[]----[]--[]------EE-EE-E---[]----[]-E[]---EE-E---E-EE--[]----[]--[]---EE-E---E-EE--[]----[]--[]----E--E-EE-EE--[]----[]--[]----E-EE-EE-E---[]----[]-E[]---EE-E---E-EE--[]----[]--------E---[]--EE--[]--------XX----E-----E-EE--[]----[]--[]----E--E-EE-E---[]----[]--------E--E-EE-E---[]----[]--[]----E-E--EE-EE--------E---[]----E----EE-E--XXX--------[]----E-E--EE-E---[]----[]-E[]----E-E--EE-E---[]----[]-E[]----E-E---E-EE--[]----[]--[]---EE-E---E-E---[]----[]-E[]----E-E--EE-E---[]----[]--[]----E-EE-EE-EE--[]----[]--[]------E-[]--EE--[]----[]--[]----E-E---E-E---[]----[]--[]---EE-E---E-E---[]----[]--[]---EE-E---[]-E--[]----[]--[]----E-E---[]E---[]----[]--[]----E-EE-EE-E---[]----[]-E[]----E-E--EE-EE--[]----[]--[]----E-EE-EE-E---[]----[]--[]---EE-E---[]E---[]----[]-E[]----E-E---E-E---[]----[]--[]----E-EE--E-E---[]----[]-E[]----E-E--EE-E---[]----[]--[]---EE-E---E-E---[]----[]--[]---EE-E---E-E---[]----[]-E[]----E-EE-EE-E---------[]-E[]---EE-E---E-E---[]----[]--[]----E--E-EE-EE--------[]--[]---EE-E---E-EE--[]--------[]---EE-E---E-EE--[]----[]-E[]----E-E---E-E---[]----[]-E[]----E-----E-EE--------[]--------E--E--E-E---[]---
XXXXXXXXXXXXXXXXXXXXXXXXXXXX-XXXXXXXXXXXXXXXXXXXXXXXXXXX-XXXXXXXXXXXXXXXXXXXXXXXXXXXXXXXXXXXXXXXXXXXXXXXXXXXXXXX-XXXXXXXXXXXXXXXXXXXXXXXXXXX-XXXXXXXXXXXXXXXXXXXXXXXXXXX-XXXXXXXXXXXXXXXXXXXXXXXXXXXXXXXXXXXXXXXXXXXXXXXXXXXXXXX-XXXXXXXXXXXXXXXXXXXXXXXXXXXXXXXXXXXXXXXXXXXXXXXXXXXXXXXXXXXXXXXXXXXXXXXXXXXXXXXXXXX-XXXXXXXXXXXXXXXXXXXXXXXXXXXXXXXXXXXXXXXXXXXXXXXXXXXXXXXXXXXXXXXXXXXXXXXXXXXXXXXXXXX-XXXXXXXXXXXXXXXXXXXXXXXXXXXXXXXXXXXXXXXXXXXXXXXXXXXXXXX-XXXXXXXXXXXXXXXXXXXXXXXXXXXXXXXXXX--XXXXXXXXXXXXXXXXXXX-XXXXXXXXXXXXXXXXXXXXXXXXXXX-XX--XXXXXXXXXXXXXXXXXXXXXXXXXXXXXXXXXXXXXXXXXXXXXXXXXXXXXXX-XXXXXXXXXXXXXXXXXXXXXXXXXXXXXXXXXXXXXXXXXXXXXXXXXXX-XXXXXXXXXXXXXXXXXXXXXXXXXXX-XXXXXXXXXXXXXXXXXXXXXXXXXXXXXXXXXXXXXXXXXXXXXXXXXXXXXXX-XXXXXXXXXXXXXXXXXXXXXXXXXXX-XXXXXXXXXXXXXXXXXXXXXXXXXXXXXXXXXXXXXXXXXXXXXXXXXXXXXXXXXXX-XXXXXXXXXXXXXXXXXXXXXXX-XXXXXXXXXXXXXXXXXXXXXXXXXXX-XXXXXXXXXXXXXXXXXXXXXXXXXXXXXXXXXXXXXXXXXXXXXXXXXXXXXXX-XXXXXXXXXXXXXXXXXXXXXXXXXXX-XXXXXXXXXXXXXXXXXXXXXXXXXXXXXXXXXXXXXXXXXXXXXXXXXXXXXXX-XXXXXXXXXXXXXXXXXXXXXXXXXXX-XXXXXXXXXXXXXXXXXXXXXXXXXXX-XXXXXXXXXXXXXXXXXXXXXXXXXXX-XXXXXXXXXXXXXXXXXXXXXXXXXXX-XX--XXXXXXXXXXXXXXXXXXXXXXXXXXXXXXXXXXXXXXXXXXXXXXXXXXX-XXXXXXXXXXXXXXXXXXXXXXXXXXX-XXXXXXXXXXXXXXXXXXXXXXXXXXXXXXXXXXXXXXXXXXXXXXXXXXXXXXXXXXXXXXXXXXXXXXXXXXXXXXXXXXXXXXXXXXXXXXXXXXXXXXXXXXXXXXX-XXXXXXXXXXXXXXXXXXXXXXXXXXXXXXXXXXXXXXXXXXXXXXXXXXXXXXX-XXXXXXXXXXXXXXXXXXXXXXXXXXX
