--------------------------------------------------------------------------------------------------------------------------------------------------------------------------------------------------------------------------------------------------------------------------------------------------------------------------------------------------------------------------------------------------------------------------------------------------------------------------------------------------------------------------------------------------------------------------------------------------------------------------------------------------------------------------------------------------------------------------------------------------------------------------------------------------------------------------------------------------------------------------------------------------------------------------------------------------------------------------------------------------------------------------------------------------------------------------------------------------------------------------------------------------------------------------------------------------------------------------------------------------------------------------------------------------------------------------------------------------------------------------------------------------------------------------------------------------------
-----------------------------------------------------------------------------------Q---------------------------Q----------------------------------------------------------------------------------------------------------------------------------------------------------------------------------------------------------------------------------------------------------------------------------------------------------------------------------------------------------------------------------------------------------------------------------------------------------------------------------------------------------------------------------------------------------------------------------------------------------------------------------------------------------------------------------------------------------------------------------------------------------------------------------------------------------------------------------------------------------------------------------------------------------------------------------------------------------------------------------------------------------------------------------------------------------------------------------------------------------------------------------------------------------------------------------------------------------------------------------------------------------------------------------------------------------------------------------------
--------------------------------------------------------------------------------------------------------------------------------------------------o--------------------------------------------------------------------------------------------------------------------------------------------------------------------------------------------------oo---------------------------------------------------------------------------------------------------------------------------------------------------------------------------------------------------------------------------------------------------------------------------------------------------------------------------------------------------------------------------------------------------------------------------------------------------------------------------------------------------------------------------------------------------------------------------------------------------------------------------------------------------------------------------------------------------------------------------o------------------------------------------------------------------------------------------------------------------------------------------------------------------------------------------------------------------------------oo--------------------------oo---------------------------------------------------------------------------------------------------------
------------------------------------------------------------------------------------------------------------------------------------------------------------------------------XX----------------------------------------------------------------------------------XX--------------------------------------------------------------------------------XXXX-----------------------------------------------------------------------X----------------------------------------------------------------------------------------------------------------------------o--------------------------------------------------------------------------------------------------------------------------------------------------------------------------------------------------------------------------------------------------------------------------------------------------------------------------------------------------------------------------------------------------------------------------------------------------------------------------------------------------------------------XXX----------------------------------------------------------------------------------------------------------------------------------------------------------------------------------------------------------------------------XXXX-------------------------XXX--------------------------------------------------------------------------------------------------------
----------------------------------------------------------------------------------------------------------------------------------------------------------------------------------------------------------------------------------------------------------------------------------------------------------E----------------------------------------------------------------------------------------------------------------------------------------------------------------------------------------------------------------------------------------------------------------------------------------------------------------------------------E----------------------------------------------------------------------------------------------------------------------------------------------------------------------------------------------------------------------------------------------------------------------------------------------------------------------------------------------------------------------------------------------------------------------------------------------------------------------------------------------------------------------------------------------------------------------------------------------------------------------------------------------------------------------------------------------------------------------------------------------------------------------------------------------------------
-------?-Q-Q----S-------------------------------------XX---------?--E------------SQQ---------QQ?Q------------------------?--E----------SSSS---------------SSS-------SSS------------Q------------QQQ----------QQ?QSSS---------------------?-?ESSS-------------------Q-QQQ-----------SSSQQ------------------E----------------------------------------------?------------SSSSSS--------------------------SQ-----------------------------------------------------------------?Q?Q-----------------------------------------------------------------SSSSSS----------S----------------------------------------------------------------------SSS-----E--E-----------------------SSQS---------------------------------------------SSS---------------------SSS-------------Q-Q----------SSSSSS-----------------------------------------------------SSS-------------------------SSS-----------------------S-S-----------Q-Q-------------SS-o--------QQQ------------SSSS-------------------------SQQ-------?QQQQQ------------------------Q-?Q------------------------Q--E------------------------Q--E--------SSSSSSS------------E------------------------QQ-------------SSQQ--------SSS------------------------------------------SSS--------------QSS--------------------QQ--------------SQ-----------------S-----------------------------------SSSS---------------------SSSSSSS-----------Q--QSS--------------------?--E-------------S-------------------------SSSS
--------Q-------------------------------------------------------------X---------------------------XX-----------------------QX-XXX------------------------------------------------------------------------------------------------------------XXX-----------------------------------------------------------XXX-------------------------------------------------------------------------------------------------------------------------------------------------------------QXXXX---------------------------------------------------------------------------------------------------------------------------------------------------------------XX-X--------------------------------------------------------------------------------------------------------------------------------------------------------------------------------------------------------------------------------------------------------------------------------------------------------------------------------------------------------------------------------X-----------X-------------------------------------------------------------------XXXXXX-------------------------------------------------------------------------------------------------------------------------------------------------------------------------------------------------------------------------------------------------------------------------------------X-----------------------------------------
---XXX----------------------------------------------------E---------------------------------------Q--------------------------------------------------------------------------------------------------------------------------------------------------------------------------------------------------------XXX----------------------------------------------------------------------------------------------------------------------------------------------------------------Q-----X-------------------------------------------------------------------------------------------------------------------------------------------------------------------------------------------------------------------------------------------------------------------------------------------------------------------------------------------------------------------------------------------------------------------------------------------------------------------------------------------------------------------------------------------------------------------------------------------------------------------------------------------------E-----------------------------------------------------------------------------------------------------------------------------------------------------------------------------------------------------------------------------------------------------------------------------------------------------------------
---XX----------------E-----------------------------------<>---------------E---------------E-----------E---------------------------E------------------------------E--------E------------------E--------E------------------E------------E---------------------------------------E----------------------------XXX------------------------E-----------E---------------E---------------------------------E--------o------------E-----------E------------------E-------------------------------------------------------E------------------------E-------------------------------------------------------------------------E---------------E------------------------E--------------------------------------E-------------E---------------E---------------------------------------E------------------------------E--------E---------------E--S--------E---------------E-----------E------------------E---------------------------E--?----------------------------------------------------E--------E-E----------------E------------------------------------E---------------E-----------E---------------E-------------E---------------------E--<>------------------E----------------------------------------o-----------E---------------E-----------------E------------------------E---------------------------E------------------------E-----------E---------------E---------------E--------------E--------E---------------E--E----------E-------------E-----E---
-XXXX--QS-QQQQ------<>---QQQ-----------------------E-----[]----E?SQ------<>-----E--------<>--QQQQ-Q--<>-------Q?--E---E--SQQQ----<>-----E--?--E----Q--Q---------<>-------<>----E--Q---------<>---QQQ-<>----E?SQQQ-------<>---QQQ--E--<>----------Q-Q---------------Q-QQ------<>-<>---E?S-----------XX-XX-XXXXX-----------------------<>----------<>----E---------<>-----E--------------------<>----<>--------------------<>-----E----<>----E--QQQ----Q--<>---QQQ----E<>--SQQQQ---Q--------------E---?QQQ--------<>-----------------------<>-----E--S-----------------------------<>-----------------<>-------------<>--------------<>----XX-----------------<>---QQQ---E-SS-------------Q---QQQQ--E<>------------<>-----E--------<>---QQQQ--Q---------E---E------QQ---Q--<>-----E--S---Q----------------<>---QQQ-<>--------------<>-----E----<>--------------<>-----E----<>---E--QQ---------<>----------E<>---QQQ-------<>---QQQ---------QQ-Q---------<>------E<>---?Q----------<>-------<><>--E?SQQQ-------<>----QQ--E---E--SQQQ----Q--<>---QQQ-<>----E?QQQQ----<>-------Q?-<>----E?QQ------<>------E??--E<>----Q--Q------------<>--[]----E-SQ---------<>---QQQ-----------------<>--------------------------<>----<>-----E--<>---QQQQ---------<>----------Q-QQ-Q-Q-----<>--------------QQQ---------<>-------------Q---------<>----------<>--------------<>------S?S-----<>---QQQQ------<>---QQQ-<>----E?S-------<>-<>--------E<>----Q-------<>----<>---
XXXXX---S-----------[]--------E------E-E----------<>-----[]--------------[]----<>-----E--[]----------[]----------<>--<>----------[]----<>----<>-----------------[]-------[]-----------------[]-------[]-----------------[]-------<>--[]--------------------------------------[]-[]----------------XXX-XXXXXXXX-----------------------[]----------[]--------------[]----<>--------------------[]----[]--------------------[]----<>----[]-----------------[]--------E<>[]-----------------------E<>---------------[]-----------------------[]----<>-----E------XX------------------[]------------E----[]----E---E----[]--------------[]----XXX-XXX-?----------[]-----------------------------------<>[]------------[]----<>--------[]----------------------<>--------------[]----<>-----------------------[]-------[]--------------[]----<>----[]--------------[]----<>----[]--<>-------------[]--------E<>[]-------------[]--------E<>-----------------[]-----<>[]---------------[]-------[][]---------------[]-------<>--<>-------------[]-------[]--------------[]----------[]--------------[]----------<>[]--------------------[]--[]-----------------[]-----------------------[]--------------------------[]----[]----<>--[]----------------[]-----------------------[]--------------------------[]-----------------------[]----------[]--------------[]--------------[]-------------[]-------[]--------------[]-[]-------<>[]------------[]----[]---
XXXXX---SS----------[]-------<>-----<><>----------[]-----[]--------------[]-<>-[]----<>--[]----------[]----------[]--[]----------[]----[]----[]-----------------[]-------[]-----------------[]-------[]-----------------[]-------[]--[]--------------------------------------[]-[]---------------XXXX--XXXXXXX-----------------------[]----------[]--------------[]----[]--------------------[]----[]--------------------[]----[]----[]-----------------[]-------<>[][]-------------<>-------<>[]---------------[]-----------------------[]----[]----<>-----XXXX-----------------[]-----------<>----[]<>-<>--<>----[]--------------[]---XXoX----------------[]-----------------------S-----------[][]------------[]----[]--------[]-------------------X--[]--<>----------[]----[]-----------------------[]-------[]--------------[]----[]----[]--------------[]----[]----[]--[]-------------[]-------<>[][]-------------[]-------<>[]-----------------[]-----[][]---------------[]-------[][]---------------[]-------[]--[]-------------[]-------[]--------------[]----------[]--------------[]----------[][]--------------------[]--[]-----------------[]-----------------------[]--------------------------[]----[]----[]--[]----------------[]-----------------------[]--------------------------[]-----------------------[]----------[]--------------[]----------<>--[]-------------[]-------[]--------------[]-<>-------[][]------------[]----[]---
XXXXX---------EE----[]-EE-E--[]---E-[][]----------[]-----[]-----------E--[]-[]-[]----[]--[]------EE--[]----------[]--[]------EE--[]----[]----[]-------EE---E----[]-------[]--------EE-E-----[]-------[]-----------E-----[]-E-EE--[]--[]---------E----E------------------E-E--[]-[]--------------XXXXX--XXXXXXX---------------------E-[]----------[]-------EE--E--[]-E--[]--------EE-----E-E--[]----[]---------------E-E--[]----[]----[]----------EE-E---[]-------[][][]-E-------E---[]-------[][]--------EE-E---[]---------------EEE--E--[]----XX----[]----XXXXX----EE-----------[]------E----[]----[][]-[]--[]----[]--E-E-----EE--[]----XXX----------EE----[]--E-E----EE-E-EE----E----------EE--[][]-EE------E--[]----[]----E---[]------E--E----E----X--[]--[]-------E--[]----[]-----------------EE----[]-------[]------EEE-----[]----[]----[]--------E-EE--[]----[]----[]--[]-------E-----[]-------[][][]-------EE----[]-------[][]---------E--E----[]-----[][]-E-----E-E-EE--[]-------[][]---------E-EE--[]-E--E--[]--[]-------E-EE--[]----E--[]----------EE--[]----------[]--------E-EE--[]----------[][]--------EE-E---EE---[]--[]--------E--E-----[]-----------E--EE-E--E--[]---------------E-----E-E--[]----[]----[]-E[]------E--E--E-E-[]--------------EE-EE----[]------------------E-EE----[]-EE-E------------E--E--[]----------[]-----------E--[]-E--------[]--[]-------EE-E--[]--E-E--[]-----------E--[]-[]-E-----[][]---------E--[]----[]---
XXXXX--XXXXXXXXXXXXXXXXXXXXXXXXXXXXXXXXXXXXXXXXXXXXXXXXX-XXXXXXXXXXXXXXXXXXXXXXXXXXX-XXXXXXXXXXXXXXXXXXXXXXXXXXXXXXXXXXXXXXXXXXXXXXXXXXXXXXX-XXX-XXXXXXXXXXXXXXXXXXXXXXX-XXXXXXXXXXXXXXXXXXXXXXXXXXX-XXXXXXXXXXXXXXXXXXXXXXXXXXXXXXXXXXXXXXXXXXXXXXXXXXXXXXXXXXXXXXXXXXXXXXXXXXXXXXXXXXXXXXXXXXXXXXXX-XXXXXXXXXXXXXXXXXXXX--XXXXXXXXXXXXXXXXXXXX-XXXXXXXXXXXXXXXXXXXXXXXXXXXXXXXXXXXXXXXXXXXXXXXXXXXXXXXXXXXX--XXXXXXXXXXXXXXXXXXXXX-XXXXXXXXXXXXXXXXXXXXXXXXXXX-XXXXXXXXXXXXXXXXXXXXXXXXXXX-XXXXXXXXXXXXXXXXXXXXXXXXXXXXXXXXXXXXXXXXXXXXXXXXXXXXXXX-XXXXXXXXX---XXXXXXXXX-X-XXXXXXXXXXXXXXXXXXXXXXXXXXXXXXXXXXXXXXXXXXXXXXXXXXXXXXXXXXXXXXX-X----XXXXXXXXXXXXXXXXXXXXXXXXXXXXXXXXXXXXXXXXXXXXXX-XXXXXXXXXXXXXXXXXXXXXXXXXXXXXXXXXXXXXXXXXXXXXXXXXXXXXXX-XXXXXXXXXXXXXXXXXXXXXXXXXXXXXXX----XXXXXXXXXXXXXXXXXXXX-XXXXXXXXXXXXXXXXXXXXXXXXXXX-XXXXXXXXXXXXXXXXXXXXXXXXXXX-XXXXXXXXXXXXXXXXXXXXXXXXXXX-XXXXXXXXXXXXXXXXXXXXXXXXXXXXXXXXXXXXXXXXXXXXXXXXXXXXXXXXXXXXXXXXXXXXXXXXXXXXXXXXXXX-XXXXXXXXXXXXXXXXXXXXXXXXXXXXXXXXXXXXXXXXXXXXXXXXXXXXXXX-XXXXXXXXXXXXXXXXXXXXXXXXXXX-XXXXXXXXXXXXXXXXXXXXXXXXXXX-XXXXXXXXXXXXXXXXXXXXXXXXXXX-XXXXXXXXXXXXXXXXXXXXXXXXXXXXXXXXXXXXXXXXXXXXXXXXXXXXXXXXXXXXXXXXXXXXXXXXXXXXXXXXXXX-XXXXXXXXXXXXXXXXXXXXXXXXXXXXXXXXXXXXXXXXXXXXXXXXXXXXXXXXXXXXX-XXXXXXXXXXXXXXXXXXXXXXXX---XXXXXXXXXXXXXXXXXXXXXX-XXXXXXXXXXXXXXXXXXXXXXXXXXX-XXXXXXXXXXXXXXXXXXXXXXXXXXX-XXXXXXXXXXXXXXXXXXXXXXXXXXX-XXXXXXXXXXXXXXXXXXXXXXXXXXX
