--------------------------------------------------------------------------------------------------------------------------------------------------------------------------------------------------------------------------------------------------------------------------------------------------------------------------------------------------------------------------------------------------------------------------------------------------------------------------------------------------------------------------------------------------------------------------------------------------------------------------------------------------------------------------------------------------------------------------------------------------------------------------------------------------------------------------------------------------------------------------------------------------------------------------------------------------------------------------------------------------------------------------------------------------------------------------------------------------------------------------------------------------------------------------------------------------------------------------------------------------------------------------------------------------------------------------------------------------------------------------------------------------------------------------------------------------------
-----------------------------------------------------------------------------------------------------------------------------------------------------------------------------------------------------------------------------------------------------------------------------------------------------------------------------------------------Q---------------------------------------------------------------------------------------------------------------------------------------------------------------------------------------------------------------------------------------------------------------------------------------Q-------------------------------------------------------------------------------------------------------------------------------------------Q---------------------------Q---------------------------------------------------------------------------------------------------------------------------------------------------------------------------------------------------------------------------------------------------------Q------------------------------------------------------------------------------------------------------------------------------------------------------------------------------------------------------------------------------------------------------------------------------------------------------------------------------------------------------------------------------
SSSSSSSSSSSSSSSSSSSS-------------------------------------------------------------------------------------------------------------------------------------------------------------------------------------------------------------------------------------------------------------------------------------------------------------------------------------------------------------------------------------------------------------------------------------------------------------------------------------------------------------------------------------------------S---S------------------------------------------------------------------------------------------------------------------------------------------------------------------------------------------------------------------------------------------------------------------------------------------------------------------------------------------------------------------------------------------------------------------------------------------------------------------------------------------------------------------------------------------------------------------------------------------------------------------------------------------------------------------------------------------------------------------------------------------------------------------------------------------------------------------------------------------------------------------------------
-------------------------------------------------------------------------------------------------------------------------------------------------------------------------------------------------------------------------------------------------------------------------------------------------------------------E--------------------------------------------------------------------------------------------------------------------------------------------------XX-------------------------------------------------------------------------------------------------------------------------------------------------------------------------------------------------------------------------------------------------------------------------------E-----------------------------------------------------------------------------------------------------------------------------------------------------------------------------------------------------------------------------------------------------------------------------------------------------------------------------------------------------------------------------------------------------------------------------------------------------------------------------------------------------------------------------------------------------------------------------------------------------------------------------------------------------------------------------------------------E
---------------------------------------------------------------------------------------------------------------------------------------------------------------------------------------------------------------------------------------------------------------------------------------------------------------------------------------------------------------------------------------------------------------------------------------------------------------------------------------------------------------------------------------E----------------------------------------------------------------------------------------------------------------------------------------------------------------------------------------------------------------------------------------------------------------------------------------------------------------------------------------------------------------------------------------------------------------------------------------------------------------------------------------------------------------------------------------------------------------------------------------------------------------------------------------------------------------------------------------------------------------------------------------------------------------------------------------------------------------------------------------------------------------------------------------------------------------
-------------------------SSS--------------------------SS---------------------------------------------------------------------------------SSS---------?---------------SSS----SSS-----SSSSSS-------------------Q-Q----------------------------E----------SSSSS--------------SSSS----Q------------?-Q-Q------------SSS-o------?-Q--E-----------SSSS-----------------------------------?-QQQ-----------------------------------------SSS---------?---------------------------QQQQQ---------QQQQ----------?-----------SSSSSSS---------Q----SQS----SQSSSS---------------SSS--------------------?--E----------------------?-QQ--------------SSS-------------------------------------?-?Q--------SSSSSS----------Q-Q-------------SQQ---------QQQ---------SQSSSQ----------?Q?E------------------------?--E------------------------Q--QQQS------QSSSS----------Q-Q------------SSS-o--------Q-QQ----------SSSSS---------QQQ-------------------------QQQQ------------------------QQ?QS-S---------SQ----------Q---------------SSS---------QQQE------------------------Q-?QSSS-------SSSSS---------?--E------------SSS-------------QQ-------QSQQQQ---------?-?E-----------SSSS---------?SSS-----------SSS----------?--E---------SSSSSS---------QQQE------------SS----------?-QQ------------------------?-QE-----------SSSS---------QQQQ------------SQQ---------?-?ES---------SSSSS--------------------------QQ---------??------------SSSSS------------------------SSS-
---------------------------------------------------------------------------------------------------------------------------------------------------------------------------------------------------------------------------------------------------------------------------------------------------------------------------------------------------------------------------------------------------------------------------------------------------------------------------------------------------------------------------------------------------------------------------------------------------------------------------------------------------------------------------------XXX---------------------------------------------------------------------------------XXX-----------------------XX-XXX----------------------------------------------------------------------------------------------------------------------------------------------------------------------X----------------------------------------------------------------------------------XX-------------------------------------------------------------------------------XXXXXX---------------------------------------------------------------------------------XX--------------------------XX--------------------------X-------------------------------------------------------XX------------------------------------------------------------------------------------------------
----------------------------------------------------------------------------------------------------------------------------------------------------------------------------------------------------------------------------------------------------------------------------------------------------------------------------------------------------------------------------------------------------------------------------------------------------------------------------------------------------------------------------------------------------------------------------------------------------------------------------------------------------------------------------------Q------------------------------------------<>---------------------------------------Q---------------------------------------------------------------------------------------------------------------------------------------------------------------------------------------------------------------------------------------------------------------------------------------Q-----------------------------------------------------------------------------------Q-----------------------------------------------------------------------------------------------------------------------------------------------------------------------------------------------------------------------------------------------------------------------------------------------------
------------------E--------S------------------------E--o-------------------------------------------------E----------E-------------E-----E--o------------------E--S-------------------------------------------------------E------------------------------E--------------------------------<>-----------------------------E-----------------------------------------E-----------E---E---------------------------------------------E--o--E-----------------------------------------------------------------------E---------------E--------------E---------------------------E------------------------------------E---------------E-------------E-------------E-----------E---E-----------E------------------------------E-------[]---------------E-----------E---------------E---------------------------E--S------------E--------------E----------E----------------E------------E------------------------------------------E--------E------------------E------------E--------------E----------E----------------E--------E------------------E--------E---E--------------E--------E---------------E-----E-----E------------------E------------E-----------------E-----E------------------E--?-----E---------------E------------------------------E------------E--------------E----------E-------------E--E--------E---------------E--E--------E---------------E-----------E------------------E------------------------E--S---------------------------E------
-QQ--------------<>-----E---------------------E----<>------------------------E---E-----------E-E--------<>--------E<>------------<>----<>------------Q-------<>-----E--------------QQQQ--Q--QQQ----Q--E----Q--QQQ-------<>---QQQ--E-E----Q--------E----<>-------------Q-Q-QQQ---Q------Q-[]----E?-QQQ----Q-------------<>---?S--------------------E-------QQQ----<>--------?-<>--<>---QQQQ------<>---QQQ--E-----QQ--------E----<>----<>------S-------<>----------------Q-QQ-Q----<>------QQQ--E-E<>--QQ------<>------E?S--E--<>---Q-QQQ-----<>---QQQ-Q-----Q--Q-Q-------<>--------E---E--SQQQ----------------<>----E?SQ------<>-----------E<>---QQ-------<>-----E----<>--<>---QQQQ---<>-------E?-<>----E?QQ---------<>----E?-[]----E--Q------<>------QQ?-<>-----?SQ------<>---------------E--SQQQ----<>-----E-----E--<>---QQQQQ-----<>---QQQ--E<>--E--QQQ-------<>----QQ--E--<>---QQQQ----------------E---E---QQQ-------<>---QQQ-<>----E?SQQQ-------<>---QQQ--E--<>---QQQ-------<>----QQ--E<>---?SQQQ-------<>-------<>----E?SQQQ-------<>---QQQ-<>--<>---QQQ-------<>-------<>-----?S-------<>----<>----<>----E--Q---------<>---QQQ--E--<>--SQQQ----------<>----<>-----?S----------<>-------<>----E-QQ------<>-----E-----E-E--E?SQQQ-------<>--------E--<>---QQQQ------<>---QQQ--E<>----SQQQ----<>-<>-------<>----E?QQ-Q----<>-<>---QQ?-<>------S-------<>-----E--S-<>-----QQ----------<>---QQQ--------------Q--<>-----E-----E------QQQ--------<>---QQQ
-----------------[]----<>--------------------------[]------------------E----<>--<>----------<><>---E----[]-E-----<>[]------------[]----[]--------------------[]----<>--------XX----------------------<>-----------------[]-------<><>------------<>----[]--------<>----------------------[]----------------------------[]------------------E-----<>--<>----------[]----------[]--[]-------------[]-------<>--------------<>----[]----[]--------------[]--------------------------[]----------<><>[]----------[]----------<>--[]-------------[]--------------------------[]-------<>--<>-----------------E----[]--------------[]-----E----<>[]------------[]----<>----[]--[]----------[]----------[]-----------------[]--E----[]--------------[]--E-------[]--------------[]-----------E--<>----------[]----<>----<>--[]-------------[]-------<>[]---------------[]-------<>--[]-------------<>-------<>--<>-------------[]-------[]-----------------[]-------<>--[]-------------[]-------<>[]---------------[]-------[]-----------------[]-------[]--[]-------------[]-------[]--------------[]----[]----[]-----------------[]-------<>--[]----------------[]----[]-----------------[]-------[]--------------[]----<>----<><>---------------[]-------<>--[]-------------[]-------<>[]------------[]-[]-------[]--------------[]-[]-------[]--------------[]----<>----[]-----------------[]-----------------------[]----<>----<>-----------------[]------
-----------------[]----[]--------<>----------------[]-----------------<>----[]--[]----------[][]--<>----[]<>-----[][]------------[]----[]--------------------[]----[]--------X-----------------------[]-----------------[]-------[][]------------[]----[]--------[]----------------------[]----------------------------[]-----------------<>-----[]-E[]----------[]----------[]--[]-------------[]-------[]--------------[]----[]----[]--------------[]-<>-----------------------[]----------[][][]----------[]----------[]--[]-------------[]--------------------------[]-------[]--[]----------------<>----[]--------------[]-<>-<>----[][]------------[]-<>-[]----[]--[]----------[]----------[]-----------------[]-------[]--------------[]-<>-------[]--------------[]----------<>--[]----------[]----[]----[]--[]-------------[]-------[][]---------------[]-------[]--[]-------------[]-------[]--[]-------------[]-------[]-----------------[]-------[]--[]-------------[]-------[][]---------------[]-------[]-----------------[]-------[]--[]-------------[]-------[]--------------[]----[]----[]-----------------[]-------[]--[]----------------[]----[]-----------------[]-------[]--------------[]----[]----[][]---------------[]-------[]--[]-------------[]-------[][]------------>--[]-------[]--------------[]-[]-------[]--------------[]----[]----[]-----------------[]-----------------------[]----[]----[]<>---------------[]------
----------EE-E---[]----[]--------[]----E-EE-EE-E---[]---------E-E---E-[]----[]--[]----EE----[][]--[]----[][]-----[][]---------E--[]-E--[]-----------E-----E--[]----[]-------------------EE------E-E--[]-----------E-----[]-E--E--[][]--------EE-E[]-E--[]----E---[]-------EE-----E-EE-E--[]--------E--E-EE-------------[]--EE-----E-EE-E--[]-----[][][]------EE--[]----------[]--[]----E-EE-----[]-------[]-----------E-EXXE---[]----[]--------E--E--[]-[]-----------------E--E--[]----------[][][]------EE--[]---E---X--[]--[]----E--EE----[]-----------------EE-EE----[]-E-----[]--[]-------E-EE-E---[]----[]-----E-----E--[]-[]-[]----[][]--------E---[]-[]-[]----[]--[]----E-E---[]----------[]-E---------E-----[]-------[]--------E--E--[]-[]-------[]-X--------EE--[]----------[]--[]------EE-E[]----[]----[]-E[]------EE--E--[]-------[][]---------E-----[]-E-----[]-E[]-------E-EE--[]-E-E---[]--[]-------EE-E--[]--E-E--[]-----------E-EE--[]----E--[]--[]-------E-EE--[]-E-EE--[][]---------E--E--[]-------[]---X-------E-----[]-------[]--[]-------E--E--[]-------[]-----------E--[]----[]----[]--------E--EE----[]-------[]-E[]------EE-EE-E---[]----[]-----------E--E--[]---X---[]--------E--E--[]----[]----[][]---------E-E---[]-E-----[]-E[]-------E-EE--[]-E--E--[][]---------E-----[]-------[]-----------E--[]-[]-------[]-----------E--[]----[]----[]-----------E-----[]----------------EE--E--[]----[]----[][]---------EE----[]------
XXXX-X-XXXXXXXXXXXXXXXXXXXXXXXXXXXXXXXXXXXXXXXXXXXXXXXXXXXXXXXXXXXXXXXXXXXXXXX--XX--XXXXXXXXXXXXXXXXXXXXXXXXXXXX-XXXXXXXXXXXXXXXXXXXXXXXXXXXXXXXXXXXXXXXXXXXXXXXXXXXXXXXXXX--X-----XXXXXXXXXXXXXXXXX-XXXXXXXXXXXXXXXXXXXXXXXXXXX-XXXXXXXXXXXXXXXXXXXXXXXXXXXXXXXXXXXXXXXXXXXXXXXXXXXXXXX-XXXXXXXXXXXXXXXXXXXXXXXXXXXXXXXXXXXXXXXXXXXXXXXXXXXXXXXXXXXXXXXXXXXXXXXXXXXXXXXXXXX-XXXXXXXXXXXXXXXXXXXXXXXXXXXXXXXXXXXXXXXXXXXXXXXXXXXXXXX-XXXXXXXXXXXXXXXXXXXXXXXXXXXXXXXXXXXXXXXXXXXXXXXXXXXXXXX-XXXXXXXXXXXXXXXXXXXXXXXXXXXXXXXXXXXXXXXXXXXXXXXXXXXXXXXXXXX-XXXXXXXXXXXXXXXXXXXXXXX-XXXXXXXXXXXXXXXXXXXXXXXXXXX-XXXXXXXXXXXXXXXXXXXXXXXXXXX-XXXXXXXXXXXXXXXXXXXXXXXXXXXXXXXXXXXXXXXXXXXXXXXXXXXXXXXXXXXXXXXXXXXXXXXXXXXXXXXXXXX-XXXXXXXXXXXXXXXXXXXXXXXXXXX-XXXXXXXXXXXXXXXXXXXXXXXXXXX-XXXXXXXXXXXXXXXXXXXXXXXXXXX-XXXXXXXXXXXXXXXXXXXXXXXXXXX-XXXXXXXXXXXXXXXXXXXXXXXXXXX-XXXXXXXXXXXXXXXXXXXXXXXXXXX-XXXXXXXXXXXXXXXXXXXXXXXXXXX-XXXXXXXXXXXXXXXXXXXXXXXXXXXXXXXXXXXXXXXXXXXXXXXXXXXXXXX-XXXXXXXXXXXXXXXXXXXXXXXXXXX-XXXXXXXXXXXXXXXXXXXXXXXXXXXXXXXXXXXXXXXXXXXXXXXXXXXXXXX-XXXXXXXXXXXXXXXXXXXXXXXXXXX-XXXXXXXXXXXXXXXXXXXXXXXXXXX-XXXXXXXXXXXXXXXXXXXXXXXXXXXXXXXXXXXXXXXXXXXXXXXXXX-XXXX-XXXXXXXXXXXXXXXXXXXXXXXXXXX-XXXXXXXXXXXXXXXXXXXXXXXXXXX-XXXXXXXXXXXXXXXXXXXXXXXXXXX-XXXXXXXXXXXXXXXXXXXXXXXXXXX-XXXXXXXXXXXXXXXXXXXXXXXXXXX-XXXXXXXXXXXXXXXXXXXXXXXXXXX-XXXXXXXXXXXXXXXXXXXXXXXXXXXXXXXXXXXXXXXXXXXXXXXXXXXXXXX-XXXXXXXXXXXXXXXXXXXXXXXXXXX
