--------------------------------------------------------------------------------------------------------------------------------------------------------------------------------------------------------------------------------------------------------------------------------------------------------------------------------------------------------------------------------------------------------------------------------------------------------------------------------------------------------------------------------------------------------------------------------------------------------------------------------------------------------------------------------------------------------------------------------------------------------------------------------------------------------------------------------------------------------------------------------------------------------------------------------------------------------------------------------------------------------------------------------------------------------------------------------------------------------------------------------------------------------------------------------------------------------------------------------------------------------------------------------------------------------------------------------------------------------------------------------------------------------------------------------------------------------
--------------------------------------------------------------------------------------------------------------------------------------------------------------------------------------------------------------------------------------------------------------------------------------------------------------------------------------------------------------------------------------------------------------------------------------------------------------------------------------------------------------------------------------------------------------------------------------------------------------------------------------------------------------------------------------------------------------------------------------------------------------------------------------------------------------------------------------------------------------------------------------------------------------------------------------------------------------------------------------------------------------------------------------------------------------------------------------------------------------------------------------------------------------------------------------------------------------------------------------------------------------------------------------------------------------------------------------------------------------------------------------------------------------------------------------------------------
----oo--------------------------oo------------------------------------------------------oo--------------------------o-----------------------------------------------------------------------------------oo--------------------------oo--------------------------oo------------------------------------------------------oo------------------------------------------------------o---------------------------oo--------------------------o---------------------------oo--------------------------oo--------------------------oo--------------------------oo--------------------------oo--------------------------oo------------------------------------------------------oo--------------------------oo--------------------------oo--------------------------o---------------------------oo--------------------------oo------------------------------------------------------o---------------------------oo------------------------------------------------------oo--------------------------oo------------------------------------------------------oo--------------------------o---------------------------oo--------------------------oo--------------------------oo--------------------------o---------------------------oo--------------------------oo--------------------------oo--------------------------o---------------------------oo--------------------------oo--------------------------oo--------------------------oo----------------------
----XXX------------------------XXXX----------------------------------------------------XXX--------------------------------------------------------------------------------------------------------------XXX-------------------------XXX------------------------XXXX----------------------------------------------------XXXX---------------------------------------------------------------------------------XXX----------------------------------------------------XXXX------------------------XXXX------------------------XXXX-------------------------XXX-------------------------XXX------------------------XXXX----------------------------------------------------XXXX------------------------XXXX-------------------------XXX-------------------------X--------------------------XXXX------------------------XXXX-----------------------------------------------------X---------------------------XXX----------------------------------------------------XXXX-------------------------XXX-----------------------------------------------------XXX-------------------------X--------------------------XXXX-------------------------XX-------------------------XXXX-------------------------XX--------------------------XXX-------------------------XXX-------------------------XXX----------------------------------------------------XXXX-------------------------XXX-------------------------XXX------------------------XXXX---------------------
-----------------?---------------------------E---------------------------?-------------------------------------------------------?---------------------------?---------------------------?---------------------------?---------------------------?---------------------------?---------------------------?---------------------------?---------------------------?---------------------------?---------------------------?---------------------------?---------------------------?---------------------------E---------------------------?---------------------------E---------------------------?---------------------------?---------------------------?---------------------------?---------------------------E---------------------------?---------------------------?---------------------------?---------------------------?---------------------------?---------------------------?---------------------------?------X--------------------?---------------------------?---------------------------?---------------------------?---------------------------?---------------------------?---------------------------?---------------------------??--------------------------?---------------------------E---------------------------?---------------------------?---------------------------?---------------------------?---------------------------?---------------------------?---------------------------?---------------------------E----------
---------ooooo--XXXS----?--------------oo----ESS----SSS-----------Xooo---XXS----?---------------oo---ESS----SSS-----------Xoo---XXXS----S------------ooooo---XX-----?-------------ooo---XXX-----S-------------Xoo---XXXS----SS------------Xooo---XXS----S-------------Xoo---XXXS----SS------------X-o---XXXS----SSS------------oo---XXXS----S-------------Xooo--XXXS----S-------------Xooo--XXXS----SS------------Xoo----XXS----SSS-----------Xoo---XXXS----S-------------ooo---XXXS----S-------------oooo---XSS----SSS------------oo---XXXS----SS------------oooo---XXS----S-------------Xooo--XXXS----S-------------Xoo---XXXS----SS------------oooo--XXXS----?--------------oo---XXXS----SSS----------oooo----XXS----SS------------Xooo--XXXS----S-------------oooo---XXS----SSS-----------Xooo---XXS----S------------oooo----XXS----S-------------Xooo--XXXS----?-------------ooo----XXS----SS------------ooo---XXX-----S-------------Xooo---XXS----?-------------Xoo---XXXS----SS------------oooo---XXS----S-------------Xoo---XXXS----S-------------Xooo---XSS----S-------------Xooo---XXS----S-------------ooo----XXS----SS------------Xoo---XXXS----S-------------Xooo---XXS----SSS----------oooo---XXX-----SS------------oooo---XXS----S------------oooo---XXX-----SS------------Xooo---XXS----S------------ooooo---XXS----S-------------Xooo---XXS----S-------------Xoo---XXXS----SS-----------ooooo---XXS----S-------------Xooo---XXS----SSS-
--------------------o---------------------------o---------------------------o-------------------------------------------------------o---------------------------o---------------------------o-------------------------------------------------------o-------------------------------------------------------------------------------------------------------------------------------------------o---------------------------------------------------------------------------------------------------------------o-------------------------------------------------------o-------------------------------------------------------o---------------------------o-------------------------------------------------------o-------------------------------------------------------o-----------------------------------------------------------------------------------o---------------------------o-------------------------------------------------------o-------------------------------------------------------o---------------------------o-------------------------------------------------------o--------------------------------------------------------------------------------------------------------------oo---------------------------------------------------------------------------------------------------------------o---------------------------o-------------------------------------------------------o-----------------------------------
--------------------------------------------------------------------------------------------------------------------------------------------------------------------------------------------------------------------------------------------------------------------------------------------------------------------------------------------------------------------------------------------------------------------------------------------------------------------------------------------------------------------------------------------------------------------------------------------------------------------------------------------------------------------------------------------------------------------------------------------------------------------------------------------------------------------------------------------------------------------------------------------------------------------------------------------------------------------------------------------------------------------------------------------------------------------------------------------------------------------------------------------------------------------------------------------------------------------------------------------------------------------------------------------------------------------------------------------------------------------------------------------------------------------------------------------------------
----------------------------------------------------------------------------------------------------------------------------Q-------------------------------------------------------Q-------------------------------------------------------------------------------------------------------------------------------------------------------------------------------------------------------------------------------------------------------------------------------------------------------------------------------------------------------------------------------------------------------------------------------------------------------------------------------------------------------------------------------------------------------------------------------------------------------------------------------------------------------------------------------------------------------------------------------------------------------------------------------------------------------------------------------------------------------------------------------------------------------------------------------------------------------------------------------------------------------------------------------------------------------------------------------------------------------------------------------------------------------------------------------------------------------------------------------------------------------------------
-------------XXX----XXX-----XX-----------XXX----XXX--XXX-------------XXX----XXX------------------XXX----XXX--XX--------------XXX---XXXX--XX-X------------XXX---XXXX------------------XXX---XXXX------------------XXX---XXXX--XXXX------------XXX---XXXX--XX--------------XXX---XXXX--XXX-------------XXX---XXXX--XXX-------------XXX---XXXX--XX--------------XXX---XXXX--XXX-------------XXX---XXXX--XX-XX-----------XXX---XXXX--XXX-------------XXX---XXXX--XXX-------------XXX---XXXX--XXXXX-----------XXX---XXXX--XXX-------------XXX---XXXX--XX-X------------XXX---XXXX--XXX-------------XXX---XXXX--XX--------------XXX---XXXX-----X------------XXX----XXX------------------XXX---XXXX--XXXXX-----------XXX---XXXX--XXX-------------XXX---XXXX--XX--------------XXX---XXXX--XXX-------------XXX---XXXX--XXXXX-----------XXX---XXXX--XXX-------------XXX---XXXX------------------XXX---XXXX--XXXXX----------XXXX---XXXX--XXX-------------XXX----XXX------------------XXX---XXXX--XXXXX-----------XXX---XXXX--X---------------XXX---XXXX--XX--------------XXX----XXX--XX--------------XXX----XXX--X--X------------XXX---XXXX--XXX-------------XXX---XXXX------------------XXX---XXXX--XXX-------------XXX----XXX------------------XXX---XXXX--XX-X------------XXX---XXXX--XXX-------------XXX---XXXX--XXXX------------XXX----XXX--XXX-------------XXX---XXXX--XX--------------XXX---XXXX--XXXX------------XXX----XXX--XXX-------------XXX----XXX--XXX
--Eo---------------------------o--------------E-----------Eo---------------------------o---------------------------o--------------------------Eo--------------------------Eo--------------------------Eo--------------------------Eo---------------------------o---------------------------o--------------------------Eo--------------------------Eo--------------------------Eo---------------------------o---------------------------o--------------------------Eo---------------------------o---------------------------o---------------------------o--------------------------Eo--------------------------Eo--------------E-----------Eo---------------------------o--------------------------Eo---------------------------o--------------------------Eo--------------------------Eo--------------------------Eo--------------------------Eo--------------------------Eo---------------------------o--------------------------Eo---------------------------o--------------------------Eo---------------------------o---------------------------o--------------------------Eo---------------------------o--------------------------Eo--------------------------Eo--------------------------Eo--------------E-----------Eo--------------------------Eo---------------------------o--------------------------Eo--------------------------Eo---------------------------o--------------------------Eo---------------------------o------------------------
--XXXXX----------<>-----------XXXXXX---------<>-----------XXXXXX----------------------XXXXXX----------------------XXXXX-----------------------XXXXX-----------------------XXXXX-----------------------XXXXXX---------->-----------XXXXXX----------------------XXXXXX----------------------XXXXX-----------------------XXXXX-----------------------XXXXX-----------------------XXXXXX----------------------XXXXXX----------------------XXXXXX----------------------XXXXXX----------------------XXXXXX----------------------XXXXXX----------------------XXXXXX----------------------XXXXXX----------------------XXXXXX---------<>-----------XXXXXX----------------------XXXXXX----------------------XXXXX-----------------------XXXXX-----------------------XXXXXX----------------------XXXXXX----------------------XXXXXX----------------------XXXXXX----------------------XXXXX-----------------------XXXXX-----------------------XXXXXX----------------------XXXXX-----------------------XXXXX-----------------------XXXXXX----------------------XXXXXX----------------------XXXXXX----------------------XXXXXX----------------------XXXXXX----------------------XXXXXX----------------------XXXXX----------<>-----------XXXXX-----------------------XXXXX-----------------------XXXXX-----------------------XXXXX-----------------------XXXXXX----------------------XXXXX-----------------------XXXXXX----------------------XXXXXX--------------------
-----------------[]--------------------------[]---------------------------------------------------------------------------------------------------------------------------------------------------------------------X[]------------------------------------------------------------------------------------------------------------------------------------------------------------------------------------------------------------------------------------------------------------------------------------------------------------------------------------------------------------------------------------------------------[]------------------------------------------------------------------------------------------------------------------------------------------------------------------------------------------------------------------------------------------------------------------------------------------------------------------------------------------------------------------------------------------------------------------------------------------------------------------------------------------------------------------------------------------------------------------------------[]-----------------------------------------------------------------------------------------------------------------------------------------------------------------------------------------------------------------------------------------
---------------XXXX-----XXXX---------------XXXXXXXX-XXXX----------------XXX------XXXX--------------XXXXXXX---XXX---------------XXXX------XXX---------------XXXX-----XXXX---------------XXXX-----XXXX---------------XXXX------XXX----------------XXX------XXX---------------XXXX------XXXX--------------XXXX------XXX---------------XXXX------XXX---------------XXXX------XXX---------------XXXX------XXX---------------XXXX------XXX---------------XXXX------XXX---------------XXXX------XXX---------------XXXX------XXX---------------XXXX-----XXXX---------------XXXX------XXX---------------XXXX------XXX---------------XXXXXXX--XXXX---------------XXXX-----XXXX---------------XXXX------XXX---------------XXXX-X----XXX---------------XXXX------XXX---------------XXXX------XXX---------------XXXX------XXX---------------XXXX------XXX---------------XXXX------XXX---------------XXXX------XXX---------------XXXX------XXX----------------XXX-----XXXX---------------XXXX------XXX---------------XXXX------XXX---------------XXXX------XXX---------------XXXX------XXX---------------XXXX-----XXXX---------------XXXX------XXX---------------XXXX------XXX---------------XXXX------XXX---------------XXXXXXXXXXXXX---------------XXXX------XXX---------------XXXX------XXX---------------XXXX------XXX---------------XXXX------XXX---------------XXXX------XXX---------------XXXX------XXX---------------XXXX-----XXXX---------------XXXX------XXX
