--------------------------------------------------------------------------------------------------------------------------------------------------------------------------------------------------------------------------------------------------------------------------------------------------------------------------------------------------------------------------------------------------------------------------------------------------------------------------------------------------------------------------------------------------------------------------------------------------------------------------------------------------------------------------------------------------------------------------------------------------------------------------------------------------------------------------------------------------------------------------------------------------------------------------------------------------------------------------------------------------------------------------------------------------------------------------------------------------------------------------------------------------------------------------------------------------------------------------------------------------------------------------------------------------------------------------------------------------------------------------------------------------------------------------------------------------------
--------------------------------------------------------------------------------------------------------------------------------------------------------------------------------------------------------------------------------------------------------------------------------------------------------------------------------------------------------------------------------------------------------------------------------------------------------------------------------------------------------------------------------------------------------------------------------------------------------------------------------------------------------------------------------------------------------------------------------------------------------------------------------------------------------------------------------------------------------------------------------------------------------------------------------------------------------------------------------------------------------------------------------------------------------------------------------------------------------------------------------------------------------------------------------------------------------------------------------------------------------------------------------------------------------------------------------------------------------------------------------------------------------------------------------------------------------
----oo--------------------------oo--------------------------oo--------------------------oo--------------------------oo--------------------------oo--------------------------oo--------------------------oo--------------------------o---------------------------oo--------------------------oo--------------------------oo--------------------------oo--------------------------oo--------------------------oo------------------------------------------------------oo--------------------------oo--------------------------oo--------------------------oo--------------------------oo--------------------------o---------------------------o---------------------------oo------------------------------------------------------oo--------------------------o---------------------------o---------------------------oo--------------------------oo--------------------------oo--------------------------oo--------------------------oo--------------------------oo--------------------------oo------------------------------------------------------oo--------------------------oo--------------------------oo--------------------------oo--------------------------oo--------------------------oo--------------------------oo--------------------------o---------------------------oo--------------------------oo--------------------------o---------------------------o---------------------------oo--------------------------oo----------------------
----XXX------------------------XXXX------------------------XXXX------------------------XXXX------------------------XXXX-------------------------XX--------------------------XXX------------------------XXXX-----------------------------------------------------XXX------------------------XXXX-------------------------XXX------------------------XXXX-------------------------XXX------------------------XXXX-----------------------------------------------------XXX-------------------------XXX------------------------XXXX------------------------XXXX------------------------XXXX-----------------------------------------------------X---------------------------XXX-----------------------------------------------------XXX--------------------------------------------------------------------------------XXXX-------------------------XXX-------------------------X---------------------------XX-------------------------XXXX------------------------XXXX-------------------------XXX-----------------------------------------------------XX--------------------------XXX------------------------XXXX--------------------E----XXX------------------------XXXX-----------------------XXXXX-------------------------XX------------------------------------------------------XXX------------------------XXXX--------------------------------------------------------------------------------XXXX------------------------XXXX---------------------
-----------------?-------------------------------------------------------?---------------------------?---------------------------?---------------------------?---------------------------?---------------------------E---------------------------E---------------------------?---------------------------?---------------------------E---------------------------E---------------------------E---------------------------E---------------------------?---------------------------?---------------------------E---------------------------E---------------------------?---------------------------?---------------------------E---------------------------?---------------------------?---------------------------?---------------------------?---------------------------?---------------------------?-------------------------------------------------------?---------------------------?---------------------------?---------------------------?---------------------------?------X-------------------E?---------------------------?---------------------------?---------------------------?---------------------------E---------------------------?---------------------------?---------------------------E---------------------------?---------------------------?---------------------------?---------------------------E---------------------------?---------------------------?---------------------------?---------------------------E----------
-----------oo---XXXS----?---------------oo---ESS----SSS-----------Xooo---XXS----S--------------oo---XXXS----SS------------Xoo---XXXS----S-------------Xooo---XXS----S-------------Xooo---XXS----S-------------Xooo---XXS----SSS------------ooo---XX-----S-------------Xooo--XXXS----S------------ooooo---XXS----SS------------Xooo---XSS----SSS-----------ooo----XXS----SS------------Xooo---XXS----SSS-----------ooo----XXS----SSS-----------Xooo---XXS----S-------------Xooo---XSSS---S-S-----------ooo----XXS----SS-----------oooo---XXX-----SS------------Xooo--XXXS----SSS-----------Xooo--XXXS----S-------------Xoo----XXS----S-------------Xooo---XXS----?-------------Xooo--XXXS----S-------------oooo--XXXS----S------------oooo---XXX-----SS------------Xooo---XXS----S------------ooooo--XXXS----S------------oooo----XXS----SSS-----------Xooo---XXS----S-------------Xooo---XXS----S-------------Xooo---XXS----SSS------------oo---XXXS----SSS-----------Xooo---XXS----S--------------oo---XXXS----S-------------Xooo---XXS----S-------------Xooo---XXS----SS------------Xoo----XXS----SSS------------oo----XXS----SSS----------ooooo---XXS----S------------oooo---XXX-----SS-------------oo---XXX-----SSS-----------Xooo---XXS----?------------oooo----XXS----S-------------Xooo---XXS----S-------------ooo----XXS----SS------------Xoo---XXXS----S-------------Xooo---XXS----?-------------Xoo----XXS----SSS-----------Xooo---XXS----SSS-
--------------------o---------------------------o---------------------------o-------------------------------------------------------------------------------------------------------------------------------------------o--------------------------oo-------------------------------------------------------------------------------------------------------------------------------------------o---------------------------o---------------------------------------------------------------------------------------------------------------o---------------------------------------------------------------------------------------------------------------o------------------------------------------------------oo---------------------------o-------------------------------------------------------o---------------------------o---------------------------o---------------------------o---------------------------o---------------------------------------------------------------------------------------------------------------o---------------------------------------------------------------------------------------------------------------o-------------------------------------------------------o---------------------------o---------------------------o---------------------------o---------------------------o---------------------------o--------------------------oo-------------------------------------------------------o-------
--------------------------------------------------------------------------------------------------------------------------------------------------------------------------------------------------------------------------------------------------------------------------------------------------------------------------------------------------------------------------------------------------------------------------------------------------------------------------------------------------------------------------------------------------------------------------------------------------------------------------------------------------------------------------------------------------------------------------------------------------------------------------------------------------------------------------------------------------------------------------------------------------------------------------------------------------------------------------------------------------------------------------------------------------------------------------------------------------------------------------------------------------------------------------------------------------------------------------------------------------------------------------------------------------------------------------------------------------------------------------------------------------------------------------------------------------------
------------------------------------------------------------------------------------------------------------------------------------------------------------------------------------------------------------------------------------------------------------------------------------------------------------------------------------------------------------------------------------------------------------------------------------------------------------------------------------------------------------------------------------Q----------------------------------------------------------------------------------------------------------------------------------------------------------------------------------------------------o----------------------------------------------------------------------------------------------------------------------------------------------------------------------------------------------------------------------------------------------------------------------------------------------------------------------------------------------------------------------------------------------------------------------------------Q---------------------------Q-----------------------------------------------------------------------------------------------------------------------------------------------------------------------------------------------------------------------------------------------
-------------XXX----XXX------------------XXX----XXX------------------XXX---XXXX------------------XXX---XXXX--X---------------XXX---XXXX--XXX-------------XXX---XXXX--XXX-------------XXX---XXXX--XXXX------------XXX---XXXX--XX--------------XXX---XXXX------------------XXX---XXXX--XXXX------------XXX---XXXX--XXX-------------XXX----XXX--XXXXX-----------XXX---XXXX--XXX-------------XXX----XXX-----X------------XXX----XXX--XX--------------XXX---XXXX--XXXX------------XXX---XXXXXXXX--------------XXX---XXXX--XXXXX-----------XXX---XXXX--XXX-------------XXX---XXXX--XX--------------XXX---XXXX--XX-XX-----------XXX---XXXX--XXX-------------XXX---XXXX------------------XXX---XXXX--XXXXX-----------XXX---XXXX------------------XXX---XXXX--XXX-------------XXX---XXXX--XX-X------------XXX---XXXX-----XX-----------XXX----XXX--XXX-------------XXX---XXXX--XXXXX-----------XXX---XXXX--XXX-------------XXX----XXX--XX--------------XXX---XXXX--XXXX------------XXX---XXXX--XXX-------------XXX---XXXX--XX--------------XXX----XXX--X---------------XXX---XXXX--XXX-------------XXX---XXXX--XXX-------------XXX---XXXX--XXX-------------XXX---XXXX--XXX-------------XXX---XXXX--XXX-------------XXX---XXXX-----X------------XXX---XXXX--X--XX-----------XXX---XXXX--XXX-------------XXX---XXXX-----X------------XXX---XXXX--XXXX------------XXX---XXXX--XX-X------------XXX---XXXX------------------XXX---XXXX--XXX-------------XXX----XXX--X--
--Eo--------------E------------o--------------E------------o---------------------------o--------------------------Eo--------------------------Eo--------------------------Eo---------------------------o--------------------------Eo--------------------------Eo--------------------------Eo--------------------------Eo---------------------------o--------------------------Eo---------------------------o--------------E-----------Eo---------------------------o---------------------------o---------------------------o--------------------------Eo--------------------------Eo---------------------------o--------------------------Eo--------------------------Eo--------------------------Eo--------------------------Eo--------------------------Eo--------------------------Eo--------------------------Eo--------------------------Eo---------------------------o--------------------------Eo---------------------------o--------------------------Eo---------------------------o--------------------------Eo--------------------------Eo---------------------------o---------------------------o--------------------------Eo---------------------------o---------------------------o--------------------------Eo--------------------------Eo--------------------------Eo---------------------------o---------------------------o---------------------------o---------------------------o--------------------------Eo------------------------
--XXXXX----------<>-----------XXXXXX---------<>-----E-----XXXXXX----------------------XXXXX-----------------------XXXXXX----------------------XXXXXX----------------------XXXXXX----------------------XXXXXX----------------------XXXXX-----------------------XXXXX-----------------------XXXXX-----------------------XXXXXX----------------------XXXXX-----------------------XXXXX-----------------------XXXXXX---------<>-----------XXXXXX----------------------XXXXXX----------------------XXXXX-----------------------XXXXX-----------------------XXXXXX----------------------XXXXXX----------------------XXXXXX----------------------XXXXXX----------------------XXXXXX----------------------XXXXXX----------------------XXXXX-----------------------XXXXXX----------------------XXXXX-----------------------XXXXX-----------------------XXXXXX----------------------XXXXXX----------------------XXXXXX----------------------XXXXXX----------------------XXXXX-----------------------XXXXX-----------------------XXXXXX----------------------XXXXXX----------------------XXXXXX----------------------XXXXXX---------<>-----------XXXXX-----------------------XXXXX-----------------------XXXXX-----------------------XXXXXX----------------------XXXXX-----------------------XXXXXX----------------------XXXXX-----------------------XXXXXX----------------------XXXXX-----------------------XXXXXX----------------------XXXXXX--------------------
-----------------[]--------------------------[]--------------------------------------------------------------------------------------------------------------------------------------------------------------------------------------------------------------------------------------------------------------------------------------------------------------------------------------------------------------------------[]----------------------------------------------------------------------------------------------------------------------------------------------------------------------------------------------------------------------------------------------------------------------------------------------------------------------------------------------------------------------------------------------------------------------------------------------------------------------------------------------------------------------------------------------------------------------------------------------------------------------------------------------------------------------------------------------[]-----------------------------------------------------------------------------------------------------------------------------------------------------------------------------------------------------------------------------------------------------------------------------------------------------------------------------
----------XXX--XXXX--X-XXXXXX----------XX--XXXXXXXXXXXXX---------------XXXX------XXXX--------------XXXX------XXX---------------XXXX------XXX---------------XXXX------XXX---------------XXXX------XXX---------------XXXX------XXX---------------XXXX------XXX---------------XXXX------XXX---------------XXXX------XXX---------------XXXX------XXX---------------XXXX------XXX---------------XXXX-----XXXX---------------XXXXXXX---XXX---------------XXXX------XXX-----------------XX------XXX---------------XXXX------XXX---------------XXXX-XX---XXX---------------XXXX------XXX---------------XXXX------XXX---------------XXXX------XXX----------------XXX------XXX---------------XXXX------XXX---------------XXXX-----XXXX---------------XXXX------XXX----------------XXX------XXX---------------XXXX------XXX---------------XXXXXXX---XXX---------------XXXX------XXX---------------XXXX------XXX---------------XXXX------XXX---------------XXXX------XXX---------------XXXX------XXXX--------------XXXX------XXX---------------XXXX-----XXXX---------------XXXX------XXX---------------XXXX------XXX---------------XXXXXXX---XXX---------------XXXX------XXX---------------XXXX------XXXX--------------XXXX--X---XXX----------------XXX------XXX---------------XXXX------XXX---------------XXXX-----XXXX---------------XXXX------XXX---------------XXXX------XXX-------------------------XXXX--------------XXXX-X---XXXX---------------XXXX-----XXXX
