--------------------------------------------------------------------------------------------------------------------------------------------------------------------------------------------------------------------------------------------------------------------------------------------------------------------------------------------------------------------------------------------------------------------------------------------------------------------------------------------------------------------------------------------------------------------------------------------------------------------------------------------------------------------------------------------------------------------------------------------------------------------------------------------------------------------------------------------------------------------------------------------------------------------------------------------------------------------------------------------------------------------------------------------------------------------------------------------------------------------------------------------------------------------------------------------------------------------------------------------------------------------------------------------------------------------------------------------------------------------------------------------------------------------------------------------------------
--------------------------------------------------------------------------------------------------------------------------------------------------------------------------------------------------------------------------------------------------------------------------------------------------------------------------------------------------------------------------------------------------------------------------------------------------------------------------------------------------------------------------------------------------------------------------------------------------------------------------------------------------------------------------------------------------------------------------------------------------------------------------------------------------------------------------------------------------------------------------------------------------------------------------------------------------------------------------------------------------------------------------------------------------------------------------------------------------------------------------------------------------------------------------------------------------------------------------------------------------------------------------------------------------------------------------------------------------------------------------------------------------------------------------------------------------------
----oo--------------------------oo--------------------------oo--------------------------o---------------------------oo--------------------------oo--------------------------oo--------------------------oo--------------------------oo--------------------------oo--------------------------oo--------------------------oo--------------------------oo--------------------------oo--------------------------oo--------------------------oo--------------------------o---------------------------oo--------------------------o---------------------------oo--------------------------oo------------------------------------------------------oo--------------------------oo--------------------------oo--------------------------oo------------------------------------------------------oo--------------------------oo--------------------------oo--------------------------oo--------------------------o-----------------------------------------------------------------------------------oo--------------------------oo--------------------------oo--------------------------oo------------------------------------------------------o---------------------------oo--------------------------oo--------------------------oo--------------------------oo--------------------------oo--------------------------o---------------------------o---------------------------oo------------------------------------------------------o-----------------------
----XXX----------------X--------XXX------------------------XXXX-----------------------------------------------------XXX------------------------XXXX------------------------XXXX-------------------------XXX-------------------------X---------------------------XXX-------------------------XXX-------------------------XXX------------------------XXXX------------------------XXXX------------------------XXXX-------------------------XXX-----------------------------------------------------XXX-----------------------------------------------------XXX-------------------------XXX-----------------------------------------------------XXX-------------------------XXX-------------------------XXX------------------------XXXX----------------------------------------------------XXXX------------------------XXXX------------------------XXXX-------------------------XXX-------------------------X----------------------------------------------------------------------------------XXXX--------------------E---XXXX------------------------XXXX------------------------XXXX-----------------------------------------------------XX-------------------------XXXX-------------------------XXX------------------------XXXX------------------------XXXX------------------------XXXX-----------------------------------------------------X--------------------------XXXX-----------------------------------------------------X-----------------------
----------------E?---------------------------E-------------------------------------------------------?---------------------------?---------------------------?---------------------------?---------------------------?---------------------------?---------------------------?---------------------------?---------------------------?-------------------------------------------------------?---------------------------E---------------------------?---------------------------?---------------------------?---------------------------?--------------------------E??--------------------------?---------------------------?---------------------------?---------------------------E---------------------------?---------------------------E---------------------------?---------------------------E---------------------------?---------------------------E---------------------------?---------------------------?---------------------------?---------------------------?---------------------------?---------------------------E---------------------------?---------------------------?---------------------------E---------------------------?---------------------------E---------------------------?---------------------------E---------------------------?---------------------------?---------------------------?---------------------------?--------------------------E?o--------------------------E---------------------------?----------
-----------oo---XXX-----o--------------ooo---SSSS---S-S------------ooo---ESS----SSS-----------Xooo---XXS----S-------------Xooo---XXS----S--------------oo---XXXS----SS------------Xooo---XXS----SSS-----------oooo---XXS----S-------------Xooo---XXS----S-------------Xoo----XXS----SS------------Xoo---XXXS----SS-----------ooooo---XXS----S--------------ooo---XSS----SSS-------------oo--XXXS----SSS------------oo----XXS----SSS-----------Xoo----XXS----S-------------Xooo---XXS----S-------------Xooo---XXS----SSS-----------Xooo---XXS----S-------------Xooo--XXXS----SS------------oooo---XXS----S-------------oooo--XXXS----?-------------Xooo---XXS----S------------oooo---XXX-----SS-------------ooo--XXXS----S------------oooo---XXXS----SS------------Xooo---XXS----S-------------ooo----XXS----SSS-----------Xoo---XXXS----SSS----------oooo----XXS----SSS------------ooo---XXS----SS------------oooo--XXXS----S-------------Xoo---XXXS----?-------------oooo---XXS----?--------------oo----XXS----SSS----------oooo----XXS----SSS-----------Xooo---XSS----SSS-----------Xooo---XSS----SS-----------ooooo---XX-----S-------------Xooo---XXS----S--------------oo----XXS----SSS-----------Xooo---XXS----S--------------oo----XXS----SSS------------oo----XXS----SSS-----------Xooo---XXS----S-------------Xooo---XXS----?--------------oo----XXS----SS--------------o---XXXS----SSS-----------oooo---XX-----S-------------Xooo---XXS----S---
--------------------o---------------------------o------------------------------------------------------oo---------------------------o-----------------------------------------------------------------------------------o---------------------------------------------------------------------------------------------------------------o---------------------------o-------------------------------------------------------o-------------------------------------------------------o-------------------------------------------------------o-------------------------------------------------------o--------------------------oo-------------------------------------------------------o-------------------------------------------------------o---------------------------o-----------------------------------------------------------------------------------o---------------------------o-------------------------------------------------------o--------------------------oo------------------------------------------------------------------------------------------------------------------------------------------oo---------------------------o--------------------------oo-------------------------------------------------------o----------------------------------------------------------------------------------oo----------------------------------------------------------------------------------oo---------------------------o-------
--------------------------------------------------------------------------------------------------------------------------------------------------------------------------------------------------------------------------------------------------------------------------------------------------------------------------------------------------------------------------------------------------------------------------------------------------------------------------------------------------------------------------------------------------------------------------------------------------------------------------------------------------------------------------------------------------------------------------------------------------------------------------------------------------------------------------------------------------------------------------------------------------------------------------------------------------------------------------------------------------------------------------------------------------------------------------------------------------------------------------------------------------------------------------------------------------------------------------------------------------------------------------------------------------------------------------------------------------------------------------------------------------------------------------------------------------------
--------------------------------------------------------------------------------------------------------------------------------------------------------------------------------------------------------------------------------------------------------------------------------------------------------------------------------------------------------------------------------------------------------------------Q-----------------------------------------------------------------------------------------------------------------------------------------------------------------------------------------------------------------------------------------------------------------------------------------------------------------------------------------------------------------------------------------------------------------------------------------------------------------------------------------------------------------------------------------------------------------------------------------------------------------------------------------------------------------------------------------------------------------------------------------------------------------------------------------------------------------------------------------------------------------------------------------------------------------------------------------------------------------------------------------------------------------------------------
-------------XXX---XXXX------------------XXX----XXX------------------XXX----XXX------------------XXX---XXXX------------------XXX----XXX--XX--------------XXX---XXXX--XXX-------------XXX----XXX--XX-XX-----------XXX---XXXX--XXXX------------XXX---XXXX--XXX-------------XXX---XXXX--XXX-------------XXX---XXXX--XXXX------------XXX---XXXX--XXX-------------XXX----XXX--XX--------------XXX---XXXX------------------XXX---XXXX--XXX-------------XXX---XXXX--XXXXX-----------XXX---XXXX--XX--------------XXX---XXXX--XXX-------------XXX---XXXX--XXX-------------XXX---XXXX-----X------------XXX---XXXX--XXXX------------XXX---XXXX------------------XXX---XXXX--XXXXX-----------XXX---XXXX--XXX-------------XXX---XXXX-----XX-----------XXX---XXXX--XXX-------------XXX---XXXX------------------XXX---XXXX--XXX-------------XXX---XXXX--XXXXX-----------XXX---XXXX--XXX-------------XXX---XXXX--X--X------------XXX---XXXX--XXX-------------XXX---XXXX-----X------------XXX---XXXX------------------XXX---XXXX--XXXXX-----------XXX---XXXX--XXXXX-----------XXX---XXXXX-XX-X------------XXX---XXXXXXXXXXX-----------XXX----XXX------------------XXX---XXXX--XX--------------XXX----XXX--X---------------XXX---XXXX--XXX-------------XXX---XXXX--XXX-------------XXX---XXXX--XXX-------------XXX---XXXX--XX-X------------XXX---XXXX------------------XXX---XXXX--XX--------------XXX---XXXX-----XX-----------XXX----XXX------------------XXX----XXX-----
--Eo--------------E------------o---------------------------o---------------------------o--------------------------Eo---------------------------o--------------------------Eo--------------------------Eo---------------------------o---------------------------o---------------------------o--------------------------Eo---------------------------o---------------------------o---------------------------o---------------------------o---------------------------o---------------------------o--------------------------Eo---------------------------o--------------------------Eo--------------------------Eo---------------------------o---------------------------o---------------------------o---------------------------o--------------------------Eo--------------------------Eo---------------------------o--------------E------------o--------------------------Eo--------------------------Eo--------------------------Eo--------------------------Eo---------------------------o---------------------------o---------------------------o---------------------------o--------------------------Eo--------------E-----------Eo---------------------------o--------------E-----------Eo---------------------------o---------------------------o--------------------------Eo---------------------------o---------------------------o---------------------------o--------------------------Eo--------------------------Eo------------------------
--XXXXX----------<>-----------XXXXXX----------------------XXXXXX----------------------XXXXXX----------------------XXXXXX----------------------XXXXX-----------------------XXXXXX----------------------XXXXXX----------------------XXXXXX----------------------XXXXXX----------------------XXXXXX----------------------XXXXX-----------------------XXXXXX----------------------XXXXX-----------------------XXXXX----------<>-----------XXXXXX----------------------XXXXXX----------------------XXXXXX----------------------XXXXXX----------------------XXXXXX----------------------XXXXX-----------------------XXXXXX----------------------XXXXXX----------------------XXXXX-----------------------XXXXX-----------------------XXXXX-----------------------XXXXX-----------------------XXXXX-----------E-----------XXXXXX---------<>-----------XXXXX-----------------------XXXXXX----------------------XXXXX-----------------------XXXXXX----------------------XXXXX-----------------------XXXXXX----------------------XXXXXX----------------------XXXXXX----------------------XXXXXX----------------------XXXXX----------<>-----------XXXXXX----------------------XXXXX----------<>-----------XXXXXX----------------------XXXXXX----------------------XXXXXX----------------------XXXXXX----------------------XXXXXX----------------------XXXXXX----------------------XXXXX-----------------------XXXXX-----------------------XXXXX---------------------
-----------------[]------------------------------------------------------------------------------------------------------------------------------------------------------------------------------------------------------------------------------------------------------------------------------------------------------------------------------------------------------------------------------------------------------[]------------------------------------------------------------------------------------------------------------------------------------------------------------------------------------------------------------------------------------------------------------------------------------------------------------------------------------------------------------------------------------------------------[]--------------------------------------------------------------------------------------------------------------------------------------------------------------------------------------------------------------------------------------------------------------------------------------[]------------------------------------------------------[]------------------------------------------------------------------------------------------------------------------------------------------------------------------------------------------------------------------------------E--------------------------------------
----------XXX--XXXX----XXXXXX--------------XXXX-----XXXX---------------XXXXXXX---XXX---------------XXXX------XXX---------------XXXX------XXX---------------XXXX------XXX---------------XXXX-X---XXXX---------------XXXX------XXX----------------XXX------XXX---------------XXXX------XXX---------------XXXX------XXX---------------XXXX------XXX---------------XXXXXXX---XXXXX-------------XXXX------XXX---------------XXXXXXX--XXXX---------------XXXX------XXX----------------XXX------XXX---------------XXXX------XXX---------------XXXX------XXXXX--------------XXX------XXX---------------XXXX------XXX----------------XXX------XXX---------------XXXX------XXX---------------XXXX------XXX---------------XXXX------XXX---------------XXXX------XXX---------------XXXX-----XXXX---------------XXXX-X---XXXX---------------XXXXXXX--XXXX---------------XXXX------XXX---------------XXXX------XXX----------------XXX------XXX---------------XXXX------XXX---------------XXXX------XXX---------------XXXX------XXX---------------XXXX-XX---XXX----------------XXX------XXX-----------------XX------XXX---------------XXXXXXXXXXXXX---------------XXXX-----XXXX---------------XXXXXXX---XXX---------------XXXX------XXX---------------XXXX-----XXXX---------------XXXX------XXX---------------XXXX------XXX-----------------X-------XXX---------------XXXX------XXXXXX------------XXXX-----XXXX---------------XXXXXXX--XXXX---------------XXXX-----XXXX
