--------------------------------------------------------------------------------------------------------------------------------------------------------------------------------------------------------------------------------------------------------------------------------------------------------------------------------------------------------------------------------------------------------------------------------------------------------------------------------------------------------------------------------------------------------------------------------------------------------------------------------------------------------------------------------------------------------------------------------------------------------------------------------------------------------------------------------------------------------------------------------------------------------------------------------------------------------------------------------------------------------------------------------------------------------------------------------------------------------------------------------------------------------------------------------------------------------------------------------------------------------------------------------------------------------------------------------------------------------------------------------------------------------------------------------------------------------
--------------------------------------------------------------------------------------------------------------------------------------------------------------------------------------------------------------------------------------------------------------------------------------------------------------------------------------------------------------------------------------------------------------------------------------------------------------------------------------------------------------------------------------------------------------------------------------------------------------------------------------------------------------------------------------------------------------------------------------------------------------------------------------------------------------------------------------------------------------------------------------------------------------------------------------------------------------------------------------------------------------------------------------------------------------------------------------------------------------------------------------------------------------------------------------------------------------------------------------------------------------------------------------------------------------------------------------------------------------------------------------------------------------------------------------------------------
--------------------------------------------------------------------------------------------------------------------------------------------------------------------------------------------------------------------------------------------------------------------------------------------------------------------------------------------------------------------------------------------------------------------------------------------------------------------------------------------------------------------------------------------------------------------------------------------------------------------------------------------------------------------------------------------------------------------------------------------------------------------------------------------------------------------------------------------------------------------------------------------------------------------------------------------------------------------------------------------------------------------------------------------------------------------------------------------------------------------------------------------------------------------------------------------------------------------------------------------------------------------------------------------------------------------------------------------------------------------------------------------------------------------------------------------------------
-------------------------------------------------------------------------------------------------------------------------------------------------------------------------------------------------------------------------------------------------------------------------------------------------------------------------------------------------------------------------------------------------------------------------------------------------------------------------------------------------------------------------------------------------------------------------------E------------------------------------------------------------------------------------------------------------------------------------------------------------------------------------------------------------------------------------------------------------------------------------------------------------------------------------------------------------------------------------------------------------------------------------------------------------------------------------------------------------------------------------------------------------------------------------------------------------------------------------------------------------------------------------------------------------------------------------------------------------------------------------------------------------------------------------------------------------------------
--------------------------------------------------------------------------------------------------------------------------------------------------------------------------------------------------------------------------------------------------------------------------------------------------------------------------------------------------------------------------------------------------------------------------------------------------------------------------------------------------------------------------------------------------------------------------------------------------------------------------------------------------------------------------------------------------------------------------------------------------------------------------------------------------------------------------------------------------------------------------------------------------------------------------------------------------------------------------------------------------------------------------------------------------------------------------------------------------------------------------------------------------------------------------------------------------------------------------------------------------------------------------------------------------------------------------------------------------------------------------------------------------------------------------------------------------------
---------Q----SSSS-S-SSS--------------------------------o------------SSS--------SSSS---------?--E---------------o--------Q-QQ------------------------?--E---------------o------?Q?-QE----------SSSS----------?S-E------------SS----------?-QE-----------SS-----------?S-E-----------SSSS---------QQQQ------------------------Q-Q-------------------------?--E------------------------?--E-----------SSS----------?--E------------------------Q--------------SS---------------------------------------?S-E-----------SSSS---------?--E---------SSSSSS---------?-QE--------SQSSSS-o------?-QQQE------------------------QQQQ----------------------------SSS---------------------?--E-----------SSSS---------?-----------------S---------?--E-----------S---o--------?--E------------------------Q-QE-----------SS-----------?--E------------------------?-QE-----------SS-----------?--E------------------------?-QE-----------SSS----------Q-Q-------------------------?--E---------------o--------?--E---------------o--------?--E-----------S------------Q-QQ------------S-----------Q---------------------------?--E-----------SSS--------?-?--E------------------------?-QQ-----------S------------Q-Q----------------o--------?---------------------------?--E-------------------------------S--------------------?--E------------------------?-?E-----------SSSS-------------------------------------?-Q------------SSS----------?--E------------SSS
----------------------------------------------------------------------X------------------------XXXX----------------------------X--------------------------X------------------------QXXXXX-----------------------XXXX-----------------------XXXXX------------------------XXXX----------------------------------------------------------------------------------XX--------------------------XX--------------------------X---------------------------------------------------------------------------------XXXX------------------------------------------------------XX--------------------------X---------------------------XX----------XX----------------------------------------------------------------------X------------------------XXXXX-----------X--------------XX----------XX-----------Q?-XX-----------------------XX-XX----------XX--------------XX-----------------------XXXXXX----------X-------------XXX---------------------------------------X-----------QXXXX----------XX-----------XXXXXX---------XX-----------QXXXX-----------X--------------XX-----------------------------------------------------XXX-----------------------XXXXX--------------------------XX---o------XX-----------------------------------------XXX-----------------------XXXXX---------------------------------------X-----------XXXXX-----------------------XXXXXX-----------------------------------------------------XX-----------------------XXXXX------------
------------------------------------------------------------------------------------------------------XXXXX---------------------------------------------------------------------------Q---------------------------Q---------------------------Q---XXX---------------------------------------------------------------------------------------------------------------------------------------------------------------------------------------------------------------------------------------------------------------------------------------------------------------------------------------------------------------------------------------------------------------------------------------------------------------------------------------------------------------------XXX------------------------------------------------------XX-----------------------------------------------------------------------------Q-----------------------------------------------------------------------------------Q---------------------------Q-------------------------------------------------------------------------------------------------------------------------------------------Q---XXX-------------------------------------------------------------------------------------------------------------------------------------------------------------------------------------------------------------------------------------------------------------------
----S----------------E----------------------------------------------------------------E-------------------------------E--------------E----------E-------------------E-------E-----------------------------E-----------E--E------------E-----------------------E---------------------------E------------------E--------E------------------E---------------------------E---------------------------E----------E-----------------------------E--------------E---------------------------E----------E-------------------E-------------------------------------E--------------E----------E----------------E---------------------------E--------E---E-------------------------E----------------E----------E-----------------------------E-----------------------------------------------------------------------------------E---------------------------E-------------------------------------------------------E--------------E------------E--------------E----------------------------------------E----------------------------------------------------------------------E---------------------------E------------E-------------------------E-------------------E---------E------------------------------------------E----------E----------------E----------E-----------------------------E---------------------------------------------------E---E-----------------E-------------------------------------E--------------E----------E-------------------E---
--E----E--Q-QQQ-----<>-------------Q--QQQQ-------------------<>----------------------<>----E-SQQQ-----------------E--<>---QQQQ------<>----QQ--E<>----SQQQ-----E----<>-----E<>--E?SQQQ-----------E-----E--<>--SQQQ----<>-<>--------E--<>---QQQQ---Q-----------<>----E?SQQQ----------------<>----E?SQQQ-------<>----EQ-<>---EE-SQQQ-------<>-----Q--E<>--E-SQQQ----Q--<>---QQQ--E<>----SQQQ-------<>--------E<>----SQQQ-----------------E--<>---QQQQ------<>---QQQ--E-E<>---QQQQ------<>--------E<>---?SQQQ-----E----<>-----E------SQQQ-----------------E--<>--SQQQ-------<>---QQQ--E<>--E?SQQQ-------<>--------E--<>--SQQQQ------<>----QQ-<>--<>---QQQQ------<>---QQQ--E<>-----QQQ-------<>--------E<>-----QQQ-----------E-----E-E<>---QQQQ----------------E<>--E--QQQQ----------------E-E--E?SQQQ-------------------E<>---QQQQ----------------E-E<>---QQQQ----------------E-E<>--SQQQ-----------E-----E-E<>--SQQQQ------<>--------E-E<>---QQQQ------<>-----Q--E-E<>--SQQQ-------------------E<>--SQQQ-----------------E-E<>--SQQQ-----------------E-E<>--SQQQ-------<>-----Q--E<>--E--QQQ-------<>----------E<>--SQQQ-----------E----<><>--E?SQQQ----------<>-----E-E<>---QQQQ---Q--<>-----Q--E<>--E--QQQQ------<>--------E<>--E?SQQQ-------<>--------E<>--E?SQQQ-----------------E--<>---QQQQ------<>-----Q--E-E----SQQQ-----------E----<>--<>--SSQQ----------<>-----E-E-----QQQ-----------------E-E<>---QQQQ------<>--------E<>----SQQQ----------<>---
-<>-----------------[]---E-----------------------------------[]----------------E-----[]---------------------E----<>--[]-------------[]-------<>[]------------<>----[]----<>[]------------------<>----<>--[]----------[]-[]-------<>--[]----------------------[]--------------------------[]-----------------[]-------[]--<>-------------[]-------<>[]---------------[]-------<>[]---------------[]-------<>[]------------------------<>--[]-------------[]-------<><>[]-------------[]-------<>[]------------<>----[]----<>--<>----------------------<>--[]-------------[]-------<>[]---------------[]-------<>--[]-------------[]-------[]--[]-------------[]-------<>[]---------------[]-------<>[]------------------<>----<><>[]-----------------E----<>[]---------------S--------<><><>----------------------<><>[]----------------------<><>[]----------------------<><>[]----------------<>----<><>[]-------------[]-------<><>[]-------------[]-------<><>[]----------------------<><>[]-----------------E----<><>[]----------------------<><>[]-------------[]-------<>[]---------------[]-------<><>[]----------------<>----[][]------------------[]----<><>[]-------------[]-------<>[]---------------[]-------<>[]---------------[]-------<>[]------------------------<>--[]-------------[]-------<>[>------------------<>----[]--[]----------------[]----<><>------------------------<><>[]-------------[]-------<>[]------------------[]---
-[]--X--------------[]--<>-----------------------------------[]---------------<>-----[]--------------------<>----[]->[]-------------[]-------[][]------------[]----[]--X-[][]------------------[]----[]--[]----------[]-[]-------[]--[]----------------------[]--------------------------[]-----------------[]---<>--[]--[]-------------[]-------[][]---------------[]-------[][]---------------[]-------[][]------------------------[]--[]-------------[]-------[][][]-------------[]-------[][]------------[]----[]----[]--[]----------------SS----[]--[]-------------[]-------[][]---------------[]---<>--[]--[]-------------[]-------[]--[]-------------[]-------[][]---------------[]-------[][]------------------[]----[][][]----------------<>----[][]------------------------[][][]----------------------[][][]----------------------[][][]----------------------[][][]----------------[]----[][][]-------------[]-------[][][]-------------[]-------[][][]----------------------[][][]----------------<>----[][][]----------------------[][][]-------------[]-------[][]---------------[]-------[][][]----------------[]----[][]------------------[]----[][][]-------------[]-------[][]---------------[]-------[][]---------------[]---<>--[][]------------------------[]--[]-------------[]-------[][]------------------[]----[]--[]----------------[]----[][]------------------------[][][]-------------[]-------[][]------------------[]---
-[]--------E--E-----[]--[]-------------E--E-EE-E------E--E---[]-------E-EE-E--[]-----[]----------EE-EE-E---[]----[][][]-------E-EE--[]-E--E--[][]--------EE--[]----[]----[][]--------EE-E--E---[]----[]--[]------EE--[]-[]-------[]--[]------EE-E------------[]-X---------E-EE-E---E-----[]-----------E-EE--[]-E-[]--[]--[]-------E-EE--[]-E--E--[][]--------EE-EE--[]-------[][]-E------EE-EE--[]-------[][]--------EE-EE-E---------[]--[]-------E-EE--[]----E--[][][]------EE-EE--[]-------[][]--------EE-EXXX---[]----[]-X[]------EE-EE-E---------[]--[]-------E-EE--[]-------[][]---------E-EE--[]-E-[]--[]-E[]-------E-EE--[]-EE-E--[]--[]-------E-EE--[]----E--[][]-E------EE-EE--[]-------[][]--------EE-EE-E---[]----[][][]-E----EE-EE-E---[]----[][]-E------EE-EE------E-E--[][][]------EE-EE-----------[][][]-E----EE-EE-----------[][][]------EE-EE-----------[][][]------EE-EE-E---[]----[][][]------EE-EE--[]-------[][][]-------E-EE--[]-EE-E--[][][]------EE-EE-E---------[][][]-E----EE-EE-E---[]----[][][]------EE-EE-E---------[][][]-------E-EE--[]-E--E--[][]---------E-EE--[]----E--[][][]-E----EE-E--E---[]----[][]---------E-EE-E---[]----[][][]------EE-EE--[]-------[][]---------E-EE--[]-EE-E--[][]---------E-EE--[]-E-[]--[][]-E-------E-EE-----------[]-E[]-------E-EE--[]-EE-E--[][]-E------EE-EE-----[]----[]-E[]------EE-EE-E---[]----[][]-E------EE-EE-----E-----[][][]------EE-EE--[]-E-----[][]--------EE-EE-E---[]---
-XX--XXXXXXXXXXXXXXXXXX-XXXXXXXX-XXXXXXXXXXXXXXXXXXXXXXXXXXXXXXXXXXXXXXXXXXXXXXXXXXX-XXXXXXXXXXXXXXXXXXXXXXXXXXX-XXXXXXXXXXXXXXXXXXXXXXXXXXXXXXXXXXXXXXXXXXXXXXXXXXXXXXX-XXXXXXXXXXXXXXXXXXXXXXXXXXXXXXXXXXXXXXXXXXXXXXXXXXXXXXXXXXXXXXXXXXXXXXXXXXXXXXXXXXXXXXXXXXXXXXXXXXXXXXXXXXXXXXXXXXXXXXXXXXXXXXXXXXXXXXXXXXXXXXXXXXXXXXXXXXXXXXXXXXXXXXXXXXXXXXXXXXXXXXXXXXXXXXXXXXXXXXXXXXXXXXXXXXXXXXXXXXXXXXX-XXXXXXXXXXXXXXXXXXXXXXXXXXXXXXXXXXXXXXXXXXXXXXXXXXXXXXXXXXXXXXXXXXXXXXXXXXXXXXXXXXX-XXXXXXXXXXXXXXXXXXXXXXXXXXXXXXXXXXXXXXXXXXXXXXXXXXXXXXXXXXXXXXXXXXXXXXXXXXXXXXXXXXX-XXXXXXXXXXXXXXXXXXXXXXXXXXX-XXXXXXXXXXXXXXXXXXXXXXXXXXX-XXXXXXXXXXXXXXXXXXXXXXXXXXXXXXXXXXXXXXXXXXXXXXXXXXXXXXX-XXXXXXXXXXXXXXXXXXXXXXXXXXX-XXXXXXXXXXXXXXXXXXXXXXXXXXXXXXXXXXXXXXXXXXXXXXXXXXXXXXX-XXXXXXXXXXXXXXXXXXXXXXXXXXX-XXXXXXXXXXXXXXXXXXXXXXXXXXX-XXXXXXXXXXXXXXXXXXXXXXXXXXX-XXXXXXXXXXXXXXXXXXXXXXXXXXX-XXXXXXXXXXXXXXXXXXXXXXXXXXX-XXXXXXXXXXXXXXXXXXXXXXXXXXX-XXXXXXXXXXXXXXXXXXXXXXXXXXX-XXXXXXXXXXXXXXXXXXXXXXXXXXXXXXXXXXXXXXXXXXXXXXXXXXXXXXXXXXXXXXXXXXXXXXXXXXXXXXXXXXX-XXXXXXXXXXXXXXXXXXXXXXXXXXX-XXXXXXXXXXXXXXXXXXXXXXXXXXX-XXXXXXXXXXXXXXXXXXXXXXXXXXX-XXXXXXXXXXXXXXXXXXXXXXXXXXX-XXXXXXXXXXXXXXXXXXXXXXXXXXX-XXXXXXXXXXXXXXXXXXXXXXXXXXX-XXXXXXXXXXXXXXXXXXXXXXXXXXX-XXXXXXXXXXXXXXXXXXXXXXXXXXXXXXXXXXXXXXXXXXXXXXXXXXXXXXX-XXXXXXXXXXXXXXXXXXXXXXXXXXX-XXXXXXXXXXXXXXXXXXXXXXXXXXX-XXXXXXXXXXXXXXXXXXXXXXXXXXX-XXXXXXXXXXXXXXXXXXXXXXXXXXX
