--------------------------------------------------------------------------------------------------------------------------------------------------------------------------------------------------------------------------------------------------------------------------------------------------------------------------------------------------------------------------------------------------------------------------------------------------------------------------------------------------------------------------------------------------------------------------------------------------------------------------------------------------------------------------------------------------------------------------------------------------------------------------------------------------------------------------------------------------------------------------------------------------------------------------------------------------------------------------------------------------------------------------------------------------------------------------------------------------------------------------------------------------------------------------------------------------------------------------------------------------------------------------------------------------------------------------------------------------------------------------------------------------------------------------------------------------------
--------------------------------------------------------------------------------------------------------------------------------------------------------------------------------------------------------------------------------------------------------------------------------------------------------------------------------------------------------------------------------------------------------------------------------------------------------------------------------------------------------------------------------------------------------------------------------------------------------------------------------------------------------------------------------------------------------------------------------------------------------------------------------------------------------------------------------------------------------------------------------------------------------------------------------------------------------------------------------------------------------------------------------------------------------------------------------------------------------------------------------------------------------------------------------------------------------------------------------------------------------------------------------------------------------------------------------------------------------------------------------------------------------------------------------------------------------
--------------------------------------------------------------------------------------------------------------------------------------------------------------------------------------------------------------------------------------------------------------------------------------------------------------------------------------------------------------------------------------------------------------------------------------------------------------------------------------------------------------------------------------------------------------------------------------------------------------------------------------------------------------------------------------------------------------------------------------------------------------------------------------------------------------------------------------------------------------------------------------------------------------------------------------------------------------------------------------------------------------------------------------------------------------------------------------------------------------------------------------------------------------------------------------------------------------------------------------------------------------------------------------------------------------------------------------------------------------------------------------------------------------------------------------------------------
-----XXX------------------------------------------------------------------------------------------------------------------------------------------------------------------------------------------------------------------------------------------------------------------------------------------------------------------------------------------------------------------------------------------------------------------------------------------------------------------------------------------------------------------------------------------------------------------------------------------------------------------------------------------------------------------------------------------------------------------------------------------------------------------------------------------------------------------------------------------------------------------------------------------------------------------------------------------------------------------------------------------------------------------------------------------------------------------------------------------------------------------------------------------------------------------------------------------------------------------------------------------------------------------------------------------------------------------------------------------------------------------------------------------------------------------------------------------------
--------------------------------------------------------------------------------------------------------------------------------------------------------------------------------------------------------------------------------------------------------------------------------------------------------------------------------------------------------------------------------------------------------------------------------------------------------------------------------------------------------------------------------------------------------------------------------------------------------------------------------------------------------------------------------------------------------------------------------------------------------------------------------------------------------------------------------------------------------------------------------------------------------------------------------------------------------------------------------------------------------------------------------------------------------------------------------------------------------------------------------------------------------------------------------------------------------------------------------------------------------------------------------------------------------------------------------------------------------------------------------------------------------------------------------------------------------
o-----------------------SSSSo--------QQQ------------SSSS---------?-QE------------------------Q-QQSSSS------------------------------------------------?--E----------SSSS----------?-Q----------------o--------Q---------------------------?--E-----------SSSS---------?--E------------------------?-Q-------------------------?--E---------------o--------?--E------------------------?--E---------------o--------Q-QQ------------------------?--E-----------S---o------?QQQQQ-----------S----------?-QQQQ------------------------Q-Q----S--------------------?--E------------------------?--E----------SSSSS---------?--E------------------------Q-Q-------------------------?--E---------------o--------?--E------------------------Q-Q-------------------------?--E------------S--o--------?--E-----------S---o--------?-QE------------------------Q-Q-------------------------Q-Q-------------SSS---------?--E-----------SSSS---------?--E------------SS----------?--E------------------------?-QQ------------------------?--E------------------------?--E-----------SS-----------?---------------------------?--E-----------S---o--------?--E---------------o--------Q-QQ------------------------?--E-----------SS--o--------?--E------------------------Q-Q-------------------------Q---------------------------?--E-----------S------------?--E---------------o--------?-Q----------------o--------?--E-----------SSS-o------?QQ-QE---------------
----------------------------------------------------------------------XX--------------------------------------------------------------------------------XXXX--------------------------XX---------------------------------------------------XXXXXX----------------------QXXXX-----------X--------------------------XX-----------XXXXX-----------------------XXXXXX--o------XX--------------XX----------XX---------------------------------------XXXXXX----------------------QXXXX----------XX---------------------------X---------------------------------------XXXXX-----------------------XXXXX------------------------X-XX---------------------------------------------------XXXXX-----------------------QXXXX----------XX-------------------------------------------------------------------XXXXXX---------XX-----------Q?XXX----------XX---------------------------X---------------------------------------XX-X------------------------XXXXXX-------------------------X----o------XX--------------XX---o-----XXX--------------X---------------------------XX----------XX---------------------------------------XXXXXX---------XX-----------QX-XX---o------XX--------------XX-----------X-----------XXXXXX----------------------XXXXXX---------XX-------------------------------------------------------------------XXXXXX----------------------XXXXXX--------------------------X---o------XX-----------XXXXXX----------------------XX-XX---o-----XXX
----------------------------------------------------------------------------------------------------------------------------------------------------------------------------------------------------------------------------------------------Q-----------------------------------------------------------X-X-------------------------------------------------Q---XXX---------------------------------------------------------------------------------------------------------Q---X-X-------------------------------------------------------------------------------------------------------------------------------------------------------------------------------------------------------------------------Q-----X-----------------------------------------------------------------------------Q-----X---------------------Q-----------------------------------------------------------------------------------------------------------------------------------------------XXX-------------------------X-X---------------------------------------------------------------------------------------------------------Q---XXX---------------------Q---XXX-----------------------------------------------------------------------------Q---XXX-----------------------------------------------------------------------------------------------------------------------------------------XXX---------------------Q---------------------------QX--XXX-------
------------------------------E------------------E--------E-------------------------------E-------------------------E----------------E------------E---------------------------E--------------E----------E----------------E--------------------------------------------------------------------E--------------E--------------------------------------------------------------------E------------------------------------------E--------------------------------------E----------------E--------E------------------E------------E--------------E------------E-----------------------------------------------------E-----------------------------E--------------E----------E------------------------------------------------------------------------E---------------------------------------------------------------------------------------------------------------E------------E--------------E------------------------E---------------E-----------------E-------------------------------------E-------------------------E-----------------------------E-------------------------E-----------------------------E-------------------------------------------------------E--------------E----------------------------------------E-------------------------E----------------E---------------------------E------------E---------------------------------------------E---------E-------------------------E---------------------------E-----------------------
--E--<>---QQQQ---------------<>----E?SQQQ-------<>-------<>--<>---QQQQ----------------E--<>---QQQQ------<>---QQQ--E<>------Q--------<>--------E--<>---QQQQ----------------E-E<>---QQQ-------<>-----Q--E<>--E?-QQQQ------<>--------E-E<>--SQQQ-----------------E-E<>--SQQQ--------------------<>---QQQQ------<>---QQQ--E-E----SQQQ-----------E-----E-E<>--SQQQ-------------------E<>---QQQQ------<>--------E-E<>--SQQQQ------<>-----Q--E-E<>--SQQQ-----------E-----E<>--E?SQQQ-------<>-------<>----E?SQQQ-------<>---QQQ--E--<>---QQQQ------<>---QQQ--E-E<>--SQQQ-----------E-----E--<>--SQQQ-----------------E<>--E?SQQQ-----------------E--<>---QQQ-------<>---QQQ--E<>----SQQQ-----------------E-E<>--SQQQ-----------------E-E<>---QQQQ------<>----------E----SQQQ-----------------E-E<>--SQQQ-----------------E-E--E?SQQQ-----------------E--<>---QQQ-------<>---QQQ--E--<>---QQQQ---<>-<>----Q---E-E----SQQQ----<>-----E-----E-E<>--SQQQ-----E----<>-----E----E--QQQ-------<>-----------<>---QQQQ---Q---E-----Q--E<>--E?SQQQ-------------------E<>---QQQQ----------------E<>-----QQQ-------------------E<>--SQQQ-----------------E-E----SQQQQ------------------E<>---QQQQ------<>--------E-E<>--SQQQ-----------------E-E<>--SQQQ-------S---------E<>--E--QQQQ------<>----------E<>---QQQQ------<>--------E-E<>--SQQQ-----------E-----E-E----SQQQ----------<>-------E<>---QQQQ---Q---------Q--E<>---?SQQQ-----------------E<>--E?SQQQ-------<>-----Q
-<>--[]----------------------[]-----------------[]-------[]--[]-------------<>-------<>--[]-------------[]-------<>[]---------------[]-------<>--[]-----------------E----<><>[]-------------[]-------<>[]---------------[]-------<><>[]-----------------E----<><>[]----------------------<>--[]-------------[]-------<><>------------------<>----<><>[]----------------------<><>[]-------------[]-------<><>[]-------------[]-------<><>[]----------------<>----<>[]---------------[]-------[]-----------------[]-------<>--[]-------------[]-------<><>[]----------------<>--X-<>--[]-----------------E----<>[]-------------------E----<>--[]-------------[]-------<>[]-------------------E----<><>[]----------------------<><>[]-------------[]-------<><>-------------------E----<><>[]----------------------<><>------------------------<>--[]-------------[]-------<>--[]----------[]-[]-------<><>------------[]----<>----<><>[]----------------[]----<><>---------------[]-------<>--[]-------------<>-------<>[]-------------------E----<><>[]----------------------<>[]------------------------<><>[]-----------------E----<><>-------------------------E<>[]-------------[]-------<><>[]----------------------<><>[]----------------------<>[]---------------[]--------E<>[]-------------[]-------<><>[]----------------<>----<><>------------------[]-----E<>[]----------------------<>[]------------------------<>[]---------------[]------
-[]--[]----------------------[]-----------------[]-------[]--[]-------------[]-------[]--[]-------------[]-------[][]---------------[]-------[]--[]----------------<>----[][][]-------------[]-------[][]---------------[]-------[][][]----------------<>----[][][]----------------------[]--[]-------------[]-------[][]------------------[]----[][][]----------------------[][][]-------------[]-------[][][]-------------[]-------[][][]----------------[]----[][]---------------[]-------[]-----------------[]-------[]--[]-------------[]-------[][][]----------------[]--X-[]--[]----------------<>----[][]------------------<>----[]--[]-------------[]-------[][]------------------<>----[][][]----------------------[][][]-------------[]-------[][]------------------<>----[][][]----------------------[][]-E----------------------[]--[]-------------[]-------[]--[]----------]--[]-------[][]------------[]----[]----[][][]----------------[]----[][]---------------[]-------[]--[]-------------[]-------[][]------------------<>----[][][]----------------------[][]------------------------[][][]----------------<>----[][]------------------------<>[][]-------------[]-------[][][]----------------------[][][]----------------------[][]---------------[]-------<>[][]-------------[]-------[][][]----------------[]----[][]------------------[]----<>[][]----------------------[][]------------------------[][]---------------[]------
-[]--[]----E-EE-EE-----E--E--[]-----------E--E--[]-E-E---[]--[]-------E-EE--[]----E--[]-E[]-------E-EE--[]-EE-E--[][]--------E--EE--[]-------[]--[]------EE-EE-E---[]-EX-[][][]------EE-EE--[]-EE-E--[][]--------EE-EE--[]-E--E--[][][]------EE-EE-E---[]----[][][]------EE-EE-E---------[]-E[]------EE-EE--[]--E-E--[][]-E------EE-EE-E---[]----[][][]------EE-EE-----------[][][]-E----EE-EE--[]----E--[][][]-------E-EE--[]-E--E--[][][]------EE-EE-E---[]----[][]--------EE-EE--[]-------[]-----------E-EE--[]----E--[]--[]-------EE-E--[]--E-E--[][][]------EE-E--E---[]-XX-[]-E[]------EE-EE-E---[]----[][]---------E-EE-E---[]----[]-E[]-------E--E--[]-EE-E--[][]--------EE-EE-E---[]----[][][]------EE-EE-----------[][][]------EE-EE--[]-E--E--[][]-E------EE-EE-----[]----[][][]------EE-EE-E---------[][]---------E-EE--------E--[]-E[]-------EE-E--[]--E-E--[]-E[]------EE-----[]-------[][]--------EE--[]----[]----[][][]------EE-E--E---[]----[][]--------EE-EE--[]-------[]--[]-------E-EE--[]-EE-E--[][]---------E-EE-E---[]----[][][]------EE-EE-----------[][]--------EE-EE-----E-----[][][]-E----EE-EE-E---[]----[][]--------EE-EE-E---------[][][]------EE-EE--[]-EE-E--[][][]------EE-EE-E---------[][][]------EE-EE-----------[][]---------E-EE--[]-E--E--[][][]------EE-EE--[]----E--[][][]-E----EE-EE-E---[]----[][]--------EE-EE-E---[]----[][][]-E----EE-EE-----EE-E--[][]---------E-EE-E---E-----[][]---------E-EE--[]--E-E-
XXXXXXXXXXXXXXXXXXXXXXXXXXXX-XXXXXXXXXXXXXXXXXXXXXXXXXXXXXXXXXXXXXXXXXXXXXXXXXXXXXXX-XXXXXXXXXXXXXXXXXXXXXXXXXXX-XXXXXXXXXXXXXXXXXXXXXXXXXXX-XXXXXXXXXXXXXXXXXXXXXXXXXXX-XXXXXXXXXXXXXXXXXXXXXXXXXXX-XXXXXXXXXXXXXXXXXXXXXXXXXXX-XXXXXXXXXXXXXXXXXXXXXXXXXXXXXXXXXXXXXXXXXXXXXXXXXXXXXXX-XXXXXXXXXXXXXXXXXXXXXXXXXXXXXXXXXXXXXXXXXXXXXXXXXXXXXXX-XXXXXXXXXXXXXXXXXXXXXXXXXXXXXXXXXXXXXXXXXXXXXXXXXXXXXXX-XXXXXXXXXXXXXXXXXXXXXXXXXXX-XXXXXXXXXXXXXXXXXXXXXXXXXXX-XXXXXXXXXXXXXXXXXXXXXXXXXXX-XXXXXXXXXXXXXXXXXXXXXXXXXXXXXXXXXXXXXXXXXXXXXXXXXXXXXXX-XXXXXXXXXXXXXXXXXXXXXXXXXXXXXXXXXXXXXXXXXXXXXXXXXXXXXXX-XXXXXXXXXXXXXXXXXXXXXXXXXXX-XXXXXXXXXXXXXXXXXXXXXXXXXXX-XXXXXXXXXXXXXXXXXXXXXXXXXXX-XXXXXXXXXXXXXXXXXXXXXXXXXXXXXXXXXXXXXXXXXXXXXXXXXXXXXXX-XXXXXXXXXXXXXXXXXXXXXXXXXXX-XXXXXXXXXXXXXXXXXXXXXXXXXXXXXXXXXXXXXXXXXXXXXXXXXXXXXXX-XXXXXXXXXXXXXXXXXXXXXXXXXXX-XXXXXXXXXXXXXXXXXXXXXXXXXXXXXXXXXXXXXXXXXXXXXXXXXXXXXXXXXXXXXXXXXXXXXXXXXXXXXXXXXXXXXXXXXXXXXXXXXXXXXXXXXXXXXXXXXXXXXXXXXXXXXXXXXXXXXXXXXXX-XXXXXXXXXXXXXXXXXXXXXXXXXXXXXXXXXXXXXXXXXXXXXXXXXXXXXXX-XXXXXXXXXXXXXXXXXXXXXXXXXXX-XXXXXXXXXXXXXXXXXXXXXXXXXXXXXXXXXXXXXXXXXXXXXXXXXXXXXXX-XXXXXXXXXXXXXXXXXXXXXXXXXXX-XXXXXXXXXXXXXXXXXXXXXXXXXXX-XXXXXXXXXXXXXXXXXXXXXXXXXXX-XXXXXXXXXXXXXXXXXXXXXXXXXXX-XXXXXXXXXXXXXXXXXXXXXXXXXXX-XXXXXXXXXXXXXXXXXXXXXXXXXXXXXXXXXXXXXXXXXXXXXXXXXXXXXXX-XXXXXXXXXXXXXXXXXXXXXXXXXXX-XXXXXXXXXXXXXXXXXXXXXXXXXXX-XXXXXXXXXXXXXXXXXXXXXXXXXXX
