--------------------------------------------------------------------------------------------------------------------------------------------------------------------------------------------------------------------------------------------------------------------------------------------------------------------------------------------------------------------------------------------------------------------------------------------------------------------------------------------------------------------------------------------------------------------------------------------------------------------------------------------------------------------------------------------------------------------------------------------------------------------------------------------------------------------------------------------------------------------------------------------------------------------------------------------------------------------------------------------------------------------------------------------------------------------------------------------------------------------------------------------------------------------------------------------------------------------------------------------------------------------------------------------------------------------------------------------------------------------------------------------------------------------------------------------------------
--------------------------------------------------------------------------------------------------------------------------------------------------------------------------------------------------------------------------------------------------------------------------------------------------------------------------------------------------------------------------------------------------------------------------------------------------------------------------------------------------------------------------------------------------------------------------------------------------------------------------------------------------------------------------------------------------------------------------------------------------------------------------------------------------------------------------------------------------------------------------------------------------------------------------------------------------------------------------------------------------------------------------------------------------------------------------------------------------------------------------------------------------------------------------------------------------------------------------------------------------------------------------------------------------------------------------------------------------------------------------------------------------------------------------------------------------------
--------------------------------------------------------------------------------------------------------------------------------------------------------------------------------------------------------------------------------------------------------------------------------------------------------------------------------------------------------------------------------------------------------------------------------------------------------------------------------------------------------------------------------------------------------------------------------------------------------------------------------------------------------------------------------------------------------------------------------------------------------------------------------------------------------------------------------------------------------------------------------------------------------------------------------------------------------------------------------------------------------------------------------------------------------------------------------------------------------------------------------------------------------------------------------------------------------------------------------------------------------------------------------------------------------------------------------------------------------------------------------------------------------------------------------------------------------
--------------------------------------------------------------------------------------------------------------------------------------------------------------------------------------------------------------------------------------------------------------------------------------------------------------------------------------------------------------------------------------------------------------------------------------------------------------------------------------------------------------------------------------------------------------------------------------------------------------------------------------------------------------------------------------------------------------------------------------------------------------------------------------------------------------------------------------------------------------------------------------------------------------------------------------------------------------------------------------------------------------------------------------------------------------------------------------------------------------------------------------------------------------------------------------------------------------------------------------------------------------------------------------------------------------------------------------------------------------------------------------------------------------------------------------------------------
--------------------------------------------------------------------------------------------------------------------------------------------------------------------------------------------------------------------------------------------------------------------------------------------------------------------------------------------------------------------------------------------------------------------------------------------------------------------------------------------------------------------------------------------------------------------------------------------------------------------------------------------------------------------------------------------------------------------------------------------------------------------------------------------------------------------------------------------------------------------------------------------------------------------------------------------------------------------------------------------------------------------------------------------------------------------------------------------------------------------------------------------------------------------------------------------------------------------------------------------------------------------------------------------------------------------------------------------------------------------------------------------------------------------------------------------------------
----------------S------------------------SQS------Q-------------------------------SS---------Q-Q----------------o--------?-Q-------------------------?--E-----------SSSS---------Q-Q-------------S---------------------------------------?--E-----------SSS----------?--E---------------o--------Q-----SS--------------------Q--E------------------------?--E-----------SS---------?-Q------------------o--------?-QE-----------SSS----------?--E---------------o------?QQQQQ-----------SS---------------------------------------------SS--------------------?--E------------SSS---------?--E-------------------------------S--------------------?--E------------------------?--E-----------SSS----------?--E-----------SS-----------Q-Q----------------o--------?--E-----------S---o--------?-QE-----------S------------Q-QQ------------------------Q-Q----S--------------------?--E----------SSSSS---------Q--------------SSSS-------?-QQ-------------SSS----------?--E-------------SS---------Q-QE---------SSS------------?--E--------SSSSSSS---------QQQ---------------------------------------------------------------------------------?-QE------------SS----------???QS--------SSSSSS---------?-QQ----------------------------------------------------?-Q-------------------------?--E--------------So--------?--E-----------S----------------------------------------?-?ES-S------SSSSSS---------?--E------------------------?-Q----S-----------
------------------------------------------------------------------------------------------------------------------------------XX------------------------?-X----------------------------------------X---------------------------------------XXXXXX----------------------QXXXX-----------X------------------------------------------X------------------------XXXXX---o------XX--------------------------XX-------------XXX-----------------------XXXXX--------------------------XX-----------X--------------------------XX---------------------------------------XXXXX-----------------------XXXXXX---------XX------------------------------------------X------------------------XXXXXX----------------------QXXXXX----------X---------------------------------------XXXXX-----------------------QX-XX---o-----XXX---------------------------X--------------------------XX-----------XX-X-----------------------------------------------------------------------------------X----------------------------------------------------XXXXXX------------------------------------------------------------------------------------------------------------XXX-------------------------XXX--------------------------XX-------------------------------------------------------------------------------XXXXX-----------------------XXXXXX---------XX--------------------------XX-------------XXX-----------------------XXXXX---------------------------------------X
----------------------------------E---------------------------------------------------------------------------------------------------------------------------------------------------------------------------------------------------------------------------------------------------------------------------------------------------------------------------Q---XXX---------------------------------------------------------------------------------------------------------Q---X-X-------------------------------------------------------------------------------------------------------------XXX-----------------------------------------------------------------------------------------------------------------------------------------------------------------Q---------------------------QQ--XXX-------------------------------------------------------------------------------------------------------------------------------------------------------------------------------------------------------------------------Q---------------------------------------------------------------------------------------------------------------Q-----------------------------------------------------------------------------------------------------------------------------------------------------------------------Q-----------------------------------------------------------------------------------------------------------------------------
------E--------------------------<>---------------------------------------------E--o---------------------E---------------------------E----------E-----------------------------E--------------E------------E---------------------------------------------------------------------------------E----------------E----------E-----------------------------E-------------------------E-----------------------------E--------------E----------E--------------------------------------------E------------E---------------------------E-------------------------E-------------------E---------E---------------------------E--------------E------------------------------------------------------------------------------------------------E--------------E-----------------------------------------------------------------------------------E---------------------------E--------E---------------E--S--------E---------------E-----------E------------------E----------E-------------------E-------------------------------------------------------------E---------------------------E-----------------------------E-------------------E---------E--------------E--------E---E-------------------------------------------------------E--------------E---------------------------E----------E-------------------E--o------E-------------------------E----------------E------------E-------------------------E-----------------------------E--------------E------
-----<>---QQQQ----------------E--[]---QQQQ---Q---QQ-------E--------------------<>----<>----E?SQQQ-------<>----QQ--E-E<>---QQQQ------<>--------E<>--E?SQQQ-----------------E-E<>---QQQQ------<>-----Q----E<>---QQQQ----------------E-E<>--SQQQ-------------------E----SQQQ-----------------E<>-----QQQQ------<>-----Q--E<>--E?SQQQ-----------------E--<>--SQQQ----Q---E---Q-Q--E<>--E?-QQQQ----------------E-E<>---QQQ-------<>--------E<>----SQQQ-----------E-----E---ES?SQQQQ---Q--<>---QQQ--E--<>---QQQQ----------------E--<>---QQQQ------<>-----Q--E<>----SQQQ----------<>-----E-E<>--SQQQ-----------------E--<>---QQQQ------<>-----Q--E-E<>---QQQQ----------------E-E<>--SQQQ-----------E-----E-E-E--SQQQ-------------------E<>---QQQQ------<>-----Q--E<>----SQQQ-----------------E-E-E--SQQQ----Q--<>--------E--<>---QQQQ------<>---QQQ--E----E--QQQQ------<>---QQQ-<>---E--S-------<>-----E----<>----E--QQQ----<>----------<>----E?-QQQ-------<>---QQQ--E<>--E?SQQQ----------<>-----E<>---QQQ------<>--------?--E-E<>--SQQQ-----------E----<>----S?SQQ---------E----E--<>----E--Q---------<>----E---E<>----Q-------<>----<>-----E--<>--SQQQ-------<>-------<>--<>--S-QQ-----------------E-E--E-SQQQQ---Q------------E--<>---QQQ-------<>----QQ--E-E<>---QQQQ------<>--------E<>----SQQQ----------<>-----E-E<>--SQQQ-----------------E<>--E--QQQ-------<>-----Q--E--<>---QQQ-----------------E<>--E?SQQQ-----------E--------<>---QQQQ------<>---QQQ
-----[]----------------------<>--[]----------------------<>--------------------[]----[]-----------------[]-------<><>[]-------------[]-------<>[]------------------------<><>[]-------------[]--------E<>[]----------------------<><>[]-----------------E----<><>-------------------E----<>[]---------------[]-------<>[]-------------------E----<>--[]-------------<>-------<>[]------------------------<><>[]-------------[]-------<>[]------------------<>----<>--<>-------------[]-------<>--[]----------------------<>--[]-------------[]-------<>[]------------------[]----<><>[]----------------------<>--[]-------------[]-------<><>[]-----------------E----<><>[]----------------<>----<><>[>----------------------<><>[]-------------[]-------<>[]------------------------<><>[>-------------[]-------<>--[]-------------[]-------<>-----------------[]-------[]--<>----------[]----<>----[]--------------[]-----E----[]-----------------[]-------<>[]------------------[]----<>[]------------[]----------<><>[]----------------<>----[]----------------E<>---<>--[]-----------------[]---<>--<>[]------------[]----[]----<>--[]-------------[]-------[]--[]----------------------<><>------------------------<>--[]-------------[]-------<><>[]-------------[]-------<>[]------------------[]----<><>[]----------------------<>[]---------------[]-------<>--[]----------------------<>[]------------------<>----<>--[]-------------[]------
-<>--[]----------------------[]--[]----------------------[]--------------------[]----[]-----------------[]-------[][][]-------------[]-------[][]------------------------[][][]-------------[]-------<>[][]----------------------[][][]----------------<>----[][]------------------<>----[][]---------------[]-------[][]------------------<>----[]-E[]-------------[]-------[][]------------------------[][][]-------------[]-------[][]------------------[]----[]--[]-------------[]-------[]--[]----------------------[]--[]-------------[]-------[][]------------------[]----[][][]----------------------[]--[]-------------[]-------[][][]----------------<>----[][][]----------------[]----[][][]----------------------[][][]-------------[]-------[][]------------------------[][][]-------------[]-------[]--[]-------------[]-------[]--oo-------------[]-------[]--[]----------[]----[]----[]--------------[]----<>----[]-----------------[]-------[][]------------------[]----[][]------------[-----------[][][]----------------[]----[]---------------<>[]---[]--[]-----------------[]---[]--[][]------------[]----[]----[]-E[]-------------[]-------[]--[]----------------------[][]------------------------[]--[]-------------[]-------[][][]-------------[]-------[][]------------------[]----[][][]----------------------[][]---------------[]-------[]--[]----------------------[][]------------------[]----[]--[]-------------[]------
-[]-E[]-------E-EE------E-E--[]-E[]----E----EE--E-EE-----[]-----------E-EE-E---[]----[]-----------E-EE--[]-------[][][]------EE-EE--[]-E--E--[][]---------E-EE-E---------[][][]------EE-EE--[]--E-E--[][][]------EE-EE--------E--[][][]------EE-EE-E---[]----[][]-E------EE-EE-E---[]----[][]--------EE-EE--[]-E--E--[][]--------EE-EE-E---[]----[][][]------EE-EE--[]----E--[][]--------EE-EE-----------[][][]------EE-EE--[]-E-E---[][]-E------EE-EE-E---[]----[]--[]-------E-EE--[]-------[]-E[]-------E-EE--------E--[]--[]------EE-EE--[]-E--E--[][]--------EE-EE-E---[]----[][][]-E----EE-EE-E---------[]-E[]-------E-EE--[]-EE-E--[][][]------EE-EE-E---[]----[][][]------EE-EE-E---[]----[][][]------EE-EE-E---------[][][]-------E--E--[]-E--E--[][]-E------EE-EE-E---------[][][]-------E-EE--[]-------[]--[]-------E-EE--[]-EE-E--[]--[]------EEE----[]--E-E--[]--[]---E---E--[]----[]----[]--------E-EE--[]----[]----[]--------E--E-----[]-------[][]---------E-EE-E---[]----[][]--------EE-EX-----------[][][]------EE-EE-E---[]-E--[]-----------EE--[][]-E-[]--[]---------E-E-----[]-E-[]--[][]--------EE--[]----[]----[][][]------EE-E---[]-------[]--[]-------E-EE-E---E-----[][]---------E-EE-E---------[]--[]------EE-EE--[]--E-E--[][][]------EE-EE--[]-E-E---[][]--------EE-EE-E---[]----[][][]------EE-EE-E---------[][]--------EE-EE--[]-EE-E--[]--[]------E--EE-E---E-----[][]---------E-EE-E---[]----[]--[]------EEEE---[]-EE-E-
-XXXXXXXXXXXXXXXXXXXXXXXXXXX-XXXXXXXXXXXXXXXXXXXXXXXXXXXXXXXXXXXXXXXXXXXXXXXXXXXXXXX-XXXXXXXXXXXXXXXXXXXXXXXXXXX-XXXXXXXXXXXXXXXXXXXXXXXXXXX-XXXXXXXXXXXXXXXXXXXXXXXXXXX-XXXXXXXXXXXXXXXXXXXXXXXXXXX-XXXXXXXXXXXXXXXXXXXXXXXXXXX-XXXXXXXXXXXXXXXXXXXXXXXXXXX-XXXXXXXXXXXXXXXXXXXXXXXXXXX-XXXXXXXXXXXXXXXXXXXXXXXXXXX-XXXXXXXXXXXXXXXXXXXXXXXXXXXXXXXXXXXXXXXXXXXXXXXXXXXXXXX-XXXXXXXXXXXXXXXXXXXXXXXXXXX-XXXXXXXXXXXXXXXXXXXXXXXXXXX-XXXXXXXXXXXXXXXXXXXXXXXXXXXXXXXXXXXXXXXXXXXXXXXXXXXXXXX-XXXXXXXXXXXXXXXXXXXXXXXXXXXXXXXXXXXXXXXXXXXXXXXXXXXXXXX-XXXXXXXXXXXXXXXXXXXXXXXXXXX-XXXXXXXXXXXXXXXXXXXXXXXXXXX-XXXXXXXXXXXXXXXXXXXXXXXXXXXXXXXXXXXXXXXXXXXXXXXXXXXXXXX-XXXXXXXXXXXXXXXXXXXXXXXXXXXXXXXXXXXXXXXXXXXXXXXXXXXXXXX-XXXXXXXXXXXXXXXXXXXXXXXXXXX-XXXXXXXXXXXXXXXXXXXXXXXXXXXXXXXXXXXXXXXXXXXXXXXXXXXXXXXXXXXXXXXXXXXXXXXXXXXXXXXXXXXXXXXXXXXXXXXXXXXXXXXXXXXXXXX-XXXXXXXXXXXXXXXXXXXXXXXXXXX-XXXXXXXXXXXXXXXXXXXXXXXXXXX-XXXXXXXXXXXXXXXXXXXXXXXXXXX-XXXXXXXXXXXXXXXXXXXXXXXXXXX-XXXXXXXXXXXXXXXXXXXXXXXXXXXXXXXXXXXXXXXXXXXXXXXXXXXXXXXXXXXXXXXXXXXXXXXXXXXXXXXXXXX-XXXXXXXXXXXXXXXXXXXXXXXXXXXXXXXXXXXXXXXXXXXXXXXXXXXXXXXXXXXXXXXXXXXXXXXXXXXXXXXXXXX-XXXXXXXXXXXXXXXXXXXXXXXXXXX-XXXXXXXXXXXXXXXXXXXXXXXXXXXXXXXXXXXXXXXXXXXXXXXXXXXXXXX-XXXXXXXXXXXXXXXXXXXXXXXXXXXXXXXXXXXXXXXXXXXXXXXXXXXXXXX-XXXXXXXXXXXXXXXXXXXXXXXXXXX-XXXXXXXXXXXXXXXXXXXXXXXXXXXXXXXXXXXXXXXXXXXXXXXXXXXXXXX-XXXXXXXXXXXXXXXXXXXXXXXXXXXXXXXXXXXXXXXXXXXXXXXXXXXXXXX
