--------------------------------------------------------------------------------------------------------------------------------------------------------------------------------------------------------------------------------------------------------------------------------------------------------------------------------------------------------------------------------------------------------------------------------------------------------------------------------------------------------------------------------------------------------------------------------------------------------------------------------------------------------------------------------------------------------------------------------------------------------------------------------------------------------------------------------------------------------------------------------------------------------------------------------------------------------------------------------------------------------------------------------------------------------------------------------------------------------------------------------------------------------------------------------------------------------------------------------------------------------------------------------------------------------------------------------------------------------------------------------------------------------------------------------------------------------
--------------------------------------------------------------------------------------------------------------------------------------------------------------------------------------------------------------------------------------------------------------------------------------------------------------------------------------------------------------------------------------------------------------------------------------------------------------------------------------------------------------------------------------------------------------------------------------------------------------------------------------------------------------------------------------------------------------------------------------------------------------------------------------------------------------------------------------------------------------------------------------------------------------------------------------------------------------------------------------------------------------------------------------------------------------------------------------------------------------------------------------------------------------------------------------------------------------------------------------------------------------------------------------------------------------------------------------------------------------------------------------------------------------------------------------------------------
--------------------------------oo--------------------------oo--------------------------oo--------------------------oo--------------------------oo--------------------------oo--------------------------oo--------------------------oo--------------------------oo--------------------------oo--------------------------oo--------------------------oo--------------------------oo--------------------------oo--------------------------oo--------------------------oo--------------------------oo--------------------------oo--------------------------oo--------------------------oo--------------------------oo--------------------------oo--------------------------oo--------------------------oo--------------------------oo--------------------------oo--------------------------oo--------------------------oo--------------------------oo--------------------------oo--------------------------oo--------------------------oo--------------------------ooo-------------------------oo------------------------------------------------------oo--------------------------oo--------------------------oo------------------------------------------------------oo--------------------------oo----------------------------------------------------------------------------------oo--------------------------oo--------------------------oo--------------------------oo--------------------------oo--------------------------oo----------------------
-------------------------------XXXX-----------------------XXXXX--------------------E---XXXX------------------------XXXX----------------X-------XXXX--------------------E----XXX-------------------------XXX------------------------XXXX-------------------------XXX-------------------------XXX------------------------XXXX-------------------------XXX------------------------XXXX-------------------------X--------------------------XXXX-------------------------XXX------------------------XXXX--------------------E--XXXXX--------------------E---XXXX-----------------------XXXXX--------------------E---XXXX-----------------------XXXXXX----------------------XXXXXX----------------------XXXXX-----------------------XXXXX-------------------------XXX------------------------XXXX------------------------XXXX-------------------------XXX------------------------XXXX-------------------------X-------------------------XXXXX--------------------E--XXXXXX------------------------XXX-----------------------------------------------------X--------------------------XXXX-------------------------XXX-----------------------------------------------------XXX-------------------------XXX---------------------------------------------------------------------------------XXX------------------------XXXX------------------------XXXX-------------------------XXX-------------------------XXX------------------------XXXX---------------------
-----------------?---------------------------------------------------------------------------------------------------------------?-------------------------------------------------------E---------------------------?-------------------------------------------------------?---------------------------?---------------------------E---------------------------?---------------------------?---------------------------E-------------------------------------------------------E---------------------------------------------------------------------------------------------------------------------------------------------------------------------------------------------------------------------------------------------------------------------------------------?-------------------------------------------------------E---------------------------?-------------------------------------------------------?-----------------------------------------------------------------------------------?---------------------------?---------------------------?---------------------------E---------------------------?---------------------------?---------------------------?---------------------------??--------------------------?---------------------------?---------------------------?---------------------------?---------------------------?---------------------------?---------------------------?---------------------------?----------
-----------ooo---XXS----?---------------oo---ESS----SSS----------oooo----XX-----SSS------------ooo---SSSS---SSS-------------oo--XXXS----S------------oooo----XXS----SSS------------ooo---EXS----SSS-----------Xooo---XXS----S--------------ooo---XXS----SSS-----------Xooo---XSS----S-------------Xoo---XXXS----SSS------------ooo---XXS----SS------------Xooo---XXS----?---------------oo---XXS----SSS------------ooo---XXS----SSS------------ooo---XSS----SSS------------ooo---XXS----SSS------------oo----XX----SSSS------------oo----XX----SSSS----------ooooo---XX-----SSS----------oooo----XX-----SSS------------ooo---EX-----SS-----------oooo----X-----SSSSS-----------ooo---XXS----SSS------------ooo---ESS----SSS------------ooo---ESS----SSS------------ooo---XXS----S--------------oo----XXS----SSS-----------Xooo---SSS----SSS-----------oooo---XXS----S--------------ooo---ESS----SSS-------------o---XXXS----SSS----------ooooo---XX----SSSS------------------------SSSSS----------oooo--XXXS----?-------------Xooo--XXXS----?-------------Xooo---XSS----S--------------oo----XXS----SSS-----------Xooo--XXXS----S-------------oooo---XX-----?-------------ooo---XXXS----S-------------Xoo---XXXS----SS-------------ooo--XXX-----?-------------Xooo--XXXS----S-------------Xoo---XXXS----SS------------Xooo---XXS----SSS-----------Xoo---XXXS----SS------------oooo---XXS----S-------------Xooo---XXS----SS------------oooo---XXS----S---
--------------------o---------------------------o---------------------------o------------X----------------------------------------------------------------------o--------------------------oo---------------------------o---------------------------o-----------------------------------------------------------------------------------o-----------------------------------------------------------------------------------o---------------------------o--------------------------oo---------------------------o---------------------------o---------------------------o---------------------------o---------------------------oo--------------------------------------------------------------------------------------------------------------o---------------------------o--------------------------oo---------------------------o------------------------------------------------------oo---------------------------------------------------------------------------------------------------------------o---------------------------o-------------------------------------------------------o---------------------------o--------------------------oo---------------------------o------------------------------------------------------ooo--------------------------o-------------------------------------------------------------------------------------------------------------------------------------------------------------------------------
----------------------------------------------------------------S---------------o---------------------------------------------------------------------------------------------------------------------------------------------------------------------------------------------------------------------------------------------------------------------------------------------------------------------------------------------------------------------------------------------------------------------------------------------------------------------------SSS-------------------------S-----------------------------------------------------------------------------------------------------------------------------------------------------------------------------------------------------------------------------------------------------------------------------------------------------------------------------------------------S---------------------------------------------------------------------------------------------------------------------------------------------------------------------------------------------------------------------------------------------------------------------------------------------------------------------------------------------------------------------------------------------------------------------------------------------------------------------------------------------------------------
----------------------------------------------------------------S---------E-------------------------------------------------------------------------------------------------------------------------------------------------------------------------------------------------------------------------------------------------------------------------------------------------------------------------------------------------------------------------------------------------------------------------XX----------------------------------------------------SoS-------------------------SoS---------E-------------------------------------------------------E-----------------------------------------------------------------------------------------------------------------------------------------------------------------------------------------------------------------------------------------------------------------------------S-------------------------------------E-------------------------------------------------------------------------------------------------------------------------------------------------------------------------------------------------------------------------------------------------------------------------------------------------------------------------------------------------------------------------------------------------------------------------------------------------------------------------
-------------XXX----XXX------------------XXX----XXX-----X------SS----XX--<>-XXX--XXX-------------XXX----XXX------------------XXX---XXXX-----XX-----------XXX----XXX--XXXXX-----------XXX----XXX------------------XXX----XXX------------------XXX----XXX--XX--------------XXX---XXXX--XX--------------XXX---XXXX--XXXXX-----------XXX---XXXX--XX--------------XXX---XXXX--X---------------XX-----XXX------------------XXX----XXX------------------XXX----XXX------------------XXX----XXX------X-----------XXX---XXXX--XXX-------------XX--<>-XXX-----X------SS----XX--<>-XXX--XXXXX-----SS----XX--<>-XXX--EXX-------------XXX----XXX------------------XX--<>-XXX--EXX-------------XXX----XXX------------------XXX----XXX------------------XX-----XXX------------------XXX----XXX------------------XXX----XXX-----XX-----------XXX----XXX--XXX-------------XXX---XXXX--XXX-------------XXX----XXX------------------XXX---XXXX--XX-XX-----------XX--<>-XXX--XXX-----------------<>-----E??S-------------XXX----XXX------------------XXX---XXXX-----X------------XXX---XXXXX-XXX-------------XXX----XXX--XX--------------XXX---XXXX--X--X------------XXX---XXXX-----XX-----------XXX---XXXX--XXX-------------XXX---XXXX--XX--------------XXX----XXX------------------XXX---XXXX------------------XXX---XXXX--XXX-------------XXX---XXXX--XXX-------------XXX---XXXX--XXXX------------XXX---XXXX--XXX-------------XXX---XXXX--XXXXX-----------XXX---XXXX--XXX
--Eo---------------------------o--------------E-----------Eo-------------[]------------o---------------------------o---------------------------o--------------E------------o--------------------------Eo---------------------------o--------------E------------o--------------------------Eo---------------------------o--------------------------Eo-------------------------------------------------------o---------------------------o---------------------------o------------------------------------------E--------------------------[]-----------Eo-------------[]-----------Eo-------------[]------------o--------------E------------o-------------[]------------o--------------E------------o--------------E------------o-------------<>-----------Eo---------------------------o--------------E------------o--------------------------Eo---------------------------o---------------------------o---------------------------o-------------[]--------------------------[]----<>-----Eo--------------------------Eo---------------------------o--------------------------Eo--------------------------Eo--------------------------Eo---------------------------o---------------------------o--------------------------Eo---------------------------o---------------------------o--------------------------Eo---------------------------o--------------------------Eo--------------------------Eo--------------------------Eo------------------------
--XXXXX-----------------------XXXXXX---------<>-----------XXXXX----------[]-----------XXXXXX----------------------XXXXX-----------------------XXXXX----------<>-----------XXXXXX----------------------XXXXXX----------------------XXXXXX---------<>-----------XXXXXX----------------------XXXXXX----------------------XXXXXX----------------------XXXXXX-----------------------XXXX----------<>-----------XXXXXX----------------------XXXXXX----------------------XXXXXX----------------------XXXXXX---------<>-----------XXXXXX---------[]-----------XXXXXX---------[]-----------XXXXX----------[]-----------XXXXX----------<>-----------XXXXX----------[]-----------XXXXXX---------<>-----------XXXXXX---------<>-----------XXXXXX---------[]-----------XXXXX-----------------------XXXXXX---------<>-----------XXXXXX----------------------XXXXX-----------------------XXXXXX----------------------XXXXXX----------------------XXXXX----------[]------------XXXX----------[]----[]-----XXXXX-----------------------XXXXX-----------------------XXXXXX----------------------XXXXXX---------<>-----------XXXXXX----------------------XXXXX-----------------------XXXXX-----------------------XXXXXX----------------------XXXXX-----------------------XXXXX-----------------------XXXXXX----------------------XXXXXX----------------------XXXXXX----------------------XXXXXX----------------------XXXXXX----------------------XXXXX---------------------
------------------X--------------------------[]--------------------------[]----------------------------------------------------------------------------------[]----------------------------------------------------------------------------------[]------------------------------------------------------------------------------------------------------------------------------------------[]--------------------------------------------------------------------------------------------------------------[]--------------------------[]--------------------------[]--------------------------[]--------------------------[]--------------------------[]--------------------------[]--------------------------[]--------------------------[]------------------------------------------------------[]------------------------------------------------------------------------------------------------------------------------------------------[]-----------------------E--[]----[]--------------------------------------------------------------------------------------------------------[]---------------------------------------------------------------------------------------------------------------------------------------------------------------------------------------------------------------------------------------------------------------------------------------------------------------------------------------------------------
-----------X---XXXX----XXXXX---------------XXXXXXXXXXXXX-----------XX--XXXXXXXXXXXXXX--------------XXXXXXXXXXXXXX-X--------X---XXXX-----XXXX---------------XXXXXXX---XXX---------------XXXX------XXX---------------XXXX-----XXXX---------------XXXXXXX---XXX----------------XXX------XXX---------------XXXX------XXX---------------XXXX------XXX----------------XXX------XXXXXX-------XXX--XXXXXXX-XXXXX---------------XXXX-----XXXX---------------XXXXXXX---XXX---------------XXXX------XXX---------------XXXXXXX---XXX---------------XXXXXXXXXXXXX------------X--XXXXXXXXXXXXX-----------XX--XXXXXXXXXXXXX---------------XXXXXXXXXXXXX-----------XX--XXXXXXXXXXXXX---------------XXXXXXXXXXXXXX--------------XXXXXXXX-XXXX---------------XXXXXXXXXXXXX-----------X---XXXX--X-XXXXX---------------XXXXXXXXXXXXX---------------XXXX------XXX---------------XXXX------XXX---------------XXXXXXX--XXXXX--------------XXXX------XXX---------------XXXXXXXXXXXXX----------XXXXXXXXXXXXXXXXXX---------------XXXX-----XXXX-----------------X-------XXX----------------XXX------XXX---------------XXXXXXX--XXXX---------------XXXX-----XXXX---------------XXXX------XXX---------------XXXX------XXXX--------------XXXX------XXX---------------XXXXXXXXXXXXX---------------XXXX-----XXXX---------------XXXX------XXX---------------XXXX------XXX----------------XXX------XXX---------------XXXX------XXX---------------XXXX------XXX---------------XXXX------XXX
