--------------------------------------------------------------------------------------------------------------------------------------------------------------------------------------------------------------------------------------------------------------------------------------------------------------------------------------------------------------------------------------------------------------------------------------------------------------------------------------------------------------------------------------------------------------------------------------------------------------------------------------------------------------------------------------------------------------------------------------------------------------------------------------------------------------------------------------------------------------------------------------------------------------------------------------------------------------------------------------------------------------------------------------------------------------------------------------------------------------------------------------------------------------------------------------------------------------------------------------------------------------------------------------------------------------------------------------------------------------------------------------------------------------------------------------------------------
--------------------------------------------------------------------------------------------------------------------------------------------------------------------------------------------------------------------------------------------------------------------------------------------------------------------------------------------------------------------------------------------------------------------------------------------------------------------------------------------------------------------------------------------------------------------------------------------------------------------------------------------------------------------------------------------------------------------------------------------------------------------------------------------------------------------------------------------------------------------------------------------------------------------------------------------------------------------------------------------------------------------------------------------------------------------------------------------------------------------------------------------------------------------------------------------------------------------------------------------------------------------------------------------------------------------------------------------------------------------------------------------------------------------------------------------------------
----oo------------------------------------------------------oo--------------------------oo--------------------------o---------------------------oo--------------------------oo--------------------------oo--------------------------oo--------------------------oo--------------------------oo--------------------------o---------------------------oo------------------------------------------------------oo--------------------------oo--------------------------oo--------------------------oo--------------------------oo--------------------------oo--------------------------oo--------------------------oo--------------------------oo--------------------------oo--------------------------oo--------------------------oo------------------------------------------------------oo--------------------------oo--------------------------oo--------------------------oo--------------------------oo--------------------------oo--------------------------oo------------------------------------------------------oo--------------------------oo--------------------------o---------------------------oo--------------------------oo--------------------------oo--------------------------oo------------------------------------------------------oo--------------------------oo--------------------------oo--------------------------o---------------------------oo--------------------------o---------------------------oo----------------------
----XXX----------------------------------------------------XXXX--------------------E--XXXXX-------------------------XX------------------------XXXXX--------------------E--XXXXX--------------------E---XXXX-------------------------XX-------------------------XXXX------------------------XXXX-------------------------X----------------------E----XXX-----------------------------------------------------XXX------------------------XXXX------------------------XXXX------------------------XXXX--------------------E---XXXX--------------------E--XXXXX-----------------------XXXXX-----------------------XXXXXX----------------------XXXXX-----------------------XXXXX-----------------------XXXXX--------------------E---XXXX----------------------------------------------------XXXX------------------------XXXX--------------------E----XXX------------------------XXXX------------------------XXXX-----------------------XXXXXX-------------------E---XXXXX-------------------------------------------XX-------XXX------------------------XXXX-------------------------X---------------------------XXX-------------------------XXX------------------------XXXX------------------------XXXX----------------------------------------------------XXXX-------------------------XXX------------------------XXXX-------------------------X--------------------------XXXX-----------------------------------------------------XX----------------------
-----------------E---------------------------?-----------------------------------------------------------------------------------?-----------------------------------------------------------------------------------E---------------------------E---------------------------?---------------------------?---------------------------E---------------------------?-------------------------------------------------------?---------------------------E-------------------------------------------------------------------------------------------------------------------------------------------------------------------------------------------------------------------------------------------------------------------------------------------------------------------?---------------------------E---------------------------?---------------------------?---------------------------E---------------------------E----------------------------------------------------------------------------------E?---------------------------?---------------------------E---------------------------E---------------------------?---------------------------?---------------------------?---------------------------?---------------------------?---------------------------?---------------------------?---------------------------E---------------------------?---------------------------?---------------------------?---------------------------?----------
-----------oo----XSS----SSS------------ooo---XXS----?------------ooooo---X------SSS------------ooo---ESS----SSS------------ooo---XXS----?--------------ooo---XSS----SSS-------------oo---SSS----SSS------------oo----XXS----SSS------------oo----XXS----SSS-----------Xooo--XXXS----SS-------------ooo---XXS----SSS-------------o----XXS----SSS-----------Xooo---XXS----SSS------------oo----XX-----SS-------------ooo---XXS----SSS------------ooo---XXS----SSS------------ooo---XSS----SSS------------ooo---EXS----SSS----------ooooo---XX-----SSS----------oooo----E------SSS?---------oooo----EX-----SSSS---------ooooo---XX-----SSS------------ooo---XX-----SSSS-----------ooo---ESS----SSS------------ooo---ESS----SSS------------ooo---XXS----SSS-----------Xooo---XXS----?--------------oo----XSS----SSS-----------Xooo---XSS----SSS-----------Xoo----XXS----SSS-----------Xooo---XXS----SSS-----------Xooo---XXS----SSS----------ooooo---E------SSS?---------oooo----E------SSS?-----------oo---XXX-----?-------------Xooo---XXS----?--------------ooo---XXS----S--------------oo----XXS----SS------------Xooo---XXS----S------------oooo----XXS----S------------ooooo---XXS----S-------------Xoo---XXXS----SSS----------oooo---XXX-----?--------------oo---XXXS----SS------------Xooo---XXS----S--------------ooo---XXS----SSS-----------oooo--XXXS----S-------------Xoo---XXXS----S-------------Xoo----XXS----SS------------Xoo---XXXS----S---
--------------------o--------------------------oo-----------------------------------------------------------------------------------o----------------------------------------------------------------------------------oo---------------------------o-----------------------------------------------------------------------------------o------------------------------------------------------oo---------------------------o-------------------------------------------------------o---------------------------o-------------------------------------------------------o---------------------------o---------------------------o---------------------------o---------------------------o-------------------------------------------------------o--------------------------oo---------------------------------------------------------------------------------------------------------------o---------------------------o-------------------------------------------------------o---------------------------o---------------------------o---------------------------------------------------------------------------------------------------------------o---------------------------o------------------------------------------------------oo-------------------------------------------------------o---------------------------o--------------------------oo-------------------------------------------------------------------------------------------
----------------------------------------------------------------SS-S------------------------------------------------------------------------------------------------------------------------------------------------------------------------------------------------------------------------------------------------------------------------------------------------------------------------------------------------------------------------------------------------------------------------------------------------------------S--S------------------------SS--------------------------S---------------------------S-------------------------------------------------------------------------------------------------------------------------------------------------------------------------------------------------------------------------------------------------------------------------------------------------------------------SS-S------------------------SS----------------------------------------------------------------------------------------------------------------------------------------------------------------------------------------------------------------------------------------------------------------------------------------------------------------------------------------------------------------------------------------------------------------------------------------------------------------------------------
--------------------------------------------------------------SoS---------------------------------------------------------------------------------------------------------------------------------------------------------------------------------------------------------------------------------------------------------------------------------------------------------------------------------------------------------------------------------------------------------------------------------------------------------------S---------E---------------SoS---------E---------------SoS---------E-----------------S---------E---------------------------E--------------------------------------------------------------------------X------------------------------------------------------------------------------------------------------------------------------------------------------------------------------------------------SoS---------E---------------SoS---------E-------------------------------------------------------------------------------------------------------------------------------------------------------------------------------------------------------------------------------------------------------------------------------------------------------------------------------------------------------------------------------------------------------------------------------------------------------------------------
-------------XXX----XXX------------------XXX----XXX------------SS----XX--<>-XXX--S?X-X-----------XX-----XXX--X---------------XXX----XXX------------------XXX---XXXX--XX--------------XXX----XXX------------------XXX----XXX--X---------------XXX----XXX------------------XXX---XXXX--XXX-------------XXX---XXXX--XX--------------XXX----XXX------------------XXX----XXX--X--XX-----------XXX----XXX------------------XXX----XXX------------------XXX----XXX------------------XXX----XXX-----XX-----------XXX----XXX--X---------SS----XX--<>-XXX--X?XX-----SSS--------<>-X----E?XXXS----SS----XX--<>-XXX--EXX-------------XX--<>-XXX--E?--------------XX--<>-XXX------------------XX-----XXX------------------XXX----XXX--XX--------------XXX----XXX------------------XXX----XXX------------------XXX----XXX--X---------------XXX----XXX--XX--------------XXX---XXXX--XXX-------------XXX---XXXX--XX--------------XXX----XXX------------SS--------<>-XX---E?X-------SS----XX--<>------E?S-------------XXX----XXX------------------XXX---XXXX--XX--------------XXX---XXXX--XX--------------XXX---XXXX--XXX-------------XXX---XXXX--XXXXX-----------XXX---XXXX--XXX-------------XXX---XXXX--XXX-------------XXX---XXXX--XX-XX-----------XXX---XXXX--XX--------------XXX---XXXX--XX-X------------XXX---XXXX--XX--------------XXX----XXX--XX--------------XXX---XXXX------------------XXX---XXXX--XXX-------------XXX---XXXX--XXX-------------XXX---XXXX--XXX
---o--------------E-----------Eo--------------------------Eo-------------[]------------o-------------<>-----------Eo-------------------------------------------------------o--------------E------------o--------------E------------o---------------------------o---------------------------o-------------------------------------------------------o---------------------------o--------------E------------o---------------------------o---------------------------o---------------------------o--------------E-----------Eo-------------[]-----------oo-------------[]------------o-------------[]-----------Eo-------------[]------------o-------------[]------------o-------------XX------------o--------------E------------o--------------E-----------Eo---------------------------o---------------------------o---------------------------o--------------------------Eo---------------------------o--------------------------oo-------------[]-----------Eo-------------[]-----------Eo--------------E-----------Eo---------------------------o---------------------------o--------------------------Eo--------------------------Eo--------------------------Eo---------------------------o--------------------------Eo---------------------------o--------------------------Eo---------------------------o---------------------------o--------------------------Eo---------------------------o---------------------------o------------------------
--XXXXXX---------<>-----------XXXXX-----------------------XXXXXX---------[]-----------XXXXXX---------[]-----------XXXXX-----------------------XXXXXX----------------------XXXXXX---------<>-----------XXXXX----------<>-----------XXXXX----------<>-----------XXXXXX----------------------XXXXXX----------------------XXXXXX---------<>-----------XXXXXX----------------------XXXXX----------<>-----------XXXXXX----------------------XXXXXX----------------------XXXXXX---------<>-----------XXXXXX---------<>-----------XXXXXX---------[]-----------XXXXX----------[]-----------XXXXX----------[]-----------XXXXXX---------[]-----------XXXXXX---------[]-----------XXXXXX---------[]-----------XXXXXX---------<>-----------XXXXXX---------<>-----------XXXXXX----------------------XXXXXX---------<>-----------XXXXXX----------------------XXXXXX----------------------XXXXXX----------------------XXXXXX----------------------XXXXX----------[]-----------XXXXX----------[]-----------XXXXX----------<>-----------XXXXXX----------------------XXXXXX----------------------XXXXX-----------------------XXXXXX----------------------XXXXX-----------------------XXXXX-----------------------XXXXXX----------------------XXXXX-----------------------XXXXX-----------------------XXXXXX----------------------XXXXXX----------------------XXXXXX----------------------XXXXX-----------------------XXXXXX----------------------XXXXXX--------------------
-----------------[]------------------------------------------------------[]--------------------------[]----------------------------------------------------------------------------------[]--------------------------[]--------------------------[]----------------------------------------------------------------------------------[]------------------------------------------------------[]----------------------------------------------------------------------------------[]--------------------------[]--------------------------[]--------------------------[]--------------------------[]--------------------------[]--------------------------[]--------------------------[]--------------------------[]--------------------------[]------------------------------------------------------[]------------------------------------------------------------------------------------------------------------------------------------------[]--------------------------[]--------------------------[]---------------------------------------------------------------------------------------------------------------------------------------------------------------------------------------------------------------------------------------------------------------------------------------------------------------------------------------------------------------------------------------------------------------------------------------------
-----------XX--XXXXXXXXXXXXX-----------X---XXXX--X-XXXXX-----------XX--XXXXXXXXXXXXX---------------XXXXXXXXXXXXX-----------X---XXXX----XXXXX---------------XXXXXXX---XXXX--------------XXXXXXXX-XXXX---------------XXXXXXX--XXXX---------------XXXXXXX--XXXX---------------XXXX------XXXX--------------XXXX------XXX---------------XXXXXXX---XXX---------------XXXX------XXX---------------XXXXXXX--XXXXX--------------XXXX-XX--XXXXX--------------XXXX-XX--XXXX---------------XXXXXXX--XXXX---------------XXXXXXXX-XXXX-----------XX--XXXXXXXXXXXXX-----------XXXXXXXXXXXXXXXXX-----------XX--XXXXXXXXXXXXX-----------XX--XXXXXXXXXXXXX-----------XXXXXXXXXXXXXXXXX---------------XXXXXXXXXXXXX---------------XXXXXXXX-XXXX---------------XXXXXXXXXXXXX-----------X---XXXX--X-XXXXXX--------------XXXXXXX--XXXXX--------------XXXX------XXX---------------XXXX------XXX---------------XXXX------XXX---------------XXXX-XX--XXXX-----------XXXXXXXXXXXXXXXXX----------XXXXXXXXXXXXXXXXXX----------XXX--XXXX----XXXXX----------------XXX------XXX---------------XXXX------XXX---------------XXXX------XXX---------------XXXX------XXX---------------XXXX------XXX---------------XXXX------XXXX--------------XXXX------XXX---------------XXXX------XXX---------------XXXX------XXX---------------XXXX------XXX---------------XXXX-----XXXX---------------XXXX--X--XXXX---------------XXXX------XXX---------------XXXX------XXX---------------XXXX------XXX
