--------------------------------------------------------------------------------------------------------------------------------------------------------------------------------------------------------------------------------------------------------------------------------------------------------------------------------------------------------------------------------------------------------------------------------------------------------------------------------------------------------------------------------------------------------------------------------------------------------------------------------------------------------------------------------------------------------------------------------------------------------------------------------------------------------------------------------------------------------------------------------------------------------------------------------------------------------------------------------------------------------------------------------------------------------------------------------------------------------------------------------------------------------------------------------------------------------------------------------------------------------------------------------------------------------------------------------------------------------------------------------------------------------------------------------------------------------
--------------------------------------------------------------------------------------------------------------------------------------------------------------------------------------------------------------------------------------------------------------------------------------------------------------------------------------------------------------------------------------------------------------------------------------------------------------------------------------------------------------------------------------------------------------------------------------------------------------------------------------------------------------------------------------------------------------------------------------------------------------------------------------------------------------------------------------------------------------------------------------------------------------------------------------------------------------------------------------------------------------------------------------------------------------------------------------------------------------------------------------------------------------------------------------------------------------------------------------------------------------------------------------------------------------------------------------------------------------------------------------------------------------------------------------------------------
----oo--------------------------oo--------------------------oo--------------------------oo--------------------------oo--------------------------oo--------------------------oo--------------------------oo--------------------------oo--------------------------oo--------------------------oo--------------------------oo--------------------------oo--------------------------o---------------------------oo--------------------------oo--------------------------oo--------------------------oo--------------------------oo--------------------------oo--------------------------oo--------------------------oo--------------------------oo--------------------------oo--------------------------oo--------------------------oo------------------------------------------------------oo--------------------------oo--------------------------oo--------------------------o---------------------------oo--------------------------oo--------------------------oo----------------------------------------------------------------------------------oo--------------------------oo--------------------------o---------------------------oo--------------------------oo------------------------------------------------------oo--------------------------oo----------------------------------------------------------------------------------o---------------------------oo--------------------------oo--------------------------oo----------------------
----XXX------------------------XXXX-----------------------XXXXX--------------------E--XXXXX-------------------------XX-------------------------XXXX-----------------------XXXXX--------------------E---XXXX------------------------XXXX--------------------E----XXX------------------------XXXX------------------------XXXX------------------------XXXX----------------------------------------------------XXXX------------------------XXXX------------------------XXXX-----------------------XXXXX--------------------E--XXXXX--------------------E--XXXXX------------------------XXXX------------------------XXXX-----------------------XXXXX--------------------E---XXXX-----------------------XXXXX-----------------------XXXXXX-------------------E----X--------------------------XXXX------------------------XXXX------------------------XXXX-------------------------X---------------------------XXX-----------------------XXXXX--------------------E---XXXX--------------------------------------------XX-----------------------------------XXX-------------------------XXX-------------------------X--------------------------XXXX-------------------------XXX----------------------------------------------------XXXX-------------------------XXX------------------------------------------------------------------------------------------------------------XXXX-------------------------XXX-------------------------XXX---------------------
-----------------E---------------------------------------------------------------------------------------------------------------E---------------------------E-------------------------------------------------------E-------------------------------------------------------?---------------------------?---------------------------?---------------------------E---------------------------?---------------------------E-------------------------------------------------------?---------------------------E-----------------------------------------------------------------------------------------------------------------------------------------------------------------------------------------------------------------------------------------------------------?---------------------------E-------------------------------------------------------?---------------------------?---------------------------?-----------------------------------------------------------------------------------?---------------------------?---------------------------E---------------------------?---------------------------?---------------------------?---------------------------E---------------------------?---------------------------?---------------------------E---------------------------?---------------------------?---------------------------?---------------------------?---------------------------?---------------------------?----------
-----------ooo---ESSS---S-S------------ooo---EXS----SSS----------ooooo---XX-----SSS------------ooo---EXS----SSS-----------Xooo---ESS----?-------------Xooo---SSS----SSS------------ooo---XXS----SSS-------------oo---XXS----SSS------------oo----XXS----SSS------------ooo---XXS----SS------------Xoo----XXS----SS-------------oo----XXS----SSS------------ooo---XXS----SSS------------ooo---XXS----SS------------oooo---XXS----SS-------------ooo---SSS----SSS------------oo---XXXS----SSS------------ooo---XXS----SSS-----------ooo----EX----SSSS----------ooooo---XX-----SSS----------oooo----E------SSSS---------oooo----XX-----SS-----------oooo----XX-----SSS------------ooo---XSS----SSS------------ooo---ESS----SSS------------oo----X-----SSSS------------ooo---XXS----?---------------oo--XXXS----SSS------------ooo---ESS----SSS------------ooo--XXXS----S--------------ooo---XXS----SSS-----------Xooo---XXS----S------------ooooo---XX-----SSS----------oooo----E------SSSS-----------oo---XXX-----?--------------ooo---XXS----?--------------ooo---XSS----SSS-----------Xooo---XXS----SSS-----------oooo---XXS----S-------------Xoo---XXXS----SSS-----------oooo---XXS----S-------------Xooo---XXS----S-------------Xooo---XXS----SSS------------ooo---XXS----S-------------oooo---XXS----?-------------Xooo---XXS----SS------------Xoo----XXS----S------------oooo----XXS----SS-----------ooooo---XXS----S-------------oooo---XXS----SS--
--------------------o--------------------------oo-------------------------------------------------------o---------------------------o-----------------------------------------------------------------------------------o---------------------------o---------------------------o---------------------------o-------------------------------------------------------o--------------------------oo--------------------------oo---------------------------------------------------------------------------------------------------------------o---------------------------o---------------------------o---------------------------oo--------------------------o-------------------------------------------------------o-------------------------------------------------------o-----------------------------------------------------------------------------------o--------------------------oo-------------------------------------------------------o---------------------------o---------------------------o--------------------------oo-----------------------------------------------------------------------------------o-------------------------------------------------------o---------------------------o-----------------------------------------------------------------------------------o---------------------------o---------------------------o-------------------------------------------------------o-----------------------------------
----------------------------------------------------------------S-----------------------------------------------------------------------------------------------------------------------------------------------------------------------------------------------------------------------------------------------------------------------------------------------------------------------------------------------------------------------------------------------------------------------------------------------------------------------------------------------------------------------S---------------------------S---------------------------SS--------------------------------------------------------------------------------------------------------------------------------------------------------------------------------------------------------------------------------------------------------------------------------------S--S----------------------S-SS----------------------------------------------------------------------------------------------------------------------------------------------------------------------------------------------------------------------------------------------------------------------------------------------------------------------------------------------------------------------------------------------------------------------------------------------------------------------------------
----------------------------------------------------------------S-----------------------------------------------------------------------------------------------------------------------------------------------------------------------------------------------------------------------------------------------------------------------------------------------------------------------------------------------------------------------------------------------------------Q-----------------------------------------------------------------------------------------E---------------SoS---------E---------------SoS-------------------------SoS---------E-----------------------------------------------------------------------------------E--------------------------------------------------------------------------X--------------------------------------------------------------------------------------------------------------S-------------------------SoS---------E-------------------------------------------------------------------------------------------------------------------------------------------------------------------------------------------------------------------------------------------------------------------------------------------------------------------------------------------------------------------------------------------------------------------------------------------------------------------------
-------------XXX----XXX------------------XXX----XXX------------------XX--<>-XXX--XXX-------------XXX----XXX-----XX-----------XXX----XXX------------------XXX----XXX--XX--------------XX-----XXX--XXX-------------XXX----XXX------------------XX-----XXX------------------XXX----XXX------------------XXX---XXXX--XX--------------XXX----XXX--XXX-------------XXX----XXX------------------XXX----XXX-----XX-----------XXX----XXX------------------XXX----XXX------------------XXX---XXXX--XX--------------XXX---XXXX--XX-XX-----------XX-----XXX--XXX-------------XX--<>-XXX--E----S---SSS-----X--<>---------XXX---SSS----XXX----XXX-----XX-----SS----XX--<>-XXX--XXX-------------XXX----XXX------X-----------XX-----XXX--X---------------XX--<>-XXX--X?--------------XXX----XXX------------------XXX---XXXX-----XX-----------XXX----XXXX-XX--------------XXX---XXXX------------------XXX----XXX------------------XXX----XXX-----XX-----SS----XX-----XXX--XXXXXS---SSS--------<>------E?X-------------XXX----XXX------------------XXX----XXX------------------XXX----XXX--XX--------------XXX---XXXX--XXX-------------XXX---XXXX--XX--------------XXX---XXXX--XXXXX-----------XXX---XXXX--XXX-------------XXX----XXX--X---------------XXX---XXXX--XX-XX-----------XXX---XXXX--XXX-------------XXX---XXXX------------------XXX----XXX------------------XXX---XXXX--XXX-------------XXX---XXXX--XXXXX-----------XXX---XXXX--XXX-------------XXX---XXXX--XXX
---o--------------E-----------Eo--------------------------Eo-------------[]------------o--------------E------------o---------------------------o---------------------------o--------------E------------o---------------------------o--------------E------------o---------------------------o---------------------------o--------------E------------o--------------------------Eo--------------------------Eo---------------------------o---------------------------o---------------------------o---------------------------o-------------XX------------o-------------[]------------o-------------[]------------o--------------E-----------Eo-------------[]-----------Eo--------------E------------o-------------<>------------o-------------[]-----------Eo---------------------------o---------------------------o--------------------------Eo---------------------------o---------------------------o---------------------------o-------------<>------------o-------------[]-----------Eo--------------E-----------Eo---------------------------o---------------------------o--------------------------Eo---------------------------o---------------------------o--------------------------Eo---------------------------o---------------------------o--------------------------Eo---------------------------o--------------------------Eo--------------------------Eo--------------------------Eo--------------------------Eo------------------------
--XXXXXX---------<>-----------XXXXX----------<>-----------XXXXXX---------[]-----------XXXXXX---------<>-----------XXXXXX----------------------XXXXXX----------------------XXXXXX---------<>-----------XXXXX----------<>-----------XXXXXX---------<>-----------XXXXXX----------------------XXXXXX----------------------XXXXXX---------<>-----------XXXXXX----------------------XXXXXX----------------------XXXXXX---------<>-----------XXXXXX---------<>-----------XXXXX-----------------------XXXXXX----------------------XXXXXX---------[]-----------XXXXX----------[]-----------XXXXX----------[]-----------XXXXX----------<>-----------XXXXX----------[]-----------XXXXXX---------<>-----------XXXXXX---------[]-----------XXXXXX---------[]-----------XXXXXX----------------------XXXXXX----------------------XXXXXX----------------------XXXXX-----------------------XXXXXX----------------------XXXXXX----------------------XXXXX----------[]-----------XXXXX----------[]-----------XXXXX----------<>-----------XXXXXX----------------------XXXXXX---------<>-----------XXXXXX----------------------XXXXX-----------------------XXXXXX----------------------XXXXXX----------------------XXXXX-----------------------XXXXXX----------------------XXXXX-----------------------XXXXX-----------------------XXXXXX----------------------XXXXXX----------------------XXXXX-----------------------XXXXX-----------------------XXXXXX--------------------
-----------------[]--------------------------[]--------------------------[]--------------------------[]----------------------------------------------------------------------------------[]--------------------------[]--------------------------[]----------------------------------------------------------------------------------[]----------------------------------------------------------------------------------[]--------------------------[]----------------------------------------------------------------------------------[]--------------------------[]--------------------------[]--------------------------[]--------------------------[]--------------------------[]--------------------------[]--------------------------[]--------------------------------------------------------------------------------------------------------------------------------------------------------------------------------------------------[]--------------------------[]--------------------------[]------------------------------------------------------[]-------------------------------------------------------------------------------------------------------------------------------------------------------------------------------------------------------------------------------------------------------------------------------------------------------------------------------------------------------------------------------------
X----------XX--XXXXXXX-XXXXX---------------XXXXXXX--XXXX---------------XXXXXXXXXXXXX---------------XXXXXXXXXXXXX----------------XXX------XXX---------------XXXX------XXX---------------XXXXXXXX-XXXXX----------XX--XXXXXXX-XXXXX---------------XXXXXXXX-XXXX---------------XXXXXXX--XXXX---------------XXXX------XXX---------------XXXXXXX--XXXX---------------XXXX-XX--XXXX---------------XXXX--X--XXXX---------------XXXXXXX--XXXXX--------------XXXXXXX--XXXXX--------------XXXX-----XXXX---------------XXXX-XX---XXX---------------XXXXXXXX-XXXX-----------XX--XXXXXXXXXXXXX----------XXXXXXXXXXXXXXXXXX---------------XXXXXXXXXXXXX-----------XX--XXXXXXXXXXXXX---------------XXXXXXXXXXXXX---------------XXXXXXXXXXXXX---------------XXXXXXXXXXXXX-----------X---XXXX----XXXXXXX-------------XXXX-----XXXX----------------XXXXXX---XXX---------------XXXX-----XXXX---------------XXXX--X---XXX---------------XXXX------XXX---------------XXXXXXXXXXXXX----------XXXXXXXXXXXXXXXXXX-----------XX--XXXX----XXXXX---------------XXXX-----XXXX---------------XXXXXXX---XXX---------------XXXX------XXX---------------XXXX------XXXX--------------XXXX-----XXXX---------------XXXX------XXX---------------XXXX-----XXXX---------------XXXX------XXX---------------XXXX------XXX---------------XXXX-----XXXX---------------XXXX-----XXXX---------------XXXX------XXX---------------XXXX------XXX---------------XXXX------XXX---------------XXXX------XXX
