--------------------------------------------------------------------------------------------------------------------------------------------------------------------------------------------------------------------------------------------------------------------------------------------------------------------------------------------------------------------------------------------------------------------------------------------------------------------------------------------------------------------------------------------------------------------------------------------------------------------------------------------------------------------------------------------------------------------------------------------------------------------------------------------------------------------------------------------------------------------------------------------------------------------------------------------------------------------------------------------------------------------------------------------------------------------------------------------------------------------------------------------------------------------------------------------------------------------------------------------------------------------------------------------------------------------------------------------------------------------------------------------------------------------------------------------------------
--------------------------------------------------------------------------------------------------------------------------------------------------------------------------------------------------------------------------------------------------------------------------------------------------------------------------------------------------------------------------------------------------------------------------------------------------------------------------------------------------------------------------------------------------------------------------------------------------------------------------------------------------------------------------------------------------------------------------------------------------------------------------------------------------------------------------------------------------------------------------------------------------------------------------------------------------------------------------------------------------------------------------------------------------------------------------------------------------------------------------------------------------------------------------------------------------------------------------------------------------------------------------------------------------------------------------------------------------------------------------------------------------------------------------------------------------------
----oo--------------------------oo--------------------------oo--------------------------oo--------------------------oo--------------------------oo--------------------------oo--------------------------oo--------------------------o---------------------------oo--------------------------oo--------------------------o---------------------------oo--------------------------oo--------------------------oo--------------------------oo--------------------------oo--------------------------oo--------------------------oo--------------------------oo--------------------------oo--------------------------oo--------------------------oo--------------------------oo--------------------------oo--------------------------oo------------------------------------------------------oo--------------------------oo--------------------------oo------------------------------------------------------oo--------------------------oo--------------------------oo------------------------------------------------------o---------------------------oo--------------------------oo--------------------------oo--------------------------o---------------------------oo--------------------------oo--------------------------oo--------------------------oo--------------------------oo--------------------------o---------------------------oo------------------------------------------------------oo--------------------------oo----------------------
----XXX------------------------XXXX-----------------------XXXXXX-------------------E--XXXXX------------------------XXXX------------------------XXXX-----------------------XXXXX--------------------E----XXX-----------------------------------------------------XXX-------------------------XX-----------------------------------------------------XXXX------------------------XXXX------------------------XXXX------------------------XXXX------------------------XXXX--------------------E--XXXXX--------------------E--XXXXXX----------------------XXXXX--------------------E---XXXX-----------------------XXXXX-----------------------XXXXXX------------------------XXX-----------------------XXXXX------------------------XXXX-----------------------------------------------------XXX------------------------XXXX-------------------------XXX----------------------------------------------------XXXX-----------------------XXXXXX-------------------E---XXXX-------------------------XXX----------------X------------------------------------XXX------------------------XXXX------------------------XXXX-----------------------------------------------------XXX-------------------------XXX------------------------XXXX-------------------------XXX-------------------------XXX-----------------------------------------------------XXX----------------------------------------------------XXXX-------------------------XX----------------------
-----------------?---------------------------------------------------------------------------------------------------------------?-----------------------------------------------------------------------------------?---------------------------?---------------------------?---------------------------E---------------------------E---------------------------E---------------------------?---------------------------E---------------------------?-------------------------------------------------------------------------------------------------------------------------------------------------------------------------------------------------------------------------------?-----------------------------------------------------------------------------------?-----------------------------------------------------------------------------------E---------------------------?---------------------------?----------------------------------------------------------------------------------E?---------------------------?---------------------------?---------------------------?---------------------------?---------------------------E---------------------------?---------------------------?---------------------------?---------------------------?------X--------------------?---------------------------?---------------------------?---------------------------?---------------------------?---------------------------?----------
-----------ooo--XXXS----?-------------oooo---ESS----SSS----------ooooo---XX-----SSS------------ooo---ES-----SSS------------ooo---XSS----S-S------------ooo---ESS----SSS------------ooo---ESS----SSS------------ooo---XSS----SSS-----------Xooo---XXS----S-S-----------Xoo----XXS----SSS------------ooo---XXS----SSS-----------oooo---XXS----SS------------oooo---XXS----SSS-----------Xooo---XSS----SSS------------oo----XXS----SSS-----------Xooo---XXS----SSS------------oo----XX-----SSS------------ooo---XXS----SSS-------------oo---XX-----SSS------------oo---XXX-----SSS------------ooo---XXS----SS-----------ooooo---EX-----SSS----------ooooo---E------SSS------------ooo---XXS----?-------------oooo---XXS----SSS------------ooo---XX-----SSS------------ooo---XXS----?--------------ooo---XXS----SSS------------ooo---ESS----SSS------------ooo---XXS----SS------------Xooo--XXXS----?-------------oooo---XXS----S------------oooo----XX----SSSS-------------o-----------SSSS-----------oo---XXXX----o-------------Xooo--XXXS----?-------------Xooo---XXS----S------------ooooo--XXXS----S-------------Xoo---XXX-----SS-------------oo---XXXS----SS------------oooo---XXS----?-------------Xooo---XXS----S-------------Xooo--XXXS----SSS----------ooooo--XXX----oS-------------ooo---XXX-----S-------------Xoo---XXXS----?-------------oooo---XXS----S------------ooooo--XXX-----?--------------oo---XXXS----SS------------Xooo---XXS----S---
--------------------o---------------------------o-----------------------------------------------------------------------------------o---------------------------o---------------------------o---------------------------o---------------------------o------------------------------------------------------oo--------------------------oo---------------------------o-------------------------------------------------------o-------------------------------------------------------o--------------------------------------------------------------------------------------------------------------oo---------------------------o-------------------------------------------------------o---------------------------o---------------------------o---------------------------o---------------------------o-------------------------------------------------------o--------------------------oo---------------------------o---------------------------o-------------------------------------------------------o------------------------------------------------------------------------------------------------------------------------------------------oo---------------------------o---------------------------------------------------------------------------------------------------------------o-------------------------------------------------------o---------------------------o---------------------------------------------------------------
-------------------------------------------------------------------S--------------------------------------------------------------------------------------------------------------------------------------------------------------------------------------------------------------------------------------------------------------------------------------------------------------------------------------------------------------------------------------------------------------------------------------------------------------------------------------------------------------------------------------------------------------------------------------------------------------------------------------------------------------------------------------------------------------------------------------------------------------------------------------------------------------------------------------------------------------------S---------------------------S-----------------------------------------------------------------------------------------------------------------------------------------------------------------------------------------------------------------------------------------------------------------------------------------------------------------------------------------------------------------------------------------------------------------------------------------------------------------------------------
----------------------------------------------------------------S----------------------------------------------------------------------------------------------------------------X-------------------------------------------------------------------------------------------------------------------------------------------------------------------------------------------------------------------------------------------------------------------------------------------------------------------XX-----------------------------------E-------------------------------------------------------------------------S---------------------------S---------E-----------------------------------------------------------------------------------------------------------------------------------------------------------------------------------------------------------------------------------------------------------------------------S---------E---------------S-S---------E-------------------------------------------------------------------------------------------------------------------------------------Q-----------------------------------------------------------------------------------------------------------------------------------------------------------------------------------------------------------------------------------------------------------------------------------------------------------------------------------
-------------XXX----XXX------------------XXX----XXX------------------XX-----XXX--X?X-X-----------XX--<>-XXX--XXX-------------XXX----XXX------------------XXX----XXX-----XX-----------XXX----XXX--XX--------------XXX----XXX------------------XXX----XXX--XX--------------XXX----XXX--XX--------------XXX----XXX-----XX-----------XXX----XXX------------------XXX----XXX------------------XXX----XXXX-XX--------------XXX----XXX--XX--------------XXX---XXXX-----XX-----------XX-----XXX--XXX-------------XXX----XXX--XXX-----------------<>-XXX--E-XX-------------------XXX--XXX-------------XXX----XXX-----XX-----------XX--<>-XXX--XX------------------<>-XXX--S?X-------------XXX----XXX-----XX-----------XXX----XXX--XXXXX-----------XXX----XXX------------------XXX----XXX------------------XXX----XXX------------------XXX---XXXX--XXX-------------XXX----XXX------------------XXX----XXX------------------XXX---XXXX--XX--------SS----XX--<>-XXX--E?X-------SS--------<>-----E----------------XXX----XXX------------------XXX---XXXX-----X------------XXX---XXXX--XXXX------------XXX---XXXX--XXX-------------XXX---XXXX--XXXXX-----------XXX---XXXX-----X------------XXX---XXXX--XXX-------------XXX---XXXX--XX--------------XXX---XXXX--XXXXX-----------XXX---XXXX--XXX-------------XXX---XXXX--X--X------------XXX---XXXX--XX--------------XXX---XXXX--X--X------------XXX---XXXX--XX--------------XXX---XXXX------------------XXX---XXXX--XXX
--Eo--------------------------Eo--------------E-----------Eo-------------<>------------o-------------[]-----------Eo--------------------------Eo--------------E------------o--------------E-----------Eo--------------------------Eo---------------------------o--------------------------Eo---------------------------o--------------------------Eo---------------------------o---------------------------o--------------E-----------Eo---------------------------o--------------E------------o--------------E------------o-------------[]------------o-------------<>-----------Eo--------------E------------o-------------[]------------o-------------[]-----------Eo--------------E------------o--------------E------------o--------------E-----------Eo--------------E-----------Eo--------------E------------o---------------------------o--------------------------Eo--------------------------Eo---------------------------o-------------[]------------o-------------[]----<>-----Eo---------------------------o--------------------------Eo--------------------------Eo---------------------------o---------------------------o--------------------------Eo---------------------------o---------------------------o--------------------------Eo--------------------------Eo--------------------------Eo--------------------------Eo--------------------------Eo---------------------------o--------------------------Eo------------------------
--XXXXX-----------------------XXXXX----------<>-----------XXXXXX---------[]-----------XXXXXX---------[]-----------XXXXXX---------<>-----------XXXXXX---------<>-----------XXXXXX---------<>-----------XXXXXX----------------------XXXXXX----------------------XXXXXX----------------------XXXXXX---------<>-----------XXXXX-----------------------XXXXXX----------------------XXXXXX----------------------XXXXXX---------<>-----------XXXXXX----------------------XXXXXX---------<>-----------XXXXXX---------<>-----------XXXXXX---------[]-----------XXXXX----------[]-----------XXXXXX---------<>-----------XXXXX----------[]-----------XXXXX----------[]-----------XXXXXX---------<>-----------XXXXXX---------<>-----------XXXXX----------<>-----------XXXXX----------<>-----------XXXXXX---------<>-----------XXXXX-----------------------XXXXXX----------------------XXXXXX----------------------XXXXXX----------------------XXXXX----------[]-----------XXXXX----------[]----[]-----XXXXX----------<>-----------XXXXXX----------------------XXXXXX----------------------XXXXX-----------------------XXXXX-----------------------XXXXX-----------------------XXXXXX----------------------XXXXXX----------------------XXXXXX----------------------XXXXX-----------------------XXXXX-----------------------XXXXXX----------------------XXXXX-----------------------XXXXX-----------------------XXXXX-----------------------XXXXXX--------------------
---------------------------------------------[]--------------------------[]--------------------------[]--------------------------[]--------------------------[]--------------------------[]--------------------------------------------------------------------------------------------------------------[]--------------------------------------------------------------------------------------------------------------[]------------------------------------------------------[]--------------------------[]--------------------------[]--------------------------[]--------------------------[]--------------------------[]--------------------------[]--------------------------[]--------------------------[]--------------------------[]--------------------------[]--------------------------[]------------------------------------------------------------------------------------------------------------------------------------------[]------------------E-------[]----[]--------------------[]---------------------------------------------------------------------------------------------------------------------------------------------------------------------------------------------------------------------------------------------------------------------------------------------------------------------------------------------------------------------------------------------------------------------------------------------
-----------X---XXXX----XXXXX-----------XX--XXXXXXXXXXXXX---------------XXXXXXXXXXXXX---------------XXXXXXXXXXXXX---------------XXXXXXX-XXXXX---------------XXXXXXXXXXXXX---------------XXXXXXXX-XXXXX----------X---XXXX-XX-XXXXX---------------XXXX-----XXXX---------------XXXX------XXX---------------XXXXXXX--XXXX---------------XXXX-XX---XXX---------------XXXX-XX--XXXXX--------------XXXX------XXX---------------XXXXXXX--XXXX---------------XXXX-----XXXX---------------XXXXXXXX-XXXX---------------XXXXXXXX--XXX---------------XXXXXXXXXXXXX---------------XXXXXXXX--XXX---------------XXXXXXXXXXXXX---------------XXXXXXXXXXXXX-----------XXXXXXXXXXXXXXXXX-----------XX--XXXXXXXXXXXXX---------------XXXXXXXX-XXXX---------------XXXXXXXXXXXXX-----------X---XXXX--X-XXXXX---------------XXXXXXXXXXXXX---------------XXXXXXX---XXX---------------XXXX-----XXXX---------------XXXXXXXXXXXXX---------------XXXX------XXX-----------XXX-XXXXXXXXXXXXX----------XXXXXXXXXXXXXXXXXX----------XXX--XXXX----XXXXX---------------XXXX------XXX----------------XXX------XXX----------------XXX------XXX---------------XXXX------XXX---------------XXXX-----XXXX----------------XXX------XXX---------------XXXX------XXX---------------XXXX------XXX----------------XXX------XXX---------------XXXX-----XXXX---------------XXXX------XXX---------------XXXX------XXX---------------XXXX------XXX---------------XXXX------XXX---------------XXXX------XXX
