--------------------------------------------------------------------------------------------------------------------------------------------------------------------------------------------------------------------------------------------------------------------------------------------------------------------------------------------------------------------------------------------------------------------------------------------------------------------------------------------------------------------------------------------------------------------------------------------------------------------------------------------------------------------------------------------------------------------------------------------------------------------------------------------------------------------------------------------------------------------------------------------------------------------------------------------------------------------------------------------------------------------------------------------------------------------------------------------------------------------------------------------------------------------------------------------------------------------------------------------------------------------------------------------------------------------------------------------------------------------------------------------------------------------------------------------------------
--------------------------------------------------------------------------------------------------------------------------------------------------------------------------------------------------------------------------------------------------------------------------------------------------------------------------------------------------------------------------------------------------------------------------------------------------------------------------------------------------------------------------------------------------------------------------------------------------------------------------------------------------------------------------------------------------------------------------------------------------------------------------------------------------------------------------------------------------------------------------------------------------------------------------------------------------------------------------------------------------------------------------------------------------------------------------------------------------------------------------------------------------------------------------------------------------------------------------------------------------------------------------------------------------------------------------------------------------------------------------------------------------------------------------------------------------------
----oo--------------------------oo--------------------------oo--------------------------oo--------------------------o---------------------------oo--------------------------oo------------------------------------------------------oo--------------------------o---------------------------o---------------------------oo--------------------------oo--------------------------oo--------------------------oo--------------------------oo--------------------------oo--------------------------oo--------------------------oo--------------------------oo--------------------------oo--------------------------oo--------------------------oo--------------------------oo--------------------------oo--------------------------oo----------------------------------------------o-----------------------------------oo--------------------------oo--------------------------o---------------------------oo--------------------------oo--------------------------oo---------------------------o------------------------------------------------------oo--------------------------oo--------------------------oo--------------------------oo--------------------------oo--------------------------oo--------------------------o---------------------------oo--------------------------o---------------------------oo--------------------------o---------------------------oo--------------------------oo--------------------------oo----------------------
----XXX-----------------------XXXXX-----------------------XXXXXX-------------------E---XXXX---------------------------------------------------XXXXX--------------------E---XXXX---------------------------------------------------XXXXX-----------------------------------------------------X--------------------------XXXX-------------------------XXX-------------------------X--------------------------XXXX-------------------------XX-------------------------XXXX--------------------E--XXXXX--------------------E--XXXXXX-----------------------XXXX-----------------------XXXXX-----------------------XXXXX-----------------------XXXXX--------------------E---XXXX-----------------------XXXXX-----------------------XXXXX--------------------------------------------XXX--------------------------------XXXXX------------------------XXXX-----------------------------------------------------X-------------------------XXXXX--------------------E---XXXX-------------------------XXX----------------X------------------------------------XXX------------------------XXXX-------------------------XXX-------------------------XXX------------------------XXXX-------------------------XX-----------------------------------------------------XXXX-------------------------X--------------------------XXXX-----------------------------------------------------XXX------------------------XXXX------------------------XXXX---------------------
-----------------E-----------------------------------------------------------------------------------?---------------------------E-----------------------------------------------------------------------------------E---------------------------E---------------------------?---------------------------?---------------------------?---------------------------?---------------------------E---------------------------E---------------------------?------------------------------------------------------------------------------------------------------------------------------------------------------------------------------------------------------------------------------------------------------------------------------------------------------------------E?---------------------------?-------------------------------------------------------E---------------------------?---------------------------?-----------------------------------------------------------------------------------?---------------------------?---------------------------?---------------------------?---------------------------?---------------------------?---------------------------?---------------------------?---------------------------?---------------------------?---------------------------E---------------------------?---------------------------?---------------------------?------X--------------------E---------------------------?----------
-----------ooo---XXS----S-------------ooo----EX-----SSS------------ooo---ES----SSSS------------ooo---XSS----S-S------------ooo---XXS----SSS------------ooo---SSS----SSS------------ooo---ESS----SSS------------ooo--XXX-----?---------------o---XXXS----SSS-----------Xooo--XXXS----S--------------ooo---XXS----SS-----------ooooo---XXS----S--------------oo---XXXS----SS------------ooo----XXS----SS-------------ooo---XSS----SSS------------ooo---XXS----S--------------ooo---XXS----SSS------------ooo---SSS----SSS----------ooooo---XX-----SSS----------ooooo---XX-----SSSS---------oooo----E------SSSS---------oooo----XX-----SSS----------oooo----XX-----SSS-------------oo---ESS----SSS------------ooo---ESS----SSS----------ooooo---XX-----SSS------------ooo--XXX-------------------Xooo---XXS----S--------------ooo---ESS----SSS------------ooo---XXS----SSS-----------Xooo---XXS----SS------------Xooo---SSSS---SSS----------ooooo---XX-----SSS------------oo-----------SSSS-----------ooo--XXXS----?-------------Xooo--XXXS----S-------------Xooo---XXS----S-------------Xooo---XSS----SSS----------ooooo---XXS----S-------------Xooo---XXS----S-------------Xooo--XXXS----S--------------oo---XXXS----S-------------Xooo---XXS----?--------------ooo--XXX-----S------------oooo---XXX-----SS------------Xoo---XXXS----S-------------Xoo---XXXS----S------------ooooo---XXS----S-------------Xoo----XXS----SSS----------ooooo--XXX-----S---
--------------------o---------------------------o-------------------------------------------------------o---------------------------o----------------------------------------------------------------------------------ooo------------------------------------------------------o---------------------------o------------------------------------------------------oo-------------------------------------------------------o---------------------------o---------------------------o-----------------------------------------------------------------------------------o---------------------------o---------------------------o---------------------------o---------------------------o---------------------------o---------------------------o---------------------------oo-------------------------oo--------------------------oo---------------------------o---------------------------o-------------------------------------------------------o-------------------------------------------------------o---------------------------o-------------------------------------------------------------------------------------------------------------------------------------------------------------------------------------------------------------------------------o---------------------------o---------------------------o---------------------------------------------------------------------------------------------------------------o-------
------------------------------------------------------------------------------------------------------------------------------------------------------------------------------------------------------------------------------------------------------------------------------------------------------------------------------------------------------------------------------------------------------------------------------------------------------------------------------------------------------------------------------------------------------------SSSS------------------------S---------------------------S---------------------------S---------------------------------------------------------------------------------------------------------------------------------------------------------------------------------------------------------------------------------------------------------------------------------------S---------------------------SS----------------------------------------------------------------------------------------------------------------------------------------------------------------------------------------------------------------------------------------------------------------------------------------------------------------------------------------------------------------------------------------------------------------------------------------------------------------------------------
-----------------------------------------------------------------------------------------------------------------------------------------------------?--------------------------------------------------------------------------------------Q-------------------------------------------------------------------------------------------------------------------------------------------------------------------------------------------------------------------------------------------------------------------------------------------------------------SoS---------E---------------SoS---------E---------------SoS---------E---------------------------E-----------------------------------------------------------------------------------------------------------------------------------------------------------------------------------------------------------------------------------------------------------------------------S-------------------------SoS---------E-------------------------------------------------------------------------------------------------------------------------------------------------------------------------------------------------------------------------------------------------X-----------------------------------------------------------------------------------------------------------------------------------------------------------------------------------------------------------------------
-------------XXX----XXX-----XX-----------XX-----XXX--XXX-X-----------XX--<>-XXX--XXX-------------XXX----XXX------------------XXX----XXX------------------XX-----XXX--XX--------------XXX----XXX-----XX-----------XXXX---XXX------------------XX----XXXX------------------XXX---XXXX------------------XXX---XXXX------------------XXX---XXXX--XXX-------------XXX---XXXX-----XX-----------XXX---XXXX--XXXXX-----------XXX----XXX------------------XXX---XXXX------------------XXX----XXX------------------XXX----XXX--XX-XX-----------XX-----XXX--XXXXX----SSS----XX--<>-XXX--E--XXS---SSS----XX--<>---------XX-----SS----XX--<>-XXX--EXXXX-----S-----XX--<>-XXX--XXXXX-----------XXX----XXX------------------XX-----XXX------------------XX--<>-XXX--XX--------------XXX----XXX------------------XXX----XXX-----XX-----------XXX----XXX--X---------------XXX----XXX--X---------------XXX---XXXX-----XX-----------XXX---XXXXXXXX-XX-----SS----XX--<>-XXX--XXX--S---SSS--------<>--------S-------------XXX---XXXX------------------XXX---XXXX------------------XXX---XXXX--XXX-------------XXX---XXXX--XXXX------------XXX---XXXX--XXX-------------XXX---XXXX--XXX-------------XXX---XXXX--XXX-------------XXX---XXXX-----XXX----------XXX---XXXXX-XXX-------------XXX----XXX------------------XXX---XXXX--XXX-------------XXX---XXXX--X---------------XXX---XXXX--XX-XX-----------XXX---XXXX--XXX-------------XXX---XXXX--XXX-------------XXX---XXXX-----
--Eo--------------E------------o-------------<>--------------------------[]-----------Eo---------------------------o---------------------------o--------------E------------o--------------E------------o---------------------------o--------------------------Eo---------------------------o--------------------------Eo---------------------------o---------------------------o---------------------------o--------------------------Eo---------------------------o--------------E------------o--------------E------------o-------------<>-----------oo-------------[]------------o-------------[]------------o-------------[]-----------Eo-------------[]------------o-------------<>------------o-------------<>-----------Eo-------------[]-----------Eo--------------------------Eo---------------------------o---------------------------o--------------------------Eo---------------------------o---------------------------o-------------[]--------------------------[]-----E-----Eo--------------------------Eo--------------------------Eo---------------------------o--------------------------Eo---------------------------o---------------------------o---------------------------o---------------------------o--------------------------Eo--------------E-----------Eo--------------------------Eo---------------------------o--------------------------Eo---------------------------o--------------------------Eo------------------------
--XXXXX----------<>-----------XXXXXX---------[]-----------XXXXXX---------[]-----------XXXXXX----------------------XXXXXX----------------------XXXXXX---------<>-----------XXXXXX---------<>-----------XXXXXX----------------------XXXXX----------<>-----------XXXXXX----------------------XXXXXX----------------------XXXXX-----------------------XXXXX-----------------------XXXXX-----------------------XXXXXX----------------------XXXXX-----------------------XXXXXX---------<>-----------XXXXXX---------<>-----------XXXXXX---------[]-----------XXXXX----------[]-----------XXXXX----------[]----<>-----XXXXX----------[]-----------XXXXX----------[]-----------XXXXXX---------[]-----E-----XXXXXX---------[]-----------XXXXXX---------[]-----------XXXXX-----------------------XXXXXX----------------------XXXXXX----------------------XXXXXX----------------------XXXXX-----------------------XXXXXX----------------------XXXXX----------[]-----------XXXX-----------[]----<>-----XXXXX-----------------------XXXXXX----------------------XXXXXX----------------------XXXXXX----------------------XXXXXX----------------------XXXXXX----------------------XXXXXX----------------------XXXXXX----------------------XXXXXX----------------------XXXXX----------<>-----------XXXXX-----------------------XXXXX-----------------------XXXXXX----------------------XXXXXX----------------------XXXXXX----------------------XXXXX---------------------
-----------------[]--------------------------[]--------------------------[]---------------------------X------------------------------------------------------[]--------------------------[]------------------------------------------------------[]------------------------------------------------------------------------------------------------------------------------------------------------------------------------------------------------------------------------------[]--------------------------[]--------------------------[]--------------------------[]--------------------------[]----[]--------------------[]--------------------------[]--------------------------[]--------------------------[]--------------------------[]--------------------------------------------------------------------------------------------------------------------------------------------------------------------------------------------------[]--------------------------[]----[]--------------------------------------------------------------------------------------------------------------------------------------------------------------------------------------------------------------------------------------------------------------------------------[]---------------------------------------------------------------------------------------------------------------------------------------------------------------------------------
----------XXX--XXXXXXXXXXXXX---------------XXXXXXXX-XXXX---------------XXXXXXXXXXXXX---------------XXXX-XX-XXXXX---------------XXXX------XXX---------------XXXXXXXX-XXXXX--------------XXXXXXXXXXXXX----------------XXX-XXXXXXXXX--------------XXXXXXX--XXXX---------------XXXX------XXX---------------XXXX-----XXXX---------------XXXX------XXX---------------XXXX------XXX---------------XXXX------XXX---------------XXXXXXX---XXX---------------XXXX-----XXXX---------------XXXXXXXX-XXXX---------------XXXXXXX--XXXX---------------XXXXXXXXXXXXX-----------XX--XXXXXXXXXXXXX----------XXXXXXXXXXXXXXXXXX-----------XX--XXXXXXXXXXXXX-----------XX--XXXXXXXXXXXXX---------------XXXXXXXXXXXXX---------------XXXXXXXXXXXXX---------------XXXXXXXXXXXXX-----------X---XXXX----XXXXX---------------XXXX----XXXXX---------------XXXXXXX---XXX---------------XXXX------XXX---------------XXXX------XXX-----------------XX------XXX---------------XXXXXXXXXXXXX----------XXXXXXXXXXXXXXXXXX-----------XX--XXXX-----XXXX----------------XXX-----XXXX---------------XXXX------XXX---------------XXXX------XXX---------------XXXX------XXX---------------XXXX------XXX---------------XXXX------XXX---------------XXXX------XXX--------------------------XX-----------X---XXXXXXX-XXXXX---------------XXXX------XXX---------------XXXX-----XXXX----------------XXX------XXX---------------XXXX------XXX---------------XXXX------XXX---------------XXXX------XXX
