--------------------------------------------------------------------------------------------------------------------------------------------------------------------------------------------------------------------------------------------------------------------------------------------------------------------------------------------------------------------------------------------------------------------------------------------------------------------------------------------------------------------------------------------------------------------------------------------------------------------------------------------------------------------------------------------------------------------------------------------------------------------------------------------------------------------------------------------------------------------------------------------------------------------------------------------------------------------------------------------------------------------------------------------------------------------------------------------------------------------------------------------------------------------------------------------------------------------------------------------------------------------------------------------------------------------------------------------------------------------------------------------------------------------------------------------------------
--------------------------------------------------------------------------------------------------------------------------------------------------------------------------------------------------------------------------------------------------------------------------------------------------------------------------------------------------------------------------------------------------------------------------------------------------------------------------------------------------------------------------------------------------------------------------------------------------------------------------------------------------------------------------------------------------------------------------------------------------------------------------------------------------------------------------------------------------------------------------------------------------------------------------------------------------------------------------------------------------------------------------------------------------------------------------------------------------------------------------------------------------------------------------------------------------------------------------------------------------------------------------------------------------------------------------------------------------------------------------------------------------------------------------------------------------------
----oo--------------------------oo--------------------------oo--------------------------oo--------------------------oo--------------------------oo--------------------------oo------------------------------------------------------oo--------------------------o---------------------------oo--------------------------o-------------------------------------------------------oo--------------------------oo--------------------------oo--------------------------oo--------------------------oo--------------------------oo--------------------------oo--------------------------oo--------------------------oo--------------------------oo--------------------------oo--------------------------o---------------------------oo--------------------------oo--------------------------o---------------------------oo--------------------------oo--------------------------oo--------------------------oo--------------------------oo--------------------------oo----------------------------------------------------------------------------------o-------------------------------------------------------oo--------------------------oo------------------------------------------------------oo--------------------------oo--------------------------oo--------------------------oo--------------------------o---------------------------oo--------------------------oo--------------------------oo--------------------------------------------------
---XXXX-------------------------XXX-----------------------XXXXX--------------------E--XXXXX-------------------------XXX-------------------------XX-------------------------XXXX--------------------E-------------------------------XXXX----------------------------------------------------XXXX--------------------------------------------------------------------------------XXXX------------------------XXXX-------------------------XXX------------------------XXXX------------------------XXXX--------------------E---XXXX--------------------E--XXXXX--------------------E---XXXX-----------------------XXXXX-----------------------XXXXXX-------------------E--XXXXXX-------------------E----XXX-----------------------XXXXX-------------------------XXX----------------------------------------------------XXXX--------------------E---XXXX-------------------------XXX-------------------------XXX-----------------------XXXXX--------------------E--XXXXX----------------------------------------------------------------------------------------------------------------------------------------XXXX------------------------XXXX----------------------------------------------------XXXX------------------------XXXX-------------------------XXX------------------------XXXX-------------------------X--------------------------XXXX----------------X--------XXX------------------------XXXX-------------------------------------------------
-----------------E---------------------------E-----------------------------------------------------------------------------------?---------------------------E-------------------------------------------------------?---------------------------E---------------------------E---------------------------?---------------------------?---------------------------?---------------------------E---------------------------?---------------------------?---------------------------E-------------------------------------------------------------------------------------------------------------------------------------------------------------------------------------------------------------------------------?-------------------------------------------------------?---------------------------E-------------------------------------------------------E---------------------------?---------------------------?-----------------------------------------------------------------------------------?---------------------------?---------------------------E---------------------------?---------------------------?---------------------------?---------------------------?---------------------------?---------------------------E---------------------------?---------------------------E---------------------------?---------------------------?---------------------------?---------------------------?---------------------------?----------
-----------------XX-----SSS------------ooo---ESS----?------------ooooo---XX-----SSS------------ooo---ESS----SSS-----------X-oo---XXS----SSS-----------Xooo---XXS----SSS------------ooo---XSS----SSS------------ooo---XXS----?--------------ooo---XXS----SSS------------oo----XXS----SSS------------ooo---XXS----SSS-----------Xoo----XXS----SSS------------oo---XXXS----S-------------oooo---XXS----SS-------------oo---XXX-----SSS-----------Xooo---XXS----SSS------------ooo---XXS----SSS-----------Xooo---SSS----SSS-------------oo---XXS----SSS----------oooo----XX-----SSS----------ooooo---XX-----SSS?-----------ooo---ESS----SSS----------ooooo---E------SSS------------ooo---E------SSS------------ooo---ESS----?------------oooo----XX-----SSS?----------Xooo---XXS----?--------------ooo---XXS----S--------------ooo---ESS----SSS------------ooo---XSS----S-------------Xooo---XXS----S--------------ooo--XXXS----SSS----------oooo----XX-----SSS----------oooo----E------SSS?-----------ooo--XXXS----?-------------Xooo--XXXS----?--------------ooo---XXS----SS------------Xooo--XXXX----?------------oooo---XXXS----SS------------ooo---XXXS----SSS-----------Xoo---XXX-----S-------------Xooo---XXS----S--------------oo----XXS----SS------------oooo---XXS----S--------------ooo---XXS----SSS-----------Xooo---XXS----?--------------ooo--XXXS----S-------------oooo---XXS----S-------------Xooo---XXS----SS------------Xooo--XXX-----S---
--------------------o---------------------------o---------------------------o-------------------------------------------------------o---------------------------o------------------------------------------------------oo---------------------------o---------------------------o----------------------------------------------------------------------------------oo---------------------------o---------------------------o---------------------------o---------------------------o------------------------------------------------------oo---------------------------o---------------------------o---------------------------o-----------------------------------------------------------------------------------o---------------------------o---------------------------o---------------------------o---------------------------o--------------------------oo---------------------------o---------------------------o-------------------------------------------------------o--------------------------ooo------------------------------------------------------o--------------------------oo---------------------------o------------------------------------------------------oo-----------------------------------------------------------------------------------------------------------------------------------------------------------------------------------------------------------------------------------------------------------o-------
------------------------------------------------------------------------------------------------------------------------------------------------------------------------------------------------------------------------------------------------------------------------------------------------------------------------------------------------------------------------------------------------------------------------------------------------------------------------------------------------------------------------------------------------------------S---------------------------S--S----------------------------------------------------S---------------------------------------------------------------------------------------------------------------------------------------------------------------------------------------------------------------------------------------------------------------------------------------S---------------------------S-----------------------------------------------------------------------------------------------------------------------------------------------------------------------------------------------------------------------------------------------------------------------------------------------------------------------------------------------------------------------------------------------------------------------------------------------------------------------------------
----------------------------------------------------------------S---------E-----------------------------------------------------------------------------------------------------------------------------------------------------------------------------------------------------------------------------------------------------------------------------------------------------------------------------------------Q------------------------------------------------------------------------------------------------------------X--------------------------S---------------------------S---------E---------------------------------------------S---------E--------------------------------------------------------------------------------------------------------------------------------------------------------------X--------------------------X-----------------------------------------------------------------------------------S---------E----------------oS---------E-------------------------------------------------------------------------------------------------------------------------------------------------------------------------------------------------------------------------------------------------------------------------------------------------------------------------------------------------------------------------------------------------------------------------------------------------------------------------
-------------XX--<>-XXX--XXX-------------XXX----XXX------------------XX--<>-XXX--XXXXX-----------XXX----XXX--XX--------------XXX----XXX------------------XXX----XXX--XX--------------XXX----XXX------------------XXX----XXX------------------XXX----XXX--XX--------------XXX---XXXX--XXX-------------XXX---XXXX--XX--------------XXX----XXX--XX-XX-----------XXX---XXXX------------------XXX---XXXX--XX--------------XXX---XXXX------------------XXX----XXX--X---X-----------XXX---XXXX--XX--------------XXX----XXXX-XX--X-----------XXX----XXX-----X------------XX--<>-XXX--XXXXX-----SS----XX--<>-XXX--E---------------XXX----XXX------------SS----XX--<>-XXX--X?XXX-----------XX--<>-XXX--XXX-------------XXX----XXX-----XX-----------XX--<>-XXX--XXX-------------XXX----XXX------------------XXX----XXX------------------XXX----XXX--X---X-----------XXX---XXXX------------------XXX----XXX------------------XXX---XXXX------------SS----XX--<>-XXX--X?XXX-----SS----XX--<>------E-X-------------XXX----XXX------------------XXX---XXXX--XX-XX-----------XXX---XXXX------------------XXX---XXXX------------------XXX---XXXX--XX--------------XXX---XXXX--XXXXX-----------XXX---XXXX------------------XXX---XXXX--XX-XX-----------XXX---XXXX--XXX-------------XXX---XXXX--XXX-------------XXX----XXX--XXX-------------XXX---XXXX--XXX-------------XXX---XXXX--XXXX------------XXX---XXXX--XXXX------------XXX---XXXX--XX--------------XXX---XXXX-----
---o-------------[]-----------Eo--------------------------Eo-------------[]------------o--------------E------------o--------------E------------o---------------------------o--------------E-----------Eo---------------------------o--------------------------Eo---------------------------o---------------------------o---------------------------o--------------------------Eo---------------------------o--------------E-----------Eo---------------------------o---------------------------o------------------------------------------E-----------Eo-------------[]-----------oo-------------[]------------o-------------<>-----------Eo-------------[]------------o-------------[]-----------Eo--------------E------------o-------------[]-----------Eo--------------------------Eo---------------------------o--------------E------------o--------------------------Eo---------------------------o---------------------------o-------------[]------------o-------------[]-----------Eo--------------------------Eo---------------------------o--------------------------Eo--------------------------Eo--------------------------Eo---------------------------o--------------------------Eo---------------------------o--------------------------Eo---------------------------o--------------------------Eo---------------------------o--------------------------Eo---------------------------o--------------------------Eo------------------------
--XXXXXX---------[]-----------XXXXXX----------------------XXXXX----------[]-----------XXXXXX---------<>-----------XXXXXX---------<>-----------XXXXXX----------------------XXXXXX---------<>-----------XXXXX-----------------------XXXXXX----------------------XXXXXX----------------------XXXXXX----------------------XXXXXX----------------------XXXXXX----------------------XXXXX-----------------------XXXXX----------<>-----------XXXXXX----------------------XXXXXX----------------------XXXXXX----------------------XXXXXX---------<>-----------XXXXX----------[]-----------XXXXX----------[]-----------XXXXXX---------[]-----------XXXXXX---------[]-----------XXXXXX---------[]-----------XXXXXX---------<>-----------XXXXX----------[]-----------XXXXXX----------------------XXXXX-----------------------XXXXXX---------<>-----------XXXXXX----------------------XXXXXX----------------------XXXXXX----------------------XXXXX----------[]-----------XXXXX----------[]-----------XXXXX-----------------------XXXXXX----------------------XXXXXX----------------------XXXXXX----------------------XXXXX----------<>-----------XXXXX-----------------------XXXXXX----------------------XXXXXX----------------------XXXXXX----------------------XXXXX-----------------------XXXXXX---------<>-----------XXXXXX----------------------XXXXX-----------------------XXXXXX----------------------XXXXXX----------------------XXXXX---------------------
-----------------[]------------------------------------------------------[]--------------------------[]--------------------------[]------------------------------------------------------[]------------------------------------------------------------------------------------------------------------------------------------------------------------------------------------------------------------------------------[]--------------------------------------------------------------------------------------------------------------[]--------------------------[]--------------------------[]--------------------------[]--------------------------[]--------------------------[]--------------------------[]--------------------------[]----------------------------------------------------------------------------------[]--------------------------------------------------------------------------------------------------------------[]--------------------------[]------------------------------------------------------------------------------------------------------------------------------------------[]----------------------------------------------------------------------------------------------------------------------------------------------------------------------[]-----------------------------------------------------------------------------------------------------------------------------------------------------
----------XXX--XXXXXXXXXXXXX---------------XXXX-----XXXX------------X--XXXXXXXXXXXXX---------------XXXXXXXX-XXXXX----------X---XXXXXXXXXXXXX---------------XXXX------XXX---------------XXXXXXXX-XXXX-----------X---XXXX----XXXXX---------------XXXX------XXX---------------XXXX-X----XXX---------------XXXX------XXX---------------XXXX------XXX---------------XXXX------XXX---------------XXXX------XXX---------------XXXXXXXXXXXXX---------------XXXX-X---XXXX---------------XXXX-XX---XXX---------------XXXXXX----XXX---------------XXXXXXXX-XXXX---------------XXXXXXXXXXXXX-----------XX--XXXXXXXXXXXXX---------------XXXXXXXXXXXXX-----------XXX-XXXXXXXXXXXXX---------------XXXXXXXX-XXXXX----------XX--XXXXXXXXXXXXX---------------XXXXXXXXXXXXX-----------X---XXXX----XXXXX---------------XXXX-XX--XXXX---------------XXXXXXXX-XXXX----------------XXX------XXX---------------XXXX-----XXXX---------------XXXXXXX--XXXX-----------XX--XXXXXXXXXXXXX----------XXXXXXXXXXXXXXXXXX-----------X---XXXX----XXXXX----------------XXX------XXX----------------XXX------XXX----------------XXX-----XXXX---------------XXXX-----XXXX---------------XXXX------XXX---------------XXXX------XXX---------------XXXX------XXX---------------XXXX------XXX---------------XXXX------XXX---------------XXXXXXX---XXX----------------XXX------XXX---------------XXXX------XXX---------------XXXX------XXX----------------XXX------XXX---------------XXXX------XXX
