--------------------------------------------------------------------------------------------------------------------------------------------------------------------------------------------------------------------------------------------------------------------------------------------------------------------------------------------------------------------------------------------------------------------------------------------------------------------------------------------------------------------------------------------------------------------------------------------------------------------------------------------------------------------------------------------------------------------------------------------------------------------------------------------------------------------------------------------------------------------------------------------------------------------------------------------------------------------------------------------------------------------------------------------------------------------------------------------------------------------------------------------------------------------------------------------------------------------------------------------------------------------------------------------------------------------------------------------------------------------------------------------------------------------------------------------------------
--------------------------------------------------------------------------------------------------------------------------------------------------------------------------------------------------------------------------------------------------------------------------------------------------------------------------------------------------------------------------------------------------------------------------------------------------------------------------------------------------------------------------------------------------------------------------------------------------------------------------------------------------------------------------------------------------------------------------------------------------------------------------------------------------------------------------------------------------------------------------------------------------------------------------------------------------------------------------------------------------------------------------------------------------------------------------------------------------------------------------------------------------------------------------------------------------------------------------------------------------------------------------------------------------------------------------------------------------------------------------------------------------------------------------------------------------------
----oo------------------------------------------------------oo--------------------------oo--------------------------oo--------------------------oo--------------------------oo--------------------------oo--------------------------oo--------------------------o---------------------------oo--------------------------oo--------------------------oo--------------------------o---------------------------oo--------------------------oo--------------------------oo--------------------------oo--------------------------oo--------------------------oo--------------------------oo--------------------------oo--------------------------oo--------------------------oo--------------------------oo--------------------------oo--------------------------o---------------------------oo--------------------------oo--------------------------oo------------------------------------------------------oo--------------------------oo--------------------------oo--------------------------oo--------------------------oo--------------------------o---------------------------oo------------------------------------------------------oo--------------------------oo--------------------------oo--------------------------oo--------------------------oo--------------------------o---------------------------oo--------------------------oo--------------------------oo--------------------------oo--------------------------o-----------------------
----XXX---------------------------------------------------XXXXX------------------------XXXX-------------------------XXX------------------------XXXX--------------------E--XXXXX------------------------XXXX------------------------XXXX-------------------------X--------------------------XXXX--------------------E----XXX------------------------XXXX----------------------------------------------------XXXX------------------------XXXX------------------------XXXX-----------------------XXXXX--------------------E--XXXXXX-------------------E---XXXXX----------------------XXXXX-----------------------XXXXX--------------------E---XXXX-----------------------XXXXX-----------------------XXXXXX------------------------XXX---------------------------------------------------XXXXX--------------------E----XXX------------------------XXXX--------------------E-------------------------------XXXX------------------------XXXXX----------------------XXXXX-------------------------XXX----------------XX-------XXX----------------------------------------------------XXXX----------------------------------------------------XXXX------------------------XXXX-------------------------XXX-------------------------XX--------------------------XXX-------------------------X---------------------------XXX-------------------------XXX----------------X-------XXXX-------------------------X---------------------------------------------------
-----------------?---------------------------?-----------------------------------------------------------------------------------?-----------------------------------------------------------------------------------?---------------------------E---------------------------E---------------------------E---------------------------E-------------------------------------------------------E---------------------------E---------------------------E---------------------------E-----------------------------------------------------------------------------------------------------------------------------------------------------------------------------------------------------------------------------------------------------------?---------------------------E-------------------------------------------------------?---------------------------?---------------------------E---------------------------?-----------------------------------------------------------------------------------?---------------------------?---------------------------E---------------------------?---------------------------?---------------------------?---------------------------E---------------------------?---------------------------?---------------------------?---------------------------?---------------------------?---------------------------?---------------------------?---------------------------?---------------------------?----------
-----------ooo--XXXS----?-------------Xooo---XSS----?------------oooo----XX-----SSS-------------oo---XXS----SSS------------ooo---XSS----S-------------oooo---XXS----SSS------------ooo---ESS----SSS------------ooo---XXS----S-------------Xooo---XSS----SSS------------oo----XSS----SSS------------oo----XXS----SSS-----------oooo---XXS----S-------------Xooo---SSS----SSS------------oo----XXS----SSS------------ooo---XXS----SSS------------oo----XXS----SSS------------oo----XSS----SSS------------ooo---SSS----SSS----------ooooo---XX-----SSS----------oooo----E------SSS?---------oooo----E------SSSS---------oooo----XX-----SSS-------------oo---ESS----SSS-------------oo---E-S----SSS------------oo----XX----SSSS-----------oooo--XXXS----?--------------ooo---ESS----S--------------ooo---ESS----SSS-----------Xooo---XSS----S-S-----------Xoo---XXXS----SSS-------------o----XXS----SSS------------ooo--XXXS----SSS----------ooooo----------SSS------------ooo---XX-----SSS------------ooo--XXXS----?-------------Xooo---XXS----SSS------------oo----XXS----SS-----------ooooo--XXXS----S-------------Xooo---XXS----?-------------oooo---XXS----SS------------Xooo---XSS----SSS-----------Xooo---XXS----S-------------Xooo---XXS----S-------------Xooo---XXS----S-------------Xooo---XXS----S------------ooooo---XXS----S------------oXoo---XXX-----S------------oooo---XXX-----SS------------Xoo----XXS----SSS-----------Xoo---XXXS----S---
--------------------o---------------------------o---------------------------o--------------------------oo---------------------------o-------------------------------------------------------o---------------------------o---------------------------------------------------------------------------------------------------------------o------------------------------------------------------oo-------------------------------------------------------o---------------------------o-----------------------------------------------------------------------------------o---------------------------o---------------------------o-------------------------------------------------------o-------------------------------------------------------o---------------------------o-------------------------------------------------------o------------------------------------------------------oo-----------------------------------------------------------------------------------oo--------------------------o------------------------------------------------------oo-------------------------------------------------------o---------------------------o-----------------------------------------------------------------------------------------------------------------------------------------------------------------------------------------------------------------------------------------------------------------------------------------------
----------------------------------------------------------------S---------------------------------------------------------------------------------------------------------------------------------------------------------------------------------------------------------------------------------------------------------------------------------------------------------------------------------------------------------------------------------------------------------------------------------------------------------------S---------------------------S---------------------------S-----------------------------------------------------------------------------------------------------------------------------------------------------------------------------------------------------------------------------------------------------------------------------------------------------------------------------------------------SSSS------------------------------------------------------------------------------------------------------------------------------------------------------------------------------------------------------------------------------------------------------------------------------------------------------------------------------------------------------------------------------------------------------------------------------------------------------------------------------------------------------------
---------------------------------------------------------------------------------------------------------------------------------------------------------------------------------X-------------------------------------------------------------------------------------------------------------------------------------------------------------------------------------------------------------------------------------------------------------------------------------------------------------------?--------------------------S-------------------------SoS---------E---------------SoS---------E---------------------------E----------------------------------------------X------------------------------------E--------------------------------------------------------------------------?----------------------------------------------------------------------------------------------------------------------------------------SoS---------E---------------------------E-------------------------------------------------------------------------------------------------------------------------------------------------------------------------------------------------------------------------------------------------------------------------------------------------------------------------------------------------------------------------------------------------Q-----------------------------------------------------------------------
-------------XXX----XXX------------------XXX----XXX-----XX-----------XX--<>-XXX--XXX-------------XXX----XXX------------------XXX----XXX------------------XXX----XXX--XXXXX-----------XXX----XXX--XXX-------------XXX----XXX------------------XXX---XXXX------------------XXX---XXXX--X---------------XXX---XXXX--XX-X------------XXX----XXX--X---------------XXX----XXX--XX-XX-----------XXX---XXXX--XXX-------------XXX---XXXX--XXX-------------XXX---XXXX--XX--------------XXX----XXX------------------XXX----XXX--XX-XX-----SS----XX--<>-XXX--XXX-------SS----XX--<>-XX---E?SXXS----SS----XX--<>-X----E?XXX-----------XX--<>-XXX--EXX-------------XXX----XXX------------------XX-----XXX------------------XX--<>-XXX--E?--------------XXX----XXX------------------XXX----XXX------------------XXX----XXX--X---------------XXX----XXX------------------XXX---XXXX------------------XXX----XXX------------------XXX---XXXX-----------SSS--------<>------E??-------------XX--<>-XXX------------------XXX---XXXX------------------XXX---XXXX--XX-XX-----------XXX---XXXX--XX--------------XXX---XXXX--XXXX------------XXX----XXX------------------XXX---XXXX--XX-XX-----------XXX---XXXX--XXX-------------XXX---XXXX--XXXX------------XXX---XXXX--XXX-------------XXX----XXX--XX--------------XXX---XXXX--XXXX------------XXX---XXXX--XXX-------------XXX---XXXX--XXX-------------XXX---XXXX--XXX-------------XXX---XXXX--XXX-------------XXX---XXXX--XXX
--Eo--------------E------------o---------------------------o-------------[]------------o--------------E-----------Eo--------------------------Eo--------------E---------------------------E-----------Eo---------------------------o---------------------------o------------------------------------------------------Eo--------------------------Eo---------------------------o---------------------------o---------------------------o---------------------------o--------------E------------o--------------E------------o-------------[]-----------Eo-------------[]------------o-------------[]-----------Eo-------------[]------------o--------------E--------------------------<>------------o-------------[]-----------Eo---------------------------o---------------------------o--------------E------------o-------------------------------------------------------o---------------------------o-----------------------------------------[]--------------------------[]-----------Eo---------------------------o---------------------------o--------------------------Eo--------------------------Eo--------------------------Eo---------------------------o--------------------------Eo--------------------------Eo--------------------------Eo--------------------------Eo--------------------------Eo--------------------------Eo--------------------------Eo--------------------------Eo---------------------------o------------------------
--XXXXXX---------<>-----------XXXXXX----------------------XXXXX----------[]-----------XXXXX----------<>-----E-----XXXXXX----------------------XXXXXX---------<>-----------XXXXXX---------<>-----------XXXXX-----------------------XXXXXX----------------------XXXXX-----------------------XXXXXX----------------------XXXXX----------<>-----------XXXXXX----------------------XXXXX-----------------------XXXXX-----------------------XXXXXX----------------------XXXXXX---------<>-----------XXXXXX---------<>-----------XXXXX----------[]-----------XXXXXX---------[]-----------XXXXX----------[]-----------XXXXX----------[]-----------XXXXXX---------<>-----------XXXXXX---------[]-----------XXXXXX---------[]-----------XXXXX-----------------------XXXXXX----------------------XXXXXX---------<>-----------XXXXXX----------------------XXXXXX----------------------XXXXX-----------------------XXXXXX---------------------XXXXX-----------[]-----------XXXXX----------[]-----------XXXXX-----------------------XXXXXX----------------------XXXXX-----------------------XXXXX-----------------------XXXXXX----------------------XXXXXX----------------------XXXXXX----------------------XXXXXX----------------------XXXXXX----------------------XXXXXX----------------------XXXXXX----------------------XXXXX-----------------------XXXXX-----------------------XXXXX-----------------------XXXXXX----------------------XXXXXX--------------------
-----------------[]------------------------------------------------------[]--------------------------[]------------------------------------------------------[]--------------------------[]------------------------------------------------------------------------------------------------------------------------------------------[]------------------------------------------------------------------------------------------------------------------------------------------[]--------------------------[]--------------------------[]--------------------------[]--------------------------[]--------------------------[]--------------------------[]--------------------------[]--------------------------[]----------------------------------------------------------------------------------[]------------------------------------------------------------------------------------------------------------------------------------------[]--------------------------[]-------------------------------------------------------------------------------------------------------------------------------------------------------------------------------------------------------------------------------------------------------------------------------------------------------------------------------------------------------------------------------------------------------------------------------------------------------------------------
----------XXX--XXXX----XXXXX----------------XXX------XXX---------------XXXXXXXXXXXXX-----------X---XXXXXXXXXXXXX---------------XXXX-----XXXX---------------XXXXXXX---XXX---------------XXXXXXX---XXX---------------XXXX-----XXXXX--------------XXXX------XXXX--------------XXXX-----XXXX---------------XXXX------XXX---------------XXXXXXX--XXXX---------------XXXX------XXX---------------XXXX------XXXX--------------XXXX------XXX---------------XXXX------XXX---------------XXXXXXX--XXXXX--------------XXXXXXX--XXXX---------------XXXXXXXXXXXXX----------XXXXXXXXXXXXXXXXXX----------XXXXXXXXXXXXXXXXXX-----------XX--XXXXXXXXXXXXXX--------------XXXXXXXXXXXXX---------------XXXXXXXXXXXXX-----------XX--XXXXXXXXXXXXX---------------XXXX----XXXXX---------------XXXX-----XXXX---------------XXXXXXXX-XXXXX----------X---XXXX----XXXXXX--------------XXXX--X--XXXX---------------XXXX-XX--XXXXX--------------XXXX------XXX-----------XXXXXXXXXXXXXXXXX-----------XX--XXXXXXXXXXXXX---------------XXXX------XXXX---------------XXX------XXX---------------XXXX------XXX---------------XXXX------XXX---------------XXXX------XXX---------------XXXX------XXX---------------XXXX------XXX----------------XXX------XXX---------------XXXX------XXX---------------XXXX------XXX---------------XXXX------XXX---------------XXXX------XXX---------------XXXX------XXX---------------XXXX------XXX---------------XXXX------XXX---------------XXXX------XXX
