--------------------------------------------------------------------------------------------------------------------------------------------------------------------------------------------------------------------------------------------------------------------------------------------------------------------------------------------------------------------------------------------------------------------------------------------------------------------------------------------------------------------------------------------------------------------------------------------------------------------------------------------------------------------------------------------------------------------------------------------------------------------------------------------------------------------------------------------------------------------------------------------------------------------------------------------------------------------------------------------------------------------------------------------------------------------------------------------------------------------------------------------------------------------------------------------------------------------------------------------------------------------------------------------------------------------------------------------------------------------------------------------------------------------------------------------------------
-------------------------------------------------------------------------------------------------------------------------------------------------------------------------------------------------------------------------------------------------------------------------------------------------------------------Q---------------------------Q--------------------------------------------------------------------------------------------------------------------------------------------------------------------------------------------------------------------------------------------------------------------------------------------------------------------------------------------------------------------------------------------------------------------------------------------------------------------------------------------------------------------------------------------------------------------------------------------------------------------------------------------------------------------------------------------------------------------------------------------------------------------------------------------------------------------------------------------------------------------------------------------------------------------------------------------------------------------------------------------------------------------------------------------------------------------------------------------------------
---------------------------------------------------------------------------------------------------------------------------------------------------------------------------------------------------------oo---------------------------------------------------------------------------------------------------------------------------------------------------------------------------------------------------------------------------------------------------------------------------------------------------------------------------------------------------------------------------------------------------------------------------------------------------------------------------------------------------------------------------------------------------------------------------------------------------------------------------------------------------------------------------------------------------------------------------------------------------------------------------------------------------------------------------------------------------------------------------------------------------------------------------------------------------------------------------------------------------------------------------------------------------------------------------------------------------------------------------------------------------------------------------------------------------------------------------------------------
---------------------------------------------------------------------------------------------------------------------------------------------------------------------------------------------------------XXX-------------------------------------------------------------------------------------------------------------------------------------------------------------------------------------------------------------------------------------------------------------------------------------------------------------------------------------------------------------------------------------------------------------------------------------------------------------------------------------------------------------------------------------------------------------------------------------------------------------------------------------------------------------------------------------------------------------------------------------------------------------------------------------------------------------------------------------------------------------------------------------------------------------------------------------------------------------------------------------------------oo-----------------------------------------------------------------------------------------------------------------------------------------------------------------------------------------------------------------------------------------
--------------------------------------------------------------------------------------------------------------------------------------------------------------------------------------------------------------------------------------------------------------------------------------------------------------------------------------------------------------------------------------------------------------------------------------------------------------------------------------------------------------------------------------------------------------------------------------------------------------------------------------------------------------------------------------------------------------------------------------------------------------------------------------------------------------------------------------------------------------------------------------------------------------------------------------------------------------------------------------------------------------------------------------------------------------------------------------------------------------------------------------------------------------------------------------------------------------------------------------------------------------------------------------------------------------------------------------------------------------------------------------------------------------------------------------------------------
----------------------------o----------------------------------?-?Q-E-------------S----------Q---SSS-------------------------------------------------?-?E---------SSSSSS-------------------------SSS---------Q-----------SQSSSSS-----------Q-------------------------?---------------------------?--E------------SSS---------?--E------------SSS----------------S-----------o--------?-Q------------SSS--------?-?--E-----------SSSSo--------QQQQ----------------------------------------------------?--E-------------S----------?S-E----------SSSSSo--------Q--------------SSS----------QQQ---------------------------Q-------------------------Q-----SS-------SSS-o--------?--E-----------SSSSo--------?--E------------------------QQQQ----------------------?-QQQ-------------------------?--------------SSSS---------?--E-----------SSS-o--------Q-----SS------SS------------?QQ----------------o------?-?--E------------------------Q-Q-S-S---------------------Q---------------------------?--E-----------SSSS---------?--E------------SSS---------?--E-------------------------------------SSSSS----------?--E----------------------?-?-QE------------------------Q-Q---SS-------------------------SSS--------------------?--E----------SSSSS---------?--E-----------S---o--------QQQQ---------------o------?-QQQ-----------------------?-QS-E------------S-----------Q-----S----------------------------S--------------------?--E-------------SS
---------------------------------------XXXX------------------------XXXXXX---------------------------------------------------------------------------------XX---------------------------------------------------------------------------------------------------------------------------------------XXXXX--------------------------X-------------------------------------------------------XX-----------------------XXXXXX------------------------------------------------------------------X-------------XXX------------------------XXXXX-------------------------------------------------------------------------------------------------------------XX-----------------------XXXXXX----------------------QX-XXX--o-----XXX--------------------------XX------------------------------------------XX-----------------------XXXXXX----------------------------------------------------XXX-----------------------XXXXX---------------------------------------------------------------------------------XXX----------------------------------------------------XXXX---------------------------------------------------XXXXX-----------------------XXXXX----------XX-------------------------------------------------------------------XXXXXX----------------------XXXXXX-------------------------------------------------------------------------------XXXX------------------------------------------------------------------------------------------------
----------------------------------------------------------------------------------------------------------------------------------------------------------Q---------------------------------------------------------------------------------------------------------------------------------------------------------------------------------------------------------------------------------------------------------------------------------------------------------------------------------------------------------------------------------------------------------------------------------------------------------------------------------------------------------------------------------------------------QX--XXX-----------------------------------------------------------------------------------------------------------------------------------------------------------------Q---------------------------Q-------------------------------------------------------------------------------------------------------------------------------------------------------------------------------------------------------------------------------Q-----------------------------------------------------------------------------------------------------------------------------------------------------------------------------------------------------------------------------------------------------------------------------------------------------
------E-------------------------E-------------------------E----------------------------------------------E----------E----------------E----------------------------------------------------E--E--------E---E----------------------------------------------------------------------E------------E-----------------------E---------------------E--o------E---------------------------E--------------E----------E--------------------------------------------E---------------------------E------------E-----------------------------------------------------E----------------E----------E----------------E----------------------------------------E--------------E----------E-------------------E---------E--------------E------------E--------------E----------E----------------E------------E--------------E------------------------------E---------E-------------------------E----------------E----------E----------------E------------E-------------------------E----------------E------------E-----------------------E-------------------------------E---------------------------E-------------------------E-------------------E-------E-----------------------------E--------------E---------------------------E----------E-------------------E-----------------------------------E----------------E---------------------------E--------E------------------E------------E--------------E---------------------------E--------E-E-------------E--S------
--E--<>---QQQQ-------S--------E<>------Q-----------------<>----S?S-QQ-----------------E-------QQQ-------<>-----Q--E<>--E--QQQ-------<>--------E-E<>---Q------<>-----E--S-----------------<>-<>--E----<>--<>---Q-Q----<>------QQ?--E-E<>---QQQQ------<>--------E<><>---QQQ-------<>-----Q--E--<>--SQQQ-----E-----E----<>----E?S-------<>----<>-------E<>---QQQ-----------------E--<>---QQQ-------<>----QQ-<><>--E?SQQQ-----------E-----E-E--E?SQQQQ------<>-----Q--E<><>---QQQQ------<>--------E-E<>---QQQ-----------------E-E<>--SQQQ-----------E-----E<>--Q--QQQQ------<>--------E<>--E?-QQQ-------<>--------E-E<>---QQQQ----------------E-E<>---QQQQ------<>--------E<>----SQQQ----------<>-----E-E<>--SQQQ----Q--<>-----Q--E--<>---QQQQ------<>---QQQ--E<>--E?-QQQQ------<>---QQQ--E-E<>---QQQ-------<>--------E-E----SQQQ-----E----<>--------<>---QQQQ---Q--<>--------E<>--E?SQQQ-------<>--------E<>--E?SQQQ-------<>--------E--<>---QQQQ------<>---QQQ--E<>--E?-QQQ-------<>--------E--<>---QQQ-----------E----<>----E?SQQQ----<>-----E-----E-E<>---QQQ-----------E-----E--<>---QQQQ------<>--------E<>---?SQQQ----------<>-----E<>--E?SQQQ-----------------E--<>---QQQQ------<>---QQQ----E--Q--QQQQ------<>-----Q--E<>---?S-QQ-----E----<>-------E----SQQQ----Q-Q----------E<>--E?SQQQQ------<>-----Q--E----E?-QQQ-------<>---QQQ-<>----E?SQQQ-------<>--------E--<>---QQQQ------<>----QQ--E-E<>---QQQ-------<>----QQ-<><>--E?SQQQ----<>-----E---
-<>--[]----------------------<>[]------------------------[]--------------------------<><>---------------[]-------<>[]---------------[]-------<><>[]----------[]----<>--------------------[]-[]-<>----[]--[]----------[]--E-------<><>[]-------------[]-------<>[][]-------------[]-------<>--[]----------<>----<>----[]--------------[]----[]-----E<>[]----------------------<>--[]-------------[]-------[][]------------------<>----<><>---------------[]-------<>[][]-------------[]-------<><>[]----------------------<><>[]----------------<>----<>[]---------------[]-------<>[]---------------[]-------<><>[]-------------<>-------<><>[]-------------[]-------<>[]------------------[]----<><>[]-------------[]-------<>--[]-------------[]-------<>[]---------------[]-------<><>[]-------------[]-------<><>------------------[]-----E--[]-------------[]-------<>[]---------------[]-------<>[]---------------[]-------<>--[]-------------[]-------<>[]---------------[]-------<>--[]----------------<>----[]--------------[]----<>----<><>[]-----------------E----<>--[]-------------[]-------<>[]------------------[]----<>[]------------------------<>--[]-------------[]--------E<>---------------[]-------<>[]------------<>----[]----<><>------------------------<>[]---------------[]-------<>-----------------[]-------[]-----------------[]-------<>--[]-------------[]-------<><>[]-------------[]-------[][]------------[]----<>---
-[]--[]----------------------[][]------------------------[]--------------------------[][]---------------[]-------[][]---------------[]-------[][][]----------[]----[]--------------------[]-[]-[]----[]--[]----------XX-<>-------[][][]-------------[]-------[][][]-------------[]-------[]--[]----------[]----[]----[]--------------[]----[]----<>[][]----------------------[]-E[]-------------[]-------[][]------------------[]----[][]---------------[]-------[][][]-------------[]-------[][][]----------------------[][][]----------------[]----[][]---------------[]-------[][]---------------[]-------[][][]-------------[]-------[][][]-------------[]-------[][]------------------[]----[][][]-------------[]-------[]--[]-------------[]-------[][]---------------[]-------[][][]-------------[]-------[][]-X----------------[]----<>--[]-------------[]-------[][]---------------[]-------[][]---------------[]-------[]--[]-------------[]-------[][]---------------[]-------[]--[]----------------[]----[]--------------[]----[]----[][][]----------------<>--X-[]--[]-------------[]-------[][]------------------[]----[][]------------------------[]--[]-------------[]-------<>[]---------------[]-------[][]------------[]----[]----[][]------------------------[][]---------------[]-------[]-----------------[]-------[]-----------------[]-------[]--[]-------------[]-------[][][]-------------[]-------[][]------------[]----[]---
-[]--[]----E-EE-EE-----------[][]-E------EE-EE-----E-----[]-----E-----E-EE-E---------[][]---------E-EE--[]-EE-E--[][]--------EE-E---[]-------[][][]-------E--[]----[]---------------E-E--[]-[]-[]----[]--[]----E--E--E--[]-------[][][]-------E-EE--[]-E-EE--[][][]------EE-EE--[]-EE-E--[]--[]------EE-EXXE---[]----[]----------EE--[]----[]----[][][]------EE-EE-----------[][][]------EE-EE--[]-E--E--[][]---------E-EE-E---[]----[][]---------E-EE--[]-E--E--[][][]------EE-EE--[]-E--E--[][][]------EE-E------E-----[][][]-------E-EE-E---[]----[][]--------EE-EE--[]-EE-E--[][]---------E-EE--[]-E-E---[][][]------EE-EE--[]-EE-E--[][][]------EE--E--[]-E-E---[][]--------EE-EE-E---[]----[][][]-E----EE-EE--[]-------[]-X[]-------E-EE--[]-E--E--[][]---------E--E--[]----E--[][][]------EE-----[]-------[][]-X------EE-EE-E---[]----[]-E[]------E--EE--[]----E--[][]-E-------E-EE--[]-E-E---[][]---------E-EE--[]-E--E--[]-E[]-------E-EE--[]-EE-E--[][]--------EE-EE--[]-------[]--[]------EE-EE-E---[]----[]--------E-EE-EXXE---[]----[][][]------EE-EE-E---[]-XX-[]-E[]------EE-EE--[]-E--E--[][]--------EE-EE-E---[]----[][]---------E-EE-E---------[]--[]-------E-EE--[]--E-E--[][]--------EEE-E--[]-EE-E--[][]---------E-EXXE---[]----[][]---------E-EE-E---------[][]---------E-EE--[]-E--E--[]-----------E--E--[]-EE-E--[]-----------E-EE--[]-------[]--[]-------E-EE--[]-E--E--[][][]------EE--E--[]----E--[][]--------EE--[]----[]---
-XXXXXXXXXXXXXXXXXXXXXXXXXXX-XXXXXXXXXXXXXXXXXXXXXXXXXXX-XXXXXXXXXXXXXXXXXXXXXXXXXXX-XXXXXXXXXXXXXXXXXXXXXXXXXXX-XXXXXXXXXXXXXXXXXXXXXXXXXXX-XXXXXXXXXXXXXXXXXXXXXXXXXXXXXXXX---XXXXXXXXXXXXXXXXXXXXXXXXXXXXXXXXXXXXXXXXXXXXXXXX-XXXXXXXXXXXXXXXXXXXXXXXXXXXXXXXXXXXXXXXXXXXXXXXXXXXXXXXXXXXXXXXXXXXXXXXXXXXXXXXXXXX-XXXXXXXXXXXXXXXXXXXXXXXXXXX-XXXXXXXXXXXXXXXXXXXXXXXXXXXXXXXXXXXXXXXXXXXXXXXXXXXXXXX-XXXXXXXXXXXXXXXXXXXXXXXXXXXXXXXXXXXXXXXXXXXXXXXXXXXXXXX-XXXXXXXXXXXXXXXXXXXXXXXXXXXXXXXXXXXXXXXXXXXXXXXXXXXXXXX-XXXXXXXXXXXXXXXXXXXXXXXXXXX-XXXXXXXXXXXXXXXXXXXXXXXXXXX-XXXXXXXXXXXXXXXXXXXXXXXXXXX-XXXXXXXXXXXXXXXXXXXXXXXXXXX-XXXXXXXXXXXXXXXXXXXXXXXXXXX-XXXXXXXXXXXXXXXXXXXXXXXXXX--XXXXXXXXXXXXXXXXXXXXXXXXXXX-XXXXXXXXXXXXXXXXXXXXXXXXXXX-XXXXXXXXXXXXXXXXXXXXXXXXXXX-XXXXXXXXXXXXXXXXXXXXXXXXXXXXXXXXXXXXXXXXXXXXXXXXXXXXXXX-XXXXXXXXXXXXXXXXXXXXXXXXXXXXXXXXXXXXXXXXXXXXXXXXXXXXXXXXXXXXXXXXXXXXXXXXXXXXXXXXXXX-XXXXXXXXXXXXXXXXXXXXXXXXXXX-XXXXXXXXXXXXXXXXXXXXXXXXXXXXXXXXXXXXXXXXXXXXXXXXXXXXXXXXXXXXXXXXXXXXXXXXXXXXXXXXXXX-XXXXXXXXXXXXXXXXXXXXXXXXXXX-XXXXXXXXXXXXXXXXXXXXXXXXXXX-XXXXXXXXXXXXXXXXXXXXXXXXXXX-XXXXXXXXXXXXXXXXXXXXXXXXXXXXXXXXXXXXXXXXXXXXXXXXXXXXXXX-XXXXXXXXXXXXXXXXXXXXXXXXXXX-XXXXXXXXXXXXXXXXXXXXXXXXXXX-XXXXXXXXXXXXXXXXXXXXXXXXXXX-XXXXXXXXXXXXXXXXXXXXXXXXXXX-XXXXXXXXXXXXXXXXXXXXXXXXXXXXXXXXXXXXXXXXXXXXXXXXXXXXXXXXXXXXXXXXXXXXXXXXXXXXXXXXXXX-XXXXXXXXXXXXXXXXXXXXXXXXXXX-XXXXXXXXXXXXXXXXXXXXXXXXXXX
