--------------------------------------------------------------------------------------------------------------------------------------------------------------------------------------------------------------------------------------------------------------------------------------------------------------------------------------------------------------------------------------------------------------------------------------------------------------------------------------------------------------------------------------------------------------------------------------------------------------------------------------------------------------------------------------------------------------------------------------------------------------------------------------------------------------------------------------------------------------------------------------------------------------------------------------------------------------------------------------------------------------------------------------------------------------------------------------------------------------------------------------------------------------------------------------------------------------------------------------------------------------------------------------------------------------------------------------------------------------------------------------------------------------------------------------------------------
--------------------------------------------------------------------------------------------------------------------------------------------------------------------------------------------------------------------------------------------------------------------------------------------------------------------------------------------------------------------------------------------------------------------------------------------------------------------------------------------------------------------------------------------------------------------------------------------------------------------------------------------------------------------------------------------------------------------------------------------------------------------------------------------------------------------------------------------------------------------------------------------------------------------------------------------------------------------------------------------------------------------------------------------------------------------------------------------------------------------------------------------------------------------------------------------------------------------------------------------------------------------------------------------------------------------------------------------------------------------------------------------------------------------------------------------------------
-----------------------------------------------------------------------------------------oo-------------------------------------------------------------------------------------------------------------------------------------------------------------------------------------------------------------------------------------------------------------------------------------------------------------------------------------------------------------------------------------------------------------------------------------------------------------------------------------------------------------------------------------------------------------------------------------------------------------------------------------------------------------------------------------------------------------------------------------------------------------------------------------------------------------------------------------------------------------------------------------------------------------------------------------------------------------------------------------------------------------------------------------------------------------------------------------------------------------------------------------------------------------------------------------------------------------------------------------------------------------------------------------------------------------------------------------------------------------
----------------------------------------------------------------------------------------XXXX------------------------------------------------------------------------------------------------------------------------------------------------------------------------------------------------------------------------------------------------------------------------------------------------------------------------------------------------------------------------------------------------------------------------------------------------------------------------------------------------------------------------------------------------------------------------------------------------------------------------------------------------------------------------------------------------------------------------------------------------------------------------------------------------------------------------------------------------------------------------------------------------------------------------------------------------------------------------------------------------------------------------------------------------------------------------------------------------------------------------------------------------------------------------------------------------------------------------------------------------------------------------------------------------------------------------------------------------------------
--------------------------------------------------------------------------------------------------------------------------------------------------------------------------------------------------------------------------------------------------------------------------------------------------------------------------------------------------------------------------------------------------------------------------------------------------------------------------------------------------------------------------------------------------------------------------------------------------------------------------------------------------------------------------------------------------------------------------------------------------------------------------------------------------------------------------------------------------------------------------------------------------------------------------------------------------------------------------------------------------------------------------------------------------------------------------------------------------------------------------------------------------------------------------------------------------------------------------------------------------------------------------------------------------------------------------------------------------------------------------------------------------------------------------------------------------------
------------------Q---------o--------QQQ-----------------------------------------QQQ----------------------SSSSSS-------------------------------------Q-Q-------------------------?--E-------------SS---------?--E------------SSS---------Q-Q----Q--------------------?-QQ------------------------?--E-----------SSS----------?--E------------------------Q-QQ------------S---------------------------------------?-QE----------SSSS----------?--E---------------o--------?--E----------SSS-----------Q-Q-----------------------?-Q-Q-------------------------?--E------------------------?--E-----------SSS----------?--E--------------------------Q----------------o--------?--E------------SS----------?--E------------------------Q-QQ----------------------------------------------------?--E------------SSS---------?--E----------SSSSS---------Q-QQ------------------------?--Q------------S-----------?--E-----------S-S-o--------?--E----------------------?-Q-Q--------------------------------S--------SSS---------?--E-----------SSS----------?--E-----------SSSS---------?--E-----------SSSS---------?--------------S---o------?-QQQE-----------SSS--------?-Q-QE-----------------------------SSS------------------------------------------------?--E----------SSSSS-------------------------SQQ-------------------------SSS---------?-QQ-------------------------------S-----------o--------?Q-E-----------SSSS---------QQQ------------SSS-
--------------------------XX--------------------------------------------------------------------------------------XS---------------------------------------------------------------XXXXXX----------------------XXXXX---------------------------------------X-------------XXX-----------------------XXXXX-----------------------XXXXXX---------XX----------------------------------------------------------------------XX-----------------------XXXXX--------------------------XX---------------------------------------X--------------------------XX--------------XX-----------------------XXXXXX----------------------QXXXX---------------------------------------------------XXXXXX----------------------XXXXX----------XX---------------------------X---------------------------------------QXXXX--------------------------X-------------------------------------------------------XX-----------------------XXXXX-----------------------XXXXXX--o------XX--------------------------XX------------------------------------------X------------------------XXXXX--------------------------XX---------------------------------------X------------?-XX-----------------------QXXXX----------XX----------------------------------------------------------------------XX-----------------------------------------------------------------------------------X--------------------------------------XX------------XXXXX---------------------------------------
-----X------------XXX--------------------------------------------------------------------------------------------XXX--------------------------------------------------------------------------------------------------------------------------------------------------------------------------------------------------------------------------------------------------------------------------------------------------Q-----------------------------------------------------------------------------------------------------------------------------------------------------------------------Q---------------------------------------------------------------------------------------------------------------------------------------------------------------------------------------------------Q-------------------------------------------------------------------------------------------------------------------------------------------Q---XXX-----------------------------------------------------------------------------------------------------------------------------------------------------------------------X---------------------Q---------------------------Q---X-X---------------------------------------------------------------------------------------------------------------------------------------------------------------------------------------------------X---------------------Q-----------------------------------------
--------------------------------------------------------------E---------------------------------------E----------XX-------------------------------E--------------E----------E-------------------E--o----E-------------------E--o------E---------------------------E--------------E------------------------------------------------------------------E----------------E------------E---------------------------E--------------E------------------------E-----E-----------------------------------E----------------E----------------------------------------E--------------E------------E-------------------------------------------------------E--------------E----------E-------------------E-------E-----------------------------E--------------E----------E----------------E------------------------------------E-E-------------E------------------------------E------------E--------------E----------------------------------------E-------------------------E----------------E------------E--------------E------------E--------------E------------------------------E---------E---------------------------E-----------------------E-E----------------E--------E-E-------------------------------------------------------E----------------E----------E-------------------------E------------------E----------E-------------E--E------------E---------------------------E--------------E----------E-------------------------E-E----------------E------
--E-XXX-----Q---------------oo-------QQQQ--------------------<>---QQQQ-----------------<>------------<>-----E--S---->---??-------E------------E--<>---QQQ-------<>---QQQ--E<>---SSQQQ----------<>-----E<>---?SQQ------E----<>--------<>---QQQQ----------------E-E<>---QQQQ------<>----E---E------SQQQ-----E-----E-----E-E<>--SQQQ-----------------E<>--E?SQQQ-------<>--------E-E<>---QQQQ----------------E--<>---QQQQ------<>--------E-E----SQQQ----<>----<>-------E-----QQQQ----------------E<>--E--QQQQ------<>-----Q--E----E?SQQQQ----------------E-E<>---QQQ-------<>--------E--<>--SQQQ-----------E-----E--<>--SQQQ-------------------E<>---QQQQ------<>----QQ--E<>----SQQQ----------<>-----E<>--E?SQQQ-----------------E-E<>---QQQQ------<>-----Q--E<>--Q--QQQ-------<>-----Q--E-E<>--SQQQ-----E-----E----<><>--E-SQQQ----<>-----E-----E<>--E--QQQQ---Q--<>--------E--<>---QQQQ------<>--------E-E<>--SQQQ-----------------E-E<>--SQQQ-----------------E<>--E?SQQQQ------<>-----Q--E--<>---QQQQ------<>--------E-E<>---QQQ-------<>--------E--<>--SQQQ----------<>-----E--<>---QQQ-----------E-----E-E<>---QQQQ---------------<><>--E?SQQQ-------<>-------<>----E?SQQQ-------<>-----Q--E----E--QQQQ---Q-------QQQ--E<>---------------<>--------E<>-----QQQ-----------E----<>----E--Q---------<>---QQQ--E<>----QQ------<>-----------E--<>---QQQQ---Q--<>---QQQ----E<>---QQQQ------<>-----Q--E<>---?SQQQ----------------<><>--E?SQQQ-------<>---QQQ
-<>-XXX------------------------------------------------------[]------------------------[]------------[]----<>-----E[]-----------<>-----------<>--[]-------------[]-------<>[]-------------?----[]----<>[]------------------[]-----E-E[]----------------------<><>[]-------------[]---<>--<><>------------------<>----<><>[]-----------------E----<>[]---------------[]-------<><>[]----------------------<>--[]-------------[]-------<><>------------[]----[]----<><>------------------------<>[]---------------[]-------<>->------------------------<><>[]-------------[]-------<>--[]----------------<>----<>--[]-----------------------E<>[]-------------[]-------<>[]------------------[]----<>[]------------------------<><>[]-------------[]-------<>[]---------------[]-------<><>[]----------------<>----[][]------------[]----<>----<>[]---------------[]-------<>--[]-------------[]-------<><>[]-----------------E----<><>[]----------------------<>[]---------------[]-------<>--[]-------------[]-------<><>[]-------------[]--S----<>--[]----------------[]----<>--[]----------------<>----<><>[]----------------------[][]---------------[]-------[]-----------------[]-------<>-----------------<>-------<>[]---------------[]--E----<>[]------------------<>----[]-----------------[]-------<>[]------------[]--E--E----<>--[]-------------[]--------E<>[]-------------[]-------<>[]------------------------[][]---------------[]------
-[]--XX------------------------<>----------------------------[]----------------------<>[]------------[]----[]----<][]-----------[]-----------[]--[]-------------[]-------[][]------------------[]----[][]------------------[]----<>[][]----------------------[][][]-------------[]---[]--[][]------------------[]----[][][]----------------<>----[][]---------------[]-------[][][]----------------------[]--[]-------------[]-------[][]------------[]----[]----[][]----------------------X-[][]---------------[]-------[][]------------------------[][][]-------------[]-------[]--[]----------------[]----[]--[]----------------------<>[][]-------------[]-------[][]------------------[]----[][]------------------------[][][]-------------[]-------[][]---------------[]-------[][][]----------------[]----[][]------------[]----[]----[][]---------------[]-------[]--[]-------------[]-------[][][]----------------<>--X-[][][]----------------------[][]---------------[]-------[]--[]-------------[]-------[][][]-------------[]-------[]--[]----------------[]----[]--[]----------------[]----[][][]----------------------[][]---------------[]-------[]-----------------[]-------[]--<>-------------[]-------[][]---------------<>-<>----[][]------------------[]----[]-----------------[]-------[][]------------[]-<>-<>----[]--[]-------------[]-------<>[][]-------------[]-------[][]------------------------[][]---------------[]------
-[]-XXX-------E-EE----EE-------[]---------E-EE-----E---------[]----E-EE-EE-----------[][]------E-EE--[]----[]----[][]-E---------[]-----------[]-E[]-------EE----[]----E--[][]---E----EE-EE-E---[]----[][]--------EE-EE-E---[]----[][][]-------E-EE-----EE-E--[][][]-------E-EE--[]-E-[]--[][]--------EE-EE-----[]----[][][]------EE-EE-E---[]----[][]---------E-EE--[]-E-E---[][][]------EE-EE-----------[]--[]------EE-EE--[]-------[][]--------EE-E[]----[]----[][]-E------EE-EE---------X-[][]---------E-EE--[]-EE-E--[][]---------E-EE--------E--[][][]------EE-EE--[]-------[]-E[]------EE-EE-E---[]----[]--[]------EE-EE-E---------[][][]------EE-EE--[]-EE-E--[][]--------EE-EE-E---[]----[][]--------EE-EE-E---------[][][]-------E-EE--[]-E--E--[][]--------EE-EE--[]-EE-E--[][][]------EE-E------[]----[][]---------E-EXXE---[]----[][]---------E-EE--[]-------[]--[]-------E-EE--[]-E-E---[][][]------EE-EE-E---[]-E--[][][]------EE-EE-E---------[][]---------E-EE--[]-EE-E--[]--[]------EE--E--[]----E--[][][]------EE-EE--[]-------[]-E[]------EE-EE-E---[]----[]--[]------EE-EE-E---[]----[][][]------EE-EE-----EE-E--[][]---------E-EE--[]-E-E---[]-Q---------E-EE--[]--E-E--[]--[]-------E-EE--[]-EE-E--[][]--------EE-EE--[]-[]----[][]-E------EE-EE-E---[]----[]-----------E--E--[]-------[][]---------E--[]-[]-[]----[]--[]-------E-E---[]-E--E--[][][]------E--E---[]-EE-E--[][]---------E-EE-E---E-----[][]---------E-EE--[]-E--E-
-XXXXXX--XXXXXXXXXXXXXXXXXXXXXXXXXXXXXXXXXXXXXXXXXXXXXXXXXXXXXXXXXXXXXXXXXXXXXXXXXXXXXXXXXXXXXXXXXXXXXXXXXXXXXXXXXXXXXXXXXXXXXXXXXXXXXXXXXXX-XXXXXXXXXXXXXXXXXXXXXXXXXXXXXXXXXXXXXXXXXXXXXXXXXXXXXXX-XXXXXXXXXXXXXXXXXXXXXXXXXXXXXXXXXXXXXXXXXXXXXXXXXXXXXXX-XXXXXXXXXXXXXXXXXXXXXXXXXXXXXXXXXXXXXXXXXXXXXXXXXXXXXXX-XXXXXXXXXXXXXXXXXXXXXXXXXXX-XXXXXXXXXXXXXXXXXXXXXXXXXXX-XXXXXXXXXXXXXXXXXXXXXXXXXXXXXXXXXXXXXXXXXXXXXXXXXXXXXXX-XXXXXXXXXXXXXXXXXXXXXXXXXXXXXXXXXXXXXXXXXXXXXXXXXXXXXXX-XXXXXXXXXXXXXXXXXXXXXXXXXXX-XXXXXXXXXXXXXXXXXXXXXXXXXXX-XXXXXXXXXXXXXXXXXXXXXXXXXXX-XXXXXXXXXXXXXXXXXXXXXXXXXXXXXXXXXXXXXXXXXXXXXXXXXXXXXXX-XXXXXXXXXXXXXXXXXXXXXXXXXXX-XXXXXXXXXXXXXXXXXXXXXXXXXXX-XXXXXXXXXXXXXXXXXXXXXXXXXXXXXXXXXXXXXXXXXXXXXXXXXXXXXXX-XXXXXXXXXXXXXXXXXXXXXXXXXXX-XXXXXXXXXXXXXXXXXXXXXXXXXXXXXXXXXXXXXXXXXXXXXXXXXXXXXXX-XXXXXXXXXXXXXXXXXXXXXXXXXXX-XXXXXXXXXXXXXXXXXXXXXXXXXXX-XXXXXXXXXXXXXXXXXXXXXXXXXXX-XXXXXXXXXXXXXXXXXXXXXXXXXXX-XXXXXXXXXXXXXXXXXXXXXXXXXXXXXXXXXXXXXXXXXXXXXXXXXXXXXXXXXXXXXXXXXXXXXXXXXXXXXXXXXXX-XXXXXXXXXXXXXXXXXXXXXXXXXXXXXXXXXXXXXXXXXXXXXXXXXXXXXXX-XXXXXXXXXXXXXXXXXXXXXXXXXXX-XXXXXXXXXXXXXXXXXXXXXXXXXXX-XXXXXXXXXXXXXXXXXXXXXXXXXXXXXXXXXXXXXXXXXXXXXXXXXXXXXXX-XXXXXXXXXXXXXXXXXXXXXXXXXXX-XXXXXXXXXXXXXXXXXXXXXXXXXXX-XXXXXXXXXXXXXXXXXXXXXXXXXXXXXXXXXXXXXXXXXXXXXXXXXXXXXXX-XXXXXXXXXXXXXXXXXXXXXXXXXXX-XXXXXXXXXXXXXXXXXXXXXXXXXXXXXXXXXXXXXXXXXXXXXXXXXXXXXXX-XXXXXXXXXXXXXXXXXXXXXXXXXXX
