--------------------------------------------------------------------------------------------------------------------------------------------------------------------------------------------------------------------------------------------------------------------------------------------------------------------------------------------------------------------------------------------------------------------------------------------------------------------------------------------------------------------------------------------------------------------------------------------------------------------------------------------------------------------------------------------------------------------------------------------------------------------------------------------------------------------------------------------------------------------------------------------------------------------------------------------------------------------------------------------------------------------------------------------------------------------------------------------------------------------------------------------------------------------------------------------------------------------------------------------------------------------------------------------------------------------------------------------------------------------------------------------------------------------------------------------------------
--------------------------------------------------------------------------------------------------------------------------------------------------------------------------------------------------------------------------------------------------------------------------------------------------------------------------------------------------------------------------------------------------------------------------------------------------------------------------------------------------------------------------------------------------------------------------------------------------------------------------------------------------------------------------------------------------------------------------------------------------------------------------------------------------------------------------------------------------------------------------------------------------------------------------------------------------------------------------------------------------------------------------------------------------------------------------------------------------------------------------------------------------------------------------------------------------------------------------------------------------------------------------------------------------------------------------------------------------------------------------------------------------------------------------------------------------------
--------------------------------------------------------SSSSSSSSS--SSSSSSSSSSSSSSSSS----------------------------SSSSSSSSSSSSSSSSSSSSSSSSSSSS---------------------------------------------------------------------------------------------------------------------------------------------------------------------------------------------------------------------------------------------------------------------------------------------------------------------------------------------------------------------SSSSSSSSSSSSSSSSSSSSSSSSSSSSSSSSSSS---------------------------------------------------------------------------------------------------------------------------------------SS-SS-----------------------------------------------------------------------------------------------------------------------------------SS-----------------------------------------------------------------------------------------------------------------------S--S-------------SSSSSSSSSSS-------------------------------------------------------------------------------------------------------------------------------------SSSSSSS----------------------------------------SSSSSSSSSSSSSSSS--------------------------------------------------------------------------------------------------------------------------------------------SSSSSSSSSSSSSSSSSSSSSSSSSSSSSSSSSSSSSSSSSSSSSSSSSSSSSSSS--------------------------------------------------------
-----------------------------------------------------------------------------------------------------------------------------------------------------------------------------XXX-----------------------------------------------------------------------------------------------------------------------------------------------------------------------o-E-----------------------------------------------------------------------------------------------------------------------------------------------------------------------------------------------------------------------------------------------------------------------------------------------------------------------------------------------------------------------------------------------------------------------------------------------------------------------SSSSS--------------------------------------------------------------------------------------------------------------------------------------------------------------------------------------------------------------------------------------------------------------------------------------------------------------------------------------SSSSSSSSSSSSSSSS------------------------------------------------------------------------------------------------------------------------------------------------------------------------------------SSSSSSSSSSSS------------------------------------------------------------
------------------------------------------------------------------------------------------------------------------------------------------------------------------------------------------------------------------------------------------------------------------------------------------------------------------------------------------------------XXXXX-----------------------------------------------------------------------------------------------------------XXXX-----------------------------------------------------------------------------------------------------------------------------------------------------------------------------------------------------------------------------------------------------------------------------------------------------------------------------------------------------S-SSSSS--------------------------------------------------------------------------------------------------------------------------------------------------------------------------------------------------------------------------------------------------------------------------------------------------------------------------------------XSSSSSSSSSSSSSSS------------------------------------------------------------------------------------------------------------------------------------------------------------------------------------SSSSSSSSSS--------------------------------------------------------------
---------------------------------------------------SSS-------------------------------------?-Q--------------------------------QSQ---------ES---------------------------------------------------------------SSS-?SSSS-SQQ-------------SSS----------QQQ---Q--------QQQQQQQ-----------------------------------------------------------------------------------SSSSS---SS?SSSS-------------SSSS--------------------------S---------Q------------------?------------------------SSS-------------------------------------SSS---------------------------------QQQQ-----SS---------------------------------------------------------------SQ----------------Q-QQS----------------SSS-------?---------------------------------Q--------------------------------SSS----------------------------S----SSS--------SSQQQ-----------QSS------SSSSSSSSSSSSSS--------QQQQQ------------------------------SSS--------------SSSSS-------SSQQQ----------------------SQ---SQS--------------------------------------QS-----------QQ---------------------------QQQ----------------------------------------------------------------------------S?S--------------------------------------------?SSS----SSSSSSSSSSSSSSSS-------SSSSS---SS--------------------------------------------------------------------------------------------------------QQQ------QQ-----------------------------------o------------SSSSSSSSSSSS-QQ------------------------------------------S--------------
-------------------------------------------------------------------------------------------X---------------------------------------------------------------------------------------------------------------------------------------------------------------------------------------------------------------------------------------------------------------------------S---------------------------S-------------------------------------------------------------------------------E-------------------------------SSS--------X----------------------------------------------------------------------------------------------------------------------------------------------------------------------------------------------------------------------------------------------------------------------------------------------------------------------------------------------------------------------------------------------------------------------------------------------------------------------------------------------------------------------------------------------------------------------------------------------------------------------------------------------------------------------------------------------------------------------------------o--------------------------------------------------------------------------------------------------------------------------------------------------------------------------------------
----------------------------------------------------------------------------------------X--S---------------------------------------------------------------------------------------------------------------o--S---------------------------------------------------------------------------------------------------------------------------------------------ES----S----SS--------------------------S------------------------------------------------------------------------E--------------------------XX------Q---SSS---------------------------------------------------------------------------------------------------------------------------------------------------------XS--------------------------------------------------------------------------------o--------------------------------------------------------------------------------------------------------------------------------------------------------------------------------------------------------------------------o------------------------------------------------------------------------------------------------------------------------------------------------------------------------o-------------------------XXX-o------------------------------------------------------------XXX--X----------------------------------------------------------------------------------------------------------------------------------------------------------------------------------
-------------E------------------------------------------------------------S------------XX--So--------------X-----------------------------------------------------E---------------------------E------------XX-----------------------------------------------------------------------------------------------------------------------------------------------XS----------SS--------------------------------------------------------------------------------------------------ES------------ooo----------XXS----------SSS---------------------------------------------------------------------------------------------------------------------------------------E----------------XX-------------------------------------E---------------------------------------------------E-----E---------------------------------------------------------------------------------E--?--------------------------------------------------------------------------------------------------------------------------------------------------------------------------------------------------E----------------------------S------------E-----------------------------------------E----------E------------------------XXX----E------------------------oo---------------E--o---------------------------------------------E--o----------------------------------------------------------------------E----?--------------------------------------E--------------------------------
---------E--<>--------------------Q---------------------Q---S--------------------Q----XXX--SSS-------------XX-----------Q-----Q--<>------EES-------------E---E--<>---QQQ--------------------<>----------XXXX---------QQQ-----------------------Q--QQ---QQQ--------QQQQQQ-------------QQQ--Q-----------------------------------------XXX-----------SSQS----XXXX-X---SS-------Q---------XX-----------SS---------------------XXX--SS------------E----------<>---------SSS----XX--X----XX-----------S----XXXX-X----SS--SSS------S--------------------------SQQS----------------------------------------------------------------------E--------------------------<>----Q-X--SSS----XX--S-------QQQQ----------------------<>---E----------------------<>-----S-----X-E--------<>----<>----SSSSS--------SQ---QQQQQ------SSSSSSS----???SS--SSSSQ----------?QQQQQ--------<>-------QQQQ---------------Q--------------E---------Q--QQQQ-----------Q------QS------------------------------------SSSS---QQS------------QQ---------------------S------------------------------------<>-----QQQQ-------------------------------<>----SS----------------------------------<>----SSSSSSSSS---??SSS--SSSSSQ-----XXXX--S--------Q--Q------Q-----------------------<>----------E-------------------------------E----<>--------------------QQQQ---QQ--------------------------------------SS-SSSSS----?QS-----SSSSS------------<>-----E----<>-----------XX-E------------E----
--------<>--[]---------------------------------------------------------E-------------XXXX------------------XX--------------------[]---------------------<>---E--[]-------<>-----------------[]---------XXXXX--------------------------------------------------------------------<>-----------------------------------------------------------------------XXXXX-XX---------E-----------XX---X-----------------E---X--------------------------<>----------[]---------------XXX--XX--------------------XXXX--XX-------------------------------------S---------------------------------------E--------------------------------------<>--------------------------[]---------------XXX------------------------------------[]---E----------------------[]-E-------XXXX---------[]----[]---------------------------------------S-------SS-------------------------------[]----------------------------------------<>-----o----------------------------------------------------------S-------SS--------------------------------------------------------------------------------[]----------------------------------------[]----------------------------------------[]----SSSSSSSSS-------S------------XXXXX--SSS----------------------------------------[]-------XXXXXXX---------------X-----------<>----[]-------------------------------E-E------------------------------------SSSS------------------------------[]----<>----[]----------XXX<>-----------<>----
--------[]--[]--------------------------------------------------------<>------------XXXXX-----------------XXX--------------------[]---------------------[]--<>--[]-------[]-----------------[]--------XXXXXX--------------------------------------------------------------------[]----------------------------------------------------------------------XXXXXX-XXX-------------------XXX---XXX-X------------<>--XXXX---E--------------------[]----------[]--------------XXXX--XXXX-----------------XXXXX--XXXX-------------------------------------------------X---X----X---------------<>--------------------------------------[]--------------------------[]--------------XXXX--SSS-------------------------------[]--<>----------------------[]<>-------XXXX---------[]----[]-----------X-X------------------------SSS------SS-------------------------------[]----------------------------------------[]---------------------------------------------------------------SS-------SS--------------------------------------------------------------------------------[]----------------------------------------[]-----SS---------------------------------[]----SSSSSSSSS-------S-----------XXXXXX--SSS---------<>------------------<>---------[]-----------------------------XX----------[]----[]------------------------------<><>-----------------------------------SSSSSS-----------------------------[]----[]--<>[]--------XXXXX[]-----------[]----
---E----[]--[]--------------------E-E---E-E-------------------E--E----[]------------XXXXX--------------X--XXXX------------EE-----[]---------------EE----[]--[]--[]-------[]--------EE-EE----[]-E-----XXXXXXX--------EE----EE-EE-------------------------------------------------[]----E------EE--E-----------------------------------------------------XXXXXX--XXX--------------E---XXXXE--XXXXX------------[]-XXXXX-----X-------------E-E--[]----------[]---------EE--XXXXX--XXXX---X---------E--XXXXXX--XXXX----------------E-EE--E------------------E-------XE--X--------------EE-EE-[]---------------------------E-E--------[]---------E--E-------------[]-------------XXXXX-------------------------E--E-EE----[]--[]-----E-EE----EE-E-----[][]-----EXXXXX--E------[]----[]----------XXXX------------EE-E--------------------------E-----------------EE----[]---------E----------EE------------E--E--[]---------------E-E-------------E-------------------E-E-----------------E-S---E---------------------E---------------------E------EE----EE---X--------------[]-----E-EE-------------------------EE-E--[]---------------------EE-----------------[]----SSSSSSSSS-------------------XXXXXX---S----------[]-E-EE-------------[]---------[]----------------E-E-----EE---XX-E-EE-E---[]----[]-----E------------------------[][]-------EE-E--------------------------------E-------------------EE-E---[]----[]--[][]-------XXXXXX[]-----------[]----
XXXXXXXXXXXXXXXXXXXXXX--XXXXXXXXXXXXXXXXXXXXXXXX-X-XXXXXXXXXXXXXXXXXXXXXXXXXXXXXXXXXXXXXXXXXXXXXXXXXXXXXXXXX---XXXXX-XXXXXXXXXXXXXXXXXXXXXXXXXXXXXXXXXXXXXXXXXXXXXX--XXX-XXXXXXXXXXXXXXXXXXXXXXXXXXXXXXXXXX-----XXXXXXXXXXXXXXXXXXXXXXXXX----X--XXXXXXXX----XXXXXXXXXXXXXXXX---XXXXXXXXXXXXXXXXXXXXXXXXXXXXX-XXXXXXXXXXXXXXXXXXXXX--XXXXXXXX---XXXXXXXXXXXXXX--XXXXXXXXXXXXXXXXXXXXXXXXXXXXXXXXXXXXXXXXXXXXXXXXXXXXX-XXXXXXX-XXXXXXXXXXXXXXXXXXXXXXXXXXXXXXXXXXXXXXXXXXXXXXX--XXXXXXXXXXXXXXXXXXXXXXXXXX--XXXXXXXXXXXXXXXXXXXXXXXXXXXXXXXXXXXX-XXXXXXXXXXXXXXXXXXXXX-XXXXXXXXXXXXXXXXXXXXXXXXXXXXXXXXXX-XXXXXXX-XXXXXXXXXXXXXXXXXXXXXXXXXXXXXXXXXXXXXXXXXXXXXXXXXXXXXXXXXXXXXXXX--X--XXXXXXXXXXXXXXXXXXXXXXXXXXXXXXXXXXXXXXXXXXXXXXXXXXXXXXXXXXXXXXXXXXXXXXXXXXX-XXXXXXXXXXXXXXXXXXXXXXXXXXXX----XXXXXXXXXXXXXXXXXXXXXXXXXXXXXXXXXXXXXXXXXXXXXXXXXXXXXXXXXXXXXXXXXXXXXXXXXXXXXXX-XXXXXXXXXXXXXXXXXXXXXXXXXXXXXXXXX--XXXXXXXXXXXXXXX--XXXXXXXXXXXXXXXXXXXXXXXXXXXXXXXXXXXXXXXXXXXXXXXXXXXXXXXXXXXXXXXXX---XXXXXXXXX-XXXX--XXX-----XXXXXXXXXXXXXXXXXXXXXXXXX-XXX---XXXXXXXXXXXXXXXXXXXXXXXXXXXXXXXXXXXXXXX-XXXXXXXXXXXXXXXXXXXXXXXXXXXXXXXXXXXXXXXXXXXXXXXXXXXXXXXXXXXXXXXXXXXXXXXXXXXXXXXXXXXXXXXX-------XX--XXXXXXXXXXXXXXXXXXXXXXXXXXXXXXXXXXXXXXX-XXXX------XXXXXXXXXXXXXXXXXXXXXXXXXXXXXXXXXXXXXXXXXXXXXXXXXXXX-XXXXXXXXXXXXXXXXXXXXXXXXXXXXXXXXXXXXXXXXXXXXXXXXXXXX-XXXXXXXXXXXXXXXXXXXXXXXXXXXXXXXXXXXXXXXXXXXXXXXXXXXXXXXXXXXX-XXXXXXXXXXXXXXXXXXX
