--------------------------------------------------------------------------------------------------------------------------------------------------------------------------------------------------------------------------------------------------------------------------------------------------------------------------------------------------------------------------------------------------------------------------------------------------------------------------------------------------------------------------------------------------------------------------------------------------------------------------------------------------------------------------------------------------------------------------------------------------------------------------------------------------------------------------------------------------------------------------------------------------------------------------------------------------------------------------------------------------------------------------------------------------------------------------------------------------------------------------------------------------------------------------------------------------------------------------------------------------------------------------------------------------------------------------------------------------------------------------------------------------------------------------------------------------------
--------------------------------------------------------------------------------------------------------------------------------------------------------------------------------------------------------------------------------------------------------------------------------------------------------------------------------------------------------------------------------------------------------------------------------------------------------------------------------------------------------------------------------------------------------------------------------------------------------------------------------------------------------------------------------------------------------------------------------------------------------------------------------------------------------------------------------------------------------------------------------------------------------------------------------------------------------------------------------------------------------------------------------------------------------------------------------------------------------------------------------------------------------------------------------------------------------------------------------------------------------------------------------------------------------------------------------------------------------------------------------------------------------------------------------------------------------
---------------------------------------------------------------------SSSSSSSSSSSSSSS----------------------------SSSSSSSSSSSSSSSSSSSSSSSSSSSS-------------------------------------------------------------------------S-SSSSSSSSS--------------------------------------------------------SSSS--S----------------------------------------------------------------------------------------------SSSSSSSSSSS----------------------------SSSSSSSSSSSSSSSS---------------------------------------------------------------------------------------------------------------------------------------------------------------------------SSSSSSSSS--------------------------------------------------------SSSSSSSSS--SSSSSSSSSSSSSSSSS----------------------------SSSSSSSSSSSSSSSSSSSSSSSSSSSS--------------------------------------------------------SSSSSSSSSSSSSSSSSSSSSSSSSSSS--------------------------------------------------------------------------------------------------------------------------------------------------------------------------------------------------------------------------------SSSSSSSSSSSSSSSSSSSSSSSSSSSS--------------S----SSSSSSSSS------------------------------------------------------------------------------------S-SSSSSS-------------------------------------------------------------------SSSSSSSSS----------------------------SSSSSSSS-----S-------S-SSSSS--------------------------------------------------------
-------------------------------------------------------------------------------------------------------------------------------------------------------------------------------------------------------------------SSSSSSSSSSSS----------------------------------------------------------------------------------------------------------------------------------------------------------------------SS----------------------------------------------------------------------------------------------------------------------------------------------------------------------------------------------------------------------------------------------------------------------------------------------------------------------------------------------------------------------------------------------------------------------------------------------SSSSS-------------------------------------------------------------------------------------------------------------------------------------------------------------------------------------------------------------------------------------------------SS---SSSSSSSSSSSSSSSSSSSS--------------------------------------------------------------------------------------------------------------------------------------------------------------------------------------------------------------------------------------------------------------------------------------------------------------------
------------------------------------------------------------------------------------------------------------------------------------------------------------------------------E------------------------------------SSSSSSSSSSS-----------------------------------------------------------------------------------------------------------------------------------------------------------------------S------------------------------------------------------------------------------------------------------------------------EXX---------------------------------------------------------------------------------------X--E-------------------X-------------------------------------------------------------------------------------------------------------------S---------------------------------------------------------------------------------SSSSS--------------------------------------------------------------------------------------------------------------------------------------------------------------------------------------------------------------------------oo--------------------SSSX--SSSSSSSSSSSSSSSSSSSS-----------------------------------X----------------------------------------------------------------------------------------------------------------------------------------------------------------------EXX-------------------------------------------------------------------------------------------------------
-------------QQSQ----------------------?SSSSSS-SQQQS---------QQQ------S-------------------------------------------------------------------QQ----QQQ-------------------------SSS----SSSSS-SSSQ--------------------SSQSSSSSSSSSSS----------Q-Q-Q-S---------------------------------------S--------------------------Q-----------------------------------------SSSS-------SSS--------S-------S----SSQSS-SS-Q-----------SSSSS---SSSSSSSS------------------------------------------------------------------SSSSSS----------------SSS----SSSS----SQQSS--------------------------------------------------------------------------SSSS-S--S---------SSS----SSSS----SQ------------------SSSSS------------------Q--------------------------SQ------------------------S----------------------------------------------------------------SSSS---------------------SSS--Q-----------------------------------------Q----------Q-Q-S----------------------------SSSSQ-------------QQ-Q-Q-----------------------SSQQ?-SSS---QQSQSS-------------------------------QS--------------QQQ----------------------------XXX-------SS-----SSSSSSSSSSSSSSSSSSSS----SSSS------?-------------------------SS------------------------------------------------QQ-Q-------------------------------------------------SSSSS---SSSS--------------------------S?S-----------------------SSSS--------SSS--------------------------------------SSSSSSSS-----QSSSS--------------SSS-------------
-----------------------------------------------------------------------------------------------------------------------------------------------------------------------------------------------------------------------------------------------------------------------------------------------------------------------------------------------------------------------------------------------------------------------------------------------------------------------------------------------------------------------------------------------------------------------------------------------------------------------------------------------------------------------------E-----------------------XXX---------------------------------------------------------------------------------------------------------------------------------------------------------------------------------------------------------------------------------------------------------------------------------------------------------------------------------------------------------------------------------------XXX-------------------------------------------------------------------------------------------------------------------------------------------------X-----------------------------------------------------------------------------------------------------------SSS--------------------------------------------------------------------------------------
-------------------------------------------------------------Q--------------------------------------------------------------------------------------------------------------------XSS-----------------o----------------------------------------------------------------------------------------------------------------------------------------------------------------------------------------------------------------------------------------------------------------------------------------------------------------------------XS----------------------------------------------------------------------------------------------------------------------------------------XXSS-------------------------------------------------------------------------SSS--------------------------------------------------------------------------------------------------------------------------------------------------------------------------------------------------------------------------------------------------------------------------------------------------------------------------------XXXXX-------------------------------------------------------------------------XXS----------------------------------------------------------------------------------------------------------------------------------o----------------------------------------------SSS--------------------------------------------------------------------X-----------------
----------------------------------E--------------------------------------------------oo-------------------------------------------E----------------------------------------------XS-----------------------------------------------------------------------------------------------------------------------E------------------------------------------------------------------S---------------------------------------------------------------------------E-----------------------------E---------------------------XX--------------XS----------------------E---------------E-----------------------------------------------------------------------E------------------------XXS----------------------------------SSSSSSS----------------------------------oS---------?-SQ-SSS----------------------------------------------------------------------------------------------------------------E---------------------------E-E----------------------------------------------------------------------------------------------------------------------------E---------------------X--------------XXXXX-------------E----?-----------------------------------------------------XXS------------------------------------------------------------------------------------------------------------X--------------------------------------------------------XX-----------SSS---------------------------------------E---------------------------XX-----------------
-QQ---------------------------E--<>-----Q-Q-----QQQ-----SS--SSSSS-----S---------oo-----o-----------------------------------------<>------S?S---QQQ---------------E---QQQSS-----XXXX--SS----Q--------QQSS---Q----QQQQS---QSQQQ------Q--QQ--QQQ--------------------------E----<>-----E---------------------<>------E?S--------------------------------------X--------Q---S----X---SSS-------S---------SSS-QQ-----------QQ-----QSSSS-----------S-----------<>----------------------------<>----------XXXX------------XXX-----SSSS----XXX-S----SSSSSSS--------<>--------<>----<>-------SS------------------------QQ---------ESSSS--SS----E-----SS-----XXX------SS--SSS---------XXXX--------------------------S-----------o-----------QQ--------XX-------------SS----SS-----------o-----------------------------------------------S-------------------------SSS-------------S--------------------<>-------------Q--QQQ-------<><>-----------XXX----------Q--------------Q-QQQQ-------<>---QQQ-------Q--QQQQQQ-Q---ESQ--------------------------------QQS----<>-------SQQQ-Q--------------------XXXXXXXX------SSSSSSSSSSS-???SSS-SSSSSSSS-X---SSS------S----------QQQ---SSS----XXXX------------------------QQ--------------------E--QQ-Q-Q--------X-------------------S---------------Q-------XXX-----------<>-----QQQQ---------S----Q--------SSSSS---XXXX------------------------------S----Q----------------<>---------QS-SSSSS---------XXX-----------------
-----------------------E---------[]---------------------SS---------------------------------------E-------------------------------[]-----------------------------<>------------XXXXX-----------------------------------------------------------------------------------<>----[]----<>---------------------[]----------------------------------------------XX------------------------------------------------------------------------------------E------E-[]----------------------------[]---------XXXXX-----------XXXX-----E------XXXX-SSSS----------------[]--------[]----[]---------------XX--X----X-------------------------------<>----E------XXX--SSS-----o-----------XXXXX-------------------------E------E----------------------------X---X------------E-----------------------------------------------------------------------------------------------------S---S---------E-----E----[]--------------------------[][]----------XXXX--------------------------------------[]--------------------------<>---------------------E----X--------------[]---------------------------------XXXXXXXX------SSSSSSSSSS-----SS--SS--SSS------------------S--------------------XXXX-SSS--------------------------------------------------------E--X------------------------------------------XXXX-----------[]---------------------------------------XXXXX--S-------------------------------------------------[]-------------------------XXXX-----------------
----------------------<>---------[]---------------------SS--------------------------------------<>-----E-------------------------[]-<>--------------------------[]-----------XXXXXX----SS-------------SS--------------------------------------------------------------[]----[]----[]---------------------[]-------------------XX-----------------------XXXXX---E-------------------------------------------------<>---------------------------<>-----<>-[]----------------------------[]--------XXXXXX----------XXXXX-------E---XXXXX-SSS-----------------[]--------[]----[]--------------XXX--XXX--X-------------------------------[]----------XXXX---XX-------SS-------XXXXXX-----------<>------------------<>----------------------------X---X------------------------------------------------------------------------------------------------------------------S---S--------<>----<>----[]--------------------------[][]---------XXXXX----E---------------------------------[]--------------------------[]--------------------<>----X--------------[]--------------------------------XXXXXXXXX------SSSSSSSSSS-----SS--SS--SSS-----------------SS------------------XXXXXX--SS-----------------------------------------------------------X-----------------------------------------XXXXX-----------[]-------------------SS-----------------XXXXXX----------------------------------------------------[]------------------------XXXXXX---S------------
---E------------------[]-E-------[]-------------EE------S--------E-EE--E-------E----------------[]-----------------E--E--E-E-----[]-[]-------E--E-EE------------[]---EE-----XXXXXXX--SSSS-------------------------------E-------------E------------------E-----EE-----[]----[]-E--[]-------------E-E-----[]------------EE--E--XXE----------------------XXXXX-------------------------E-E--EE---------------------[]---------E-E--------EE-E---[]-----[]-[]-----------EE---------------[]------XXXXXXXX---------XXXXXX----------XXXXXX------------------E--[]--------[]----[]-------------XXXX--XXX--X------------------------EE-E---[]----EE---XXXXXX--X---------E-----EXXXXXX------------[]-E-----------E--E-[]----------------------------X---X------------------------------------E--------------------------E-EE--------------------------EE-E------------o----S-------EE-E-[]-E--[]----[]--------------------EE----[][]--------XXXXXX------------EE------------------EE----[]--E-E---------------------[]-----------EE-E-----[]----X--------E-E---[]--------------E----------------XXXXXXXXXX------SSSSSSSSSo---ooSSooSSSoSSS----EE----------------S-------E--E--XXXXXXX-SXSX----E-EE-----------------E--------------------------------X--------E-E------------------------EE---XXXXXX-ES--------[]-E-----E--------------------EE-------XXXXXXX---SSS---------E-----E-------------------------E-E--[]---------------------E-XXXXXX-----------------
XXXXXXXXXXXXXXXXXXXXXXXXXXXXXXX--XX---XXXXXXXXXXXXXXXXXXXXXXXXXXXXXXXXXXXXXXXXXXXXXXXXXXXXXXXXXXXXXXXXXX---XXXXXXXXXXXXXXXXXXXXXXXXXXXXXXXXXXXXXXXXXXXXXXXXXXXXXXXXXXXXXXXXXXXXXXX--------XXXXXXXXXXXXXXXXXXXXXXXXXXXXXXXXXXXXXXXXXXXXXXXXXXXXXXXXXXXXXXXXXXXXXXXXXXXXXXXXXXXXXXXXXXXXXXXXXXXXXXXXXXXXXXXXXXXXXXXXXXXXXXXXXXXXXXXXXXXXXXXX-XXXXXXXXXXXXXXXX--XXXX-XX-X--XXXXXXXXXXXXXXXXXXXXXXXXXXXXXXXXXXXXXXXXXXXXXXXXXXXXXXXXXXXXXXXXXXXXXXXXXXXXXXXXXXXXXXXXXXXXXXXXXXXXXXXXXXXXXXXXXXXXXXXXXXXX-----X--XXXXXXXX---XXXXXXXXXXXXX--XX--XXXXXXXXXXXXXXXXXXXXXXXXXXXXXXXXXXXXXXXXXXXXXXXXXXXXXXXXXXXXXXXXXXXXXXXXXXXXXXXXXXXXXXXXXXXXXXXXXXXXXXXXXXXXXXXXXXXXXXXXXXXXXXXXXXX----X-XXXXXXXXXXXXXXXXXXXXXXXXXXXXXXXXXXXXXXXXXXXXXXXXXXXXXXXXXXXXXXXXXXXXXXXXXXXXXXXXXXXXXXXXXXXXXXXXXXXXXXXX--XXXXX--XXXXXXXXXX-XXXXXXXXXXXXXXX---XXXXX----XXXXXXXXXXXXXXXXXXXXXXXXXXXXXXXXXXXXXXXXXXXXXXXXXXXXXXXXXXXXXX-XXXXXXXXXXXXXXXXXXXXXXXXXXXXXXXX---XX--XXXXXXXXXXXXXXXXXXXXXXXXXXXXXXXXXXXXXXXXXXXXXXXXXXXXXXXXXXXXXXXXXXXXXXXXXXXXXXXXXXXXXXXXXXXXXXXXXXXXXXXXXXXXXXXXXXXXXXXXXX-XXX---XXXXXXXXXXXXXXXXXXXXXXXXXXXXXXXXXXXXXXXXXXXXXXXXXXXXXXXXXXXXXXXXXXXXXXXXXXXXXXXXXXXXXXXXXXX-----XXXXXXXXXXXXXXXXXXXXXXXXXXXXX-X-----XXXXXXXXXXXXXXXXXXXXX-XXX-XXXXXXXXXXXXXXXXXXXXXXXXXXXXXX--XXXXXXXXXXX---X---XXXXXXXXXXXXXXXXXXXXXXXXXXX-XXXXXXXXXXXXXXXXXXXXXX-------XXXXXXXXXXXXXXXXXXXXXXXXXXXXXXXXXXXXXX-XXXXXXXXXXXXXXXXXXXXXXXXXXXXXXXXXXXXX-------XXXXXXX-XXX
