--------------------------------------------------------------------------------------------------------------------------------------------------------------------------------------------------------------------------------------------------------------------------------------------------------------------------------------------------------------------------------------------------------------------------------------------------------------------------------------------------------------------------------------------------------------------------------------------------------------------------------------------------------------------------------------------------------------------------------------------------------------------------------------------------------------------------------------------------------------------------------------------------------------------------------------------------------------------------------------------------------------------------------------------------------------------------------------------------------------------------------------------------------------------------------------------------------------------------------------------------------------------------------------------------------------------------------------------------------------------------------------------------------------------------------------------------------
--------------------------------------------------------------------------------------------------------------------------------------------------------------------------------------------------------------------------------------------------------------------------------------------------------------------------------------------------------------------------------------------------------------------------------------------------------------------------------------------------------------------------------------------------------------------------------------------------------------------------------------------------------------------------------------------------------------------------------------------------------------------------------------------------------------------------------------------------------------------------------------------------------------------------------------------------------------------------------------------------------------------------------------------------------------------------------------------------------------------------------------------------------------------------------------------------------------------------------------------------------------------------------------------------------------------------------------------------------------------------------------------------------------------------------------------------------
----------------------SSS-SS----------------------------SSSSSSSSSSSSSSSSSSSSSSSSSSSS--------------------------------------------------------------------------------------------------------------------------------------------------------------------------------------------------SS--------------------------SS--------------------------------------------------------------------------------------------------------------------------------------------SSSSSSSSSSSSSSSSSSSSSSSSSSSS----------------------------SSSSSSSSSSSSSSSSSSSSSSSSSSSSSSSSSSSSSSSSSSSSS------S---S----------------------------SSSSSSSSSSSSSSSSSSSSSSSS------------------------------------------------------------------------------------------------------------------------------------------------------------------------------------------------------------------------------------SSSSSSSSSSSSSSSSSSSSSSSSSSSS-----------------SSSSSSSSSSSSSSSSSSSSSSSSSSSSSSSSSSSSSSSSSSSSSSSS--S-SSSSSSSSSSSSSSS---------------------------------------------------------------------------------------------------------------------------------------------------------------------------------------------------------------------------------------------------------------------------------------------------------------------------------------------------SSSSSSSSSSSS--S----------------------------------------------------------------------------------------------
-----------------------------------------------------------------SSSSSSSSSSSSSSSSS----------------------------------------------------------------------------------------------------------------------------------------------------------------------------------------------------------------------------------------------------------------------------------------------------------------------------------------------------------------------------------------------------------------------------------------------------------------------------------------------------------------------------------------------------------------------------------------------------------------------------------------------------------------------------------------------------------------------------------------------------------------------------------------------------------------------------------------------------------------------------------------------------------------------------------------------------------------------------------------------------------------------------------------------------------------------------------------------------------------------------------------------------------------------------------------------------------------------------------------------------------------------------------------------------------------------------------------------------------------------
----------------------------------------------E------------SS----SSSSSSSSSSSSSSSSS-S-----------------------------------------------------------------------------------------------------------------------------------------------------------------------------------------------------------------------------------------------------------------------------------------------------------------------------------------------------------------------------------------------------------------------------------------------------------------------------------------------------------------------------------------------------------------------------------------------------------------------------------------------X-------------------------------------------------------------------------------------------------------------------------------------------------------------------------------------------------------------------------------------------------------------------------------------------------------------------------------------------------------E------------------------------------------------------------------------------------------------------------------------------------------------------------------------------------------------------------------------------------------------------------------------------------------------------------------------------------------------------------
----------------------------------------------E--XX--------------SSSSSSSSSSSSSSS-SSS-----SSS---?-SSS---------------------------------------------QQQ-Q-Q---------------------------SSSS------------S-------------QQQQ---------Q-----SSSS---SSSSS------------------------SSSSS---QQQSQQ----------------------------------------------------------------------------------------------------------------------QQQQ-Q-Q-S----------------------------------------------------------------------------------------------------------------------------------------------------------------------------------------------------------------------------------------------------------SSSSSS-Q------------SSSS-----??Q-----------------------------------------------------Q------------SS---------------------------------------------------------------SQQQQ---Q----------------SSS-------------------------S---------QQQ-------------------------------------------------------------------------Q----S----------------------------SS---------------------------SSSSS--------------SSSS------SQS--SQQ-------------SSSSS----------------------------------------------------------SSSSSSQQQ----------S----------------------QQ-------------QQ---------------SSSS---SSSSSS-SS-------------------------------------------------QQQQ-------------------------QS----------------------------------------------------SSQS----------------------------------------
------------------------------------------------XXS-------------------------------------------------------------------------------------------------------------------------------------------------------------------------------------------------------------------------------------------------------------S----------------------------------------------------------------------E-----------------------------------------------------------------------------------------------------------------------------------------------------------------------------------------------------------------------------------------------------------------------------------------------------------------------------------------------------X----------------------------------------------------------------------------------------------------------------------------------------------------------------------------------------------------------------------------------------------------------------------------------------------------------------------------------------------------------------------------------------------------------------------------------------------------------------------------------------------------------------------------------------------------------------------------------------------------------------------------------------------------------------------------------------------------------
-----------------------------------------------XXXX--------------------------------S---------------------------------------XE-----------X--------------------------------------------------------------------------------------------------SS------------------------------------------------------------ES---------------------------------------------------------------------------XSS--------oo--------------------------------------------------------------------------------------------------------------------------------------------------------------------------------------------------------------------------------------------------------------------------XXSS---------------------------------------------------------E--X-------XX-------------------------------------------------------------------------------------------------------------------------------------------------------------------------------------------------------------------------o---------------------------------------------X----------------------------------------------------------------------------------------------------------------------------------------------------------------------------------------------------------------------------------------------------------------------------------------------------------------------------------------------------------------------------------------------------oX-------------------
----------------X------------------------E-----XXX--------------------------------oS---------------------------------------------------XX------------------------E------------------------------------------------------------------------XX---------------------------------------------------------------------------------------------E-------------------------------------------XXS-------------------------------------------------------------XX---------------------------------------------------------------------S--------------------------------------E---------E-------------------------X--------------------------------------------------------------------XXXX---------------------------------------------------------------------XX-------------------------E------------E-----------------------------------------------E-------------------E----------So-----E-------------------------------------------------------------------------------------------------------------------------------------------------E--o-----------------------------------------------------------------------------------------------------------------------------E-----------------------------------------------oo---------------------------------------------------------------------------------------------------------------------------------------------------------------------------------------------------------XXXS-------------------
---------------XXX--S----------------------X--XXXX-------SSSS-------ESSSSSS--------S---------------------------------------E----------XXX------X--QS------------<>---QQ-----------------------------SSSSS--QQ-Q-QQQQ-----------Q---SS----XXX--S------------Q---------E----S-----SSSSSS------SQS--------XXX--S--SSS--Q----------E--------<>-----------------------E----------Q-------XXXX-SS---XX-----------E?QQQ---Q-------------QQQ------Q-------X--XX------------------------------E---E--------------------------------------SSS---------------------o---------<>--------<>-----Q-------------E-----XX---SQ--S--------------------------------------------E----E?-------XXXXX-SS-----QQ-------------------------------Q-------------XXX-XXX-------XXX---------Q-------------<>-----------<>--------------------------XX-------E-----E---------E?QQQQ--QQQ----<>----QQX---SSS---<>----------------QQ---------EESS------QQQQ--Q-----------E------------SSS-----Q---------S-----------------SQS--------E----<>----Q?--------E-------<>----<>---------XXXX---S-------------------SSQQ-----QQ?----QQ-------------------E-----------------------------------------------<>---QQQQQQ----QQQ----Q-Q---------------E----------QQQ----QQQQ---S?S-------------SSSSSS-------XS--------------SSSS-----------S?--------QQ-----Q--Q-QQQQQ-------------------------S-----------------------------------------------------ESS---QQ------------XXXXX--------E----------
--------------XXXX--XX-----------------XX--XXXXXXX-------------------------------------------E--------------------------XX<>-----E---XXXX-----------------------[]-----------------------------------SSS--------------------------------XXXX--oSS-------------------<>--------------------------------XXXX--------------------<>---E----[]----------------------<>---E-------------XXXXX-SX---------------------------------<>-------------------XXX-XX-----------------------------<>---E------------------------------------------------------------------------[]--------[]------------------<>---XXXX---------------------------------------------------<>------------XXXXX--S----------------------------------------------------EXXX-XXXX------XXX--E--------------------[]-----------[]-------E-----E-----------XXXX-----<>----<>------------------------[]----------------[]--X--------------------------------------------------E<>-----------SSS---------------------------E----------------<>----[]------------X-X-------[]----[]--------XXXXX--------------E--------------------------------------------<>-----------------------------------------------[]-------------------------------------<>--EX-------------------------------------------------SS----------------------XX----------------------------------------------------------------------------------------------------------------------------------XXXXX--------<>----------
-------------XXXXX--XXX---------------XXX--XXXXXXX------------------------------------------<>------S------------------XXX[]----<>--XXXXX------X------------S---[]----------------------------X------SSSS------------------------------XXXXX--SSS------------<>-----[]-------------------------------XXXXX--X-----------------[]--<>----[]-------------X-X------[]--<>------------XXXXXX--SSS---------------------------S---[]------S-----------XXXX-XXX----------------------------[]--<>------------------------------------------------------------------------[]--------[]------------------[]--XXXXX---------------------------------------------------[]---<>------XXXXXXX-SSSS------------------------------------------------XXXXX-XXXX-----XXXX-<>--------------------[]-----------[]------<>----<>----------XXXXX-----[]----[]------------------------[]----------------[]--XX------------------------------------------------<>[]------------SS--------------------------<>----------------[]----[]---<>--------XXX------[]----[]-------XXXXXX-------------<>--------------------------------------------[]-----------------------------------------------[]-------------------------------------[]--XXX---------------------------------S--------------SS---------------------XXX----------------------------------------------------------------------------------------------------------XX----SS---------------XXXXXX--------[]----------
---E--E--E--XXXXXXE-XXX--------------XXXX--XXXXXXX-----E---E-E-------------EE---------------[]---------------------EE-XXXX[]----[]-XXXXXX------X--E-------------[]-----------EE---------------X----------------E-E-----E--------------XXXXXX--SS-------E-E---[]-----[]----------E----------E-----E--XXXXXX--X----------EE-E---[]--[]----[]--------EE---X-X------[]--[]-----------XXXXXXX--S-S-------------------------------[]------S---------XXXXXX-XXX-----------E-EE-------EE----[]--[]---------------------------------EE-E--------E----------------------EE--[]--------[]--------------E---[]-XXXXXX--------------------E-----E-E-----------E-E--EE----[]-E-[]-EE--XXXXXXXX-----------EEE-----------E---------------------EE-E--XXXXX-XXXX----XXXXX-[]-----------E-EE-E---[]--------E--[]------[]----[]-----E-EE-XXXX--E---[]----[]---------------E--E-----[]-EE-E----EE-----[]--XXXX-------------E------------------------E-EE-E--[][]-----------E-------EE-E-----E--E--------[]-----EE-E-EE-E--[]----[]-E-[]---EE--XX--------[]----[]-E----XXXXXXX-------------[]------------------------------E------E------[]-----------------------E-E-----------------E---[]-------------EE------EE-EE-EE--------[]-XXX---------------------E-E-----EE-E-S--------------X---------------------XXXX--X------E-EE-------------E--E---------------------------------------------E-----E-E-------------------------------------------XXXXXXXX--------[]-E---E----
XXXXXXXXXXXXXXXXXX--XXXXXXXXXXXXXXXXXXXXXX-XXXXXXXXXXXXXXXXXXXXXXXXXXXXXXXXXXXXXXXXXXXXXXXXXXXXXXXX-XXXXXXXXXXXXXXXXXXXXXXXXXXXXXXXXXXXXXXXXXXXXXXXXXXXXXXXXXXXXXXXXXXXXXXXXXXXXX--XXXXXXX--XXXXXXXXXXXXXXXXXXXXXXXXXXXXXXXXXXXXXXXXXXXXXXX-------XXXXXXXXXX-XXXXXX-XXXXXXXXXXXXXXXXXXXXXXXXXXXXXXXXXXXXXXX-XXXXXXXXXXXXXXXXXXXXXXXXXXXXXXXXXXXX-XXXXXXXXXXXXXXXXXX-XXXXXXXXXXXXXXXXXXX------XXX-XXXXXXXXXXXXXXXXXXXXXXXXXXXXXXXXXXXXXXX--XXXXXXXXX--X---XXXXXXXXXXXXXXXXXXXXXXXXXXXXXX-XX--XXXXXXXXXXXXXX----XXXXXXX--XXXXXXXXXXXXXXXXXXXXXXXXXXXXXXXXXXXXXXXXXXXXXXXX-XX--XX--XXXXXXXXXXXXXXXXXXXXXXXX-X-XXX--XXXXXXXXXXXXXXXXXXXXXXXXXXXXXXXXXXXXXXXXXXXXXXXXXXXXXXXXXXXXXX-------XXXXXXXXXXXXXXXXXXXXXXXXX---XXXXXXXXXXXXXXXXXXXXXXXXX-XXXXXXXXXXXXX-XXXXXXXXXXXXXXXXXXXXXXXXXXXXXXXXXXXXXXXXXXXXXXXXXXXXXXXXXXXXXXXXX---XXXXXXXXXXXXXXXXXXXXXXXXXXXXXXXXXXXXXXXXXXXXXXXXXXXXXXXXXXXXXXXXX-XXXXXXXXXXXXXXXXXXXXXXXXXXXXXXXXXXXXXXXXXXXXXXXXXXXXXXXXXXXXXXXXXXXXXXXXXXXXXXXXXXXXXXXXXXXXXXXXXXXXXXXXXXXXXXXXXXXXXXXXXXXXXXXXXXXXXXXXXXXXXXXXXXXXXXXXX-----X--XXXXXXXXXXXXXXXXXXXXXXXXXXXXXXXXXXXXXXXXXXXXXXXXXXXXXX--XXXXXXXXXXXXXXXXXXXXXXXXXXXXXXX----XXX--XXXXXXXXXXXXXXXXXXXXXXXXXXXXXXXXXXXXXXXXXXXXXXXXXXXXXXXXXXXXXXXXXXXXXXXXXXXXXXXXXXXXXXXXXXXXXXXXXXXX----XXXXXXXXXXXXXXXXXXXX---X-XXXXXXXXXXXXXXXXXXXXXXXXXXXXXXXXXXXXXXXXXXXXXXXXXXXXXXXXXXXXXXXXXXXXXXXXXXXXXXXXXXXXXXXXXXXXX-XXXXXXXXXXX---XXXXXXXXXXXXXX-XXXXXXX---XXXXXXXXXXXXXXXX-X
