--------------------------------------------------------------------------------------------------------------------------------------------------------------------------------------------------------------------------------------------------------------------------------------------------------------------------------------------------------------------------------------------------------------------------------------------------------------------------------------------------------------------------------------------------------------------------------------------------------------------------------------------------------------------------------------------------------------------------------------------------------------------------------------------------------------------------------------------------------------------------------------------------------------------------------------------------------------------------------------------------------------------------------------------------------------------------------------------------------------------------------------------------------------------------------------------------------------------------------------------------------------------------------------------------------------------------------------------------------------------------------------------------------------------------------------------------------
--------------------------------------------------------------------------------------------------------------------------------------------------------------------------------------------------------------------------------------------------------------------------------------------------------------------------------------------------------------------------------------------------------------------------------------------------------------------------------------------------------------------------------------------------------------------------------------------------------------------------------------------------------------------------------------------------------------------------------------------------------------------------------------------------------------------------------------------------------------------------------------------------------------------------------------------------------------------------------------------------------------------------------------------------------------------------------------------------------------------------------------------------------------------------------------------------------------------------------------------------------------------------------------------------------------------------------------------------------------------------------------------------------------------------------------------------------
--------------------------------ooo-------------------------ooo-------------------------ooo---------------------SSS-SSSSSSSSSSSS----------------ooo-------------------------oooS--SSSS------------------ooo-------------------------oooS--SSSSS-----------------ooo-------------------------ooo-------------------------ooo---------------------SSSSSSSSSSSSSSSSS---------------ooo-------------------------oo--------------------------ooSS------------------------ooo-------------------------ooo-------------------------oo--------------------------oo--------------------------oo--------------------------oo--------------------------oo--------------------------oo--------------------------oo--------------------------oo--------------------------oo--------------------------oo--------------------------oo--------------------------ooo-------------------------oooS--SSSS------------------oo--------------------------oo--------------------------oo--------------------------oo--------------------------oo--------------------------oo--------------------------oo--------------------------oo--------------------------ooo-------------------------ooo-------------------------ooo-------------------------ooo-------------------------oooS------------------------ooo-------------------------oo--------------------------ooo-------------------------oo----------------------SSS-SSSSSSSSSSSS----------------oo----------------------
--------------------------------XXXX-----------------------XXXXX------------------------XXXX------------------------XXXX-----------------------XXXXX------------------------XXXX-----------------------XXXXX------------------------XXXX-----------------------XXXXX-----------------------XXXXX-----------------------XXXXX------------------------XXX------------------------XXXXX-----------------------XXXX------------------------XXXX------------------------XXXXX------------------------XXXX-----------------------XXXXX-----------------------XXXX------------------------XXXXX-----------------------XXXX------------------------XXXX------------------------XXXXX-----------------------XXXX------------------------XXXX-----------------------XXXXX------------------------XXXX------------------------XXXXX-----------------------XXXXX------------------------XXXX----------------------XXXXXX-----------------------XXXX------------------------XXXXX-----------------------XXXXX-----------------------XXXXX-----------------------XXXX------------------------XXXX------------------------XXXX-------------------------XXXX-----------------------XXXXX-----------------------XXXXX-----------------------XXXXX-----------------------XXXXX-----------------------XXXXX-----------------------XXXXX-----------------------XXXXX-----------------------XXXX-------------------------XXXX-----------------------XXXXX--------------------
-----------------------------------------------------------------------------------------------------------------------------------------------------------------------------------------------------------------------------------------------------E--------------------------------------------------------------------------------------------------------------------------------------------------------------------------------------------------------------------------------------------------------------------------------------------------------------------------------------------------------------------------------------------------------------------------------------------------------------------------------------------------------------------------------------------------------------------------------------------------------------------------------------------------------------------------------------------------------------------------------------------------------------------------------------------------------------------------------------------------------------------------------------------------------------------------------------------------------------------------------------------------------------------------------------------------------------------------------------------------------------------------------------------------------------------------------------------------
------------------------SSSS---------------------SSSSSSS------------------------SSSS---------------------SSSSSSS-------------------------SQQ-----------oo-----------SSSS------------o------------SSS------------------------SSSS---------------------SS-SSSS------------o-----------SSSS------------o-----------SSSS------------o-----------SSSS-------------------------SQQ------------------------SSSS------------o-----------SSSS---------oo-o-----------SSSS------------o-----------SSSS---------------------SS-SSSS---------oooo----E------SSS-------------------------SSSS---------oooo----E------SSS----------o--o----E------SSSS---------oooo----E------SSSS-----------oo-----------SSSS---------oooo----E------SSSS---------o--o-----------SSSS-----------------E------SSSS------------o----E------SSSS---------oooo-----------SSSS------------------------SSSS-------------------------SQQ-----------ooo---------SSSSS---------oo-------------SSS-------------o-----------SSSS------------o-----------SSSS------------o-----------SSSS---------oooo----EX-----SSS----------o--------------SSSS---------oooo----E------SSS-------------------------SSSS----------ooooo---------SSSS------------o-----------SSSS------------o-----------SSSS--------------E---------SSSS------------o-----------SSSS------------o-----------SSSS--------------E----------SSS------------o-----------SSSS-------------------------SSS------------o-----------SSSS
-----------------------------------------------------------------------------------------------------------------------------------------------------------------------------------------------------------------------------------------------------------------------------------------------------------------------------------------------------------------------------------------S--------------------------------------------------------------------------------------------------------------------------------------------------------------------------------------------------------------------------------------o-----------------------------------------------------------------------------------o-------------------------------------------------------o---------------------------o-----------------------------------------------------------------------------------------------------------------------------------------------------------------------------------------------------------------------------------------------------------o---------------------------o----------------------------------------------------------------------------------------------------------------------------------------------------------------<>----------------------------------------------------------------------------------<>-----------------------------------------------------------------------------------------o-------
-------------------------------------------------------------------------------------------------------------------o--------------------------------SS--------------------------SS------------------------------------------------------------------------------------------------------------------------------------------SS---------------------E----SS--------------------------SS--------------------------SS--------------------SS--S-SSS-------------------------S-------------------------------------------------------SS---------------------S--S-SS------------------------S-SS--------------------------SS------------------------S-SSS-------------------------SS--------------------------SS--------------------------S-------------------o-------S---------------------------S---------------------------SS--------------------------S----------------------o----------------------------------------------------------S-S---------------------------SS------------------------------------------------------SS------------------o-----S-SSS-------------------------S-------------------o-----S-SS------------------------------------------------------SSSSSSS--------------------------------------------E----SS---------------------E--S-SSS--[]----------------o----SS--------------------------SS---------------------o----SS---[]---------------------SS---------------------o----------------------------------------------------
------------------E-------------------------------------------------------E---------------------------E---------------------------E---------------SoS---------E-----------------S---------E--o------------------------E---------------------------E---------------------------E---------------------------E---------------SoS---------E-----------------S---------E--o--------------S---------E---------------SoS---------E--o-------oSS--SoS---------E--o--------------S---------E---------------------------E---------------SoS---------E----------oS---SoS---------E--o------------SoS---------E---------------SoS---------E---------------SoS---------E---------------SoS---------E---------------SoS---------E---------------SoS---------E---------------SoS---------E---------------SoS---------E---------------SoS---------E-----------------S---------E---------------------------E---------------------------E---------------SoS---------E---------------SoS---------E---------------------------E---------------SoS---------E--o------------SoS---------E---------------SoS---------E---------------SoS---------E---------------------------E---------------SoS---Q-----E---------------------------E---------------SoS---------E--o------------SoS----XX---E--o------------SoS---------E---------------SoS---------E---------------SoS----[]---E---------------SoS---------E---------------------------E--o------------------------E---------
-----------------<>-----E--------------------<>--S-----------------------<>-----E--S-----------------<>--------S-----------------<>------E?S-------SS--------<>------E?S-----------------<>------E?S-----------------<>------E?S-----------------<>------E?S-----------------<>------E?S-----------------<>------E?S--S---SSS--------<>------E?S-------SS--------<>------E?S-------SS--------<>------E?S--S---SSS--------<>------E?SSSS---SSS--------<>------E?S-----------------<>------E?S-----------------<>-----E-?S-------SS--------<>------S?SSSS---SSS--------<>------E?SXX----SSS----XX--<>------S?S--S---SSS--------<>------E?SXXS---SSS----XX--<>------E?X------SSS--------<>------E?S-SS---SSS--------<>------E?SXXS---SSS--------<>------E?XXXS----SS----XX--<>------E?X--S----SS--------<>------E?XXXS---SSS--------<>------E?S-----------------<>------E?S-----------------<>------E?S-----------------<>------E?SXXS---SSS--------<>------EXX-SS---SSS--------<>------E?S-----------------<>------E-S-------SS--------<>------E?SXXS---SSS----XX--<>------E--XXS---SSS--------<>------E-SXXX---SSS----XX--<>--XX--XXX-----------------<>------E?S-------SS--------<>------S?S-----------------<>------E?S--S----SS--------<>------E?SSSS---SSS--------<>------E?S-SS----SS--------<>------E?S--S----SS--------<>------E?SXXS----SS--------<>------E?SSSS---SSS--------<>------E?S-----------------<>------E?S-----------------<>------E?S
-----------------[]----<>--------------------[]-------X------------------[]----<>--------------------[]--------------------------[]------------o-------------[]--------------------------[]--------------------------[]--------------------------[]--------------------------[]--------------------------[]--------------------------[]--------------------------[]--------------------------[]------------o-------------[]--------------------------[]--------------------------[]--------------------------[]----<>-----Eo-------------[]------------o-------------[]-----E------o-------------[]------------o-------------[]------------o-------------[]------------o-------------[]------------o-------------[]------------o-------------[]------------o-------------[]------------o-------------[]------------o-------------[]--------------------------[]--------------------------[]--------------------------[]--------------------------[]------------o-------------[]------------o-------------[]------------o-------------[]------------o-------------[]--------------------------[]--------------------------[]--------------------------[]--------------------------[]--------------------------[]------------o-------------[]--------------------------[]--------------------------[]------------o-------------[]--------------------------[]------------o-------------[]--------------------------[]--------------------------[]---------
-----------------[]----[]--------------------[]--------------------------[]----[]--------------------[]--------------------------[]-----------XXXXX----------[]------------XX------------[]--------------------------[]--------------------------[]-----------XXXXX----------[]------------XXX-----------[]-----------XXXX-----------[]-----------XXXX-----------[]-----------XXXXX----------[]-----------XXXXX----------[]-----------XXXX-----------[]-----------XXXXX----------[]--------------------------[]----[]-----XXXXX----------[]-----------XXXXX----------[]-----------XXXXXX---------[]-----------XXXXX----------[]-----------XXXXX----------[]-----------XXXXX----------[]-----------XXXXX----------[]-----------XXXXX----------[]-----------XXXXX----------[]-----------XXXXX----------[]-----------XXXXX----------[]-----------XXXXX----------[]-------------X------------[]-----------XXXXX----------[]-----------XXXX-----------[]-----------XXXXX----------[]-----------XXXXX----------[]-----------XXXXX----------[]-----------XXXXX----------[]-----------XXXXX----------[]----<>-----XXXXXX---------[]--------------------------[]-----------XXXXXX---------[]------------XXX-----------[]-----------XXXXX----------[]-----------XXXX-----------[]-----------XXXXX----------[]-----------XXXXX----------[]-----------XXXXXX---------[]-----------XXXXX----------[]--------------------------[]-----------XXXX-----------[]---------
-----------E--E--[]----[]-E--------------EE--[]-------X------------E--E--[]----[]--------------E-EE--[]--------------------E-E---[]--------------------------[]--------------------------[]--------------------E-E---[]-------------------EE-E---[]--------------------------[]--------------------------[]--------------------------[]------------------E-E-----[]--------------------------[]--------------------------[]--------------------------[]--------------------------[]--------------------E-----[]----[]--------------------[]------------------E-------[]--------------------------[]--------------------------[]--------------------------[]--------------------------[]--------------------------[]--------------------------[]-----------------------E--[]--------------------------[]--------------------------[]--------------------------[]--------------------E-----[]--------------------------[]--------------------------[]--------------------------[]-----------------------E--[]--------------------------[]--------------------------[]------------------E-------[]----[]--------------------[]-------------------EE-----[]--------------------------[]--------------------------[]--------------------------[]--------------------------[]--------------------------[]--------------------------[]--------------------------[]--------------------------[]--------------------E-----[]-----------------------E--[]---------
XXX----XXXXXXXXXXXXXXXXXXXXXXXX------XXXXXXXXXXXXXXXXXXXXXX-----XXXXXXXXXXXXXXXXXXXXXXX------XXXXXXXXXXXXXXXXXXXXX-------XXXXXXXXXXXXXXXXXXX----------XXXXXXXXXXXXXXXXXX---------XXXXXXXXXXXXXXXXXXXXXX-----XXXXXXXXXXXXXXXXXXXXXXX----XXXXXXXXXXXXXXXXXXXXXX---------XXXXXXXXXXXXXXXXXXX--------XXXXXXXXXXXXXXXXXXX----------XXXXXXXXXXXXXXXXXX---------XXXXXXXXXXXXXXXXXXX----------XXXXXXXXXXXXXXXXXX----------XXXXXXXXXXXXXXXXXX----------XXXXXXXXXXXXXXXXXX----------XXXXXXXXXXXXXXXXXXXXX------XXXXXXXXXXXXXXXXXXX----------XXXXXXXXXXXXXXXXXX----------XXXXXXXXXXXXXXXXXX-----------XXXXXXXXXXXXXXXXX----------XXXXXXXXXXXXXXXXXX----------XXXXXXXXXXXXXXXXXX----------XXXXXXXXXXXXXXXXXX----------XXXXXXXXXXXXXXXXXX----------XXXXXXXXXXXXXXXXXX----------XXXXXXXXXXXXXXXXXX----------XXXXXXXXXXXXXXXXXX----------XXXXXXXXXXXXXXXXXX----------XXXXXXXXXXXXXXXXXXXX-------XXXXXXXXXXXXXXXXXXX----------XXXXXXXXXXXXXXXXXX----------XXXXXXXXXXXXXXXXXX----------XXXXXXXXXXXXXXXXXX----------XXXXXXXXXXXXXXXXXX----------XXXXXXXXXXXXXXXXXX-----------XXX-XXXXXXXXXXXXX----------XXXXXXXXXXXXXXXXXX-----------XXXXXXXXXXXXXXXXXXXX----XXXXXXXXXXXXXXXXXXXXX-----------XXXXXXXXXXXXXXXXX----------XXXXXXXXXXXXXXXXXX----------XXXXXXXXXXXXXXXXXX----------XXXXXXXXXXXXXXXXXX----------XXXXXXXXXXXXXXXXXX----------XXXXXXXXXXXXXXXXXX----------XXXXXXXXXXXXXXXXXX----------XXXXXXXXXXXXXXXXXXXX-------XXXXXXXXXXXXXXXXXXX----------XXXXXXXXXXXXXXXXXX
