--------------------------------------------------------------------------------------------------------------------------------------------------------------------------------------------------------------------------------------------------------------------------------------------------------------------------------------------------------------------------------------------------------------------------------------------------------------------------------------------------------------------------------------------------------------------------------------------------------------------------------------------------------------------------------------------------------------------------------------------------------------------------------------------------------------------------------------------------------------------------------------------------------------------------------------------------------------------------------------------------------------------------------------------------------------------------------------------------------------------------------------------------------------------------------------------------------------------------------------------------------------------------------------------------------------------------------------------------------------------------------------------------------------------------------------------------------
--------------------------------------------------------------------------------------------------------------------------------------------------------------------------------------------------------------------------------------------------------------------------------------------------------------------------------------------------------------------------------------------------------------------------------------------------------------------------------------------------------------------------------------------------------------------------------------------------------------------------------------------------------------------------------------------------------------------------------------------------------------------------------------------------------------------------------------------------------------------------------------------------------------------------------------------------------------------------------------------------------------------------------------------------------------------------------------------------------------------------------------------------------------------------------------------------------------------------------------------------------------------------------------------------------------------------------------------------------------------------------------------------------------------------------------------------------
--------------------------------------------------------------------------------------------------------------------------------------------------------------------------------------------------------------------------------------------------------------------------------------------------------------------------------------------------------------------------------------------------------------------------------------------------------------------------------------------------------------------------------------------------------------------------------------------------------------------------------------------------------------------------------------------------------------------------------------------------------------------------------------------------------------------------------------------------------------------------------------------------------------------------------------------------------------------------------------------------------------------------------------------------------------------------------------------------------------------------------------------------------------------------------------------------------------------------------------------------------------------------------------------------------------------------------------------------------------------------------------------------------------------------------------------------------
-------------------------------------------------------------------------------------------------------------------------------------------------------------------------------------------------------------------------------------------------------------------------------------------------------------------------------------------------------------------------------------------------------------------------------------------------------------------------------------------------------------------------------------------------------------------------------------------------------------------------------------------------------------------------------------------------------------------o------------------------------------------------------------------------------------------------------------------------------------------------------------------------------------------------------------------------------------------------------------------------------------------------------------------------------------------------------------------------------------------------------------------------------------------------------------------------------------------------------------------------------------------------------------------------------------------------------------------------------------------------------------------------------------------------------------------------------------
--------------------------------------------------------------------------------------------------------------------------------------------------------------------------------------------------------------------------------------------------------------------------------------------------------------------------------------------------------------------------------------------------------------------------------------------------------------------------------------------------------------------------------------------------------------------------------------------------------------------------------------------------------------------------------------------------------------------------------------------------------------------------------------------------------------------------------------------------------------------------------------------------------------------------------------------------------------------------------------------------------------------------------------------------------------------------------------------------------------------------------------------------------------------------------------------------------------------------------------------------------------------------------------------------------------------------------------------------------------------------------------------------------------------------------------------------------
---------Q-Q---------------------------------------------------?-?--E-----------SSSSo--------QQQQ----------SSSS----------Q-Q-----------------------------------------------------?--E------------------------?--E----------SSSSS-------?-Q--E------------------------?--E-----------S---o--------Q------------------o--------Q-QQ-----------SSS----------?--E------------------------Q---------------------------?--E------------------------?--E-----------S------------------SS------------------?-QQQQ-----------SSS----------QQQQ------------------------Q-Q-------------------------?--E-----------SSQQ------------E----------------------?-QQQQ-----------SSS---------------------------------------------SS-------------------?--E------------SSS--------------------------SS----------------S--------------------?Q?QS---------SSSSS---------Q--E----------------------------------------------------?-?-----------------------------------------------------Q-Q-------------------------?--------------SSSS---------?--E------------------------?--E------------------------?---------------------------?--E------------S-----------?--E-----------SS-----------?--E-------------------------------S-------SSS----------?--E------------------------?--E----------------------------------------------------?--E---------------o--------?--E-----------S------------?--E-----------S------------Q-Q-------------------------?--E---------------
-------------------------------------------------------------------XXXXXX--------------------------X--------------------------------------XX---------------------------------------XXXXXX------------------------XXX-----------------------XX-X------------------------XXXXX---o------XX----------------------------------------------------------------------X-----------XX---------------------------------------XXXXXX----------------------XXXXXX-----------------------------------------------------XX--------------------------------------XX--------------------------XX------------------------------------------X---------------------------X-------------------------------------------------------XX-----------------------XXXXX-------------------------------------------------------------------X--------------XX--------------------------------------------------------------------------------------------------------------X---------------------------------------------------------------------------------XXXX-----------------------XXXXX-----------X--------------------------XX-----------QXXXX-----------------------XXXXXX-------------------------XX-----------X---------------------------------------XXXXXX---------XX-----------XXXXXX----------X------------------------------------------X------------------------XXXXXX---------XX-----------QXXXX-----------X----------------------------------------X-XX-----------X
------------------------------------------------------------------------------------------------------------------------------------X-------------------------------------------------------------------------------------------------------------------------------------Q---XXX-------------------------------------------------------------------------------------------------------------------------------------------------------------------------------------------------------------------------Q---------------------------------X-----------------Q---------------------------------------------------------------------------------------Q-----------------------------------------------------------------------------------------------------------------------------------------------------------------------------------------------------------------------------------------------------------------------------------------------------------------------------------------------------------------------------------------------------------------------------------------------------------------------------------------------------------------------------------------------------------------------------------------------------------------------------------------------------------------------------------------------Q---XXX---------------------Q---------------------------------------------------------------------
----E----------------E----------E-------------------------E---------------------E--o---------------------E--?------------------------E----------------------------------------------------E---------------E-----------------------E------------------E------------E-------------------------E----------------E------------E--------------E---------------------------E------------E--------------E------------------------------E-------------------------------------E--------------E--------E-E----------------E----------E----------------E------------E-----------------------E---------------E--E----------E-------------------------E------------------E----------E-----------------------------E--------------E--------E---------------------E--o------------------E---------------E--------------E--------------------------------------E---------------------------E-------------------------E---E--------------E------------E------------------------------------------E--------------------------------------E---------------------------------------------------------E--------------E------------------------------------------------------------------------------------------------E-----------------------------------------------------------------------------------E--------------E----------------------------------------E----------------------------------------------------------------------E----------------------------------
--E<>-----QQQ-------<>---------<>----------------------X-<>----E?SQ-------E----<>-----E-E<>--SQQQ-------<>--------E-------QQQQ------<>----QQ--E-E--E--QQQ-----------------E-E----SQQQ----<>-----E-----E-E<>---QQQQ---------------<>->--E?SQQQ----S--<>----------E<>---QQQQ---Q------------E<>--Q?-QQQ-------<>--------E--<>--SQQQ-------<>--------E-E<>--SQQQ-------<>-----Q--E--<>---QQQQ------<>--------E-E----SQQQ-----E----<>-----E-E-E--SQQQ-----------E-----E-E<>---QQQQ------<>-----Q-<><>--E?SQQQ-------<>--------E<>--E?SQQQ-------<>---QQQ--E--<>---QQQQ---Q---E---QQQ-<>----E-SQQQ----<>-<>--------E<>-----QQQ-----------E--X-<>----E?SQQQ-------<>--------E<>--E-SQQQ-----------------E-E<>---QQQ-------<>----QQ-<>----S?S--------E----<>-----E--------------<>-----E-----E--<>---QQQQ------<>-----Q--E--<>-----------------------E<>--E?SQQQ-----------------E<>-------------------------E--<>---SQQ-------<>--------E-E<>---QQQQ----------------E--<>---QQQQ------<>--------E-E-----QQQ-----------------E<>-----QQQ-----------E-----E-E----SQQQ-----------------E-E<>---QQQQ------<>--------E-E--E-SQQQ-------------------E<>--SQQQ-----------E-----E-E----SQQQQ------------------E<>---QQQQ----------------E-E----SQQQ-----------------E-E----SQQQ-----------------E-E<>---QQQQ------<>--------E-E----SQQQQ----------------E-E<>--SQQQ-----------------E-E----SQQQ-----------------E-E<>---QQQQ------<>-----Q--E-E<>--SQQQ---------------
-<>[]---------------[]---------[]----------------E-------[]--------------<>----[]----<><>[]-------------[]-------<>--<>-------------[]-------<><>------------------------<><>------------[]----<>----<><>[]----------------------[][]---------------[]--E-----E<>[]----------------------<>[]---------------[]-------<>--[]-------------[]-------<><>[]-------------[]-------<>--[]-------------[]-------<><>------------------[]----<><>[>----------------<>----<><>[]-------------[]-------[][]---------------[]-------<>[]---------------[]-------<>--[]-------------<>-------[]--------------[]-[]-------<>[]------------------<>-XX-[]-----------------[]-------<>[]------------E------E----<><>[]-------------[]-------[]--------------<>----[]----<>--------------[]----<>----<>--[]-------------[]-------<>--[]----------------------<>[]------------------------<>[]----------------E-------<>--[]-------------[]-------<><>[]-----------------E----<>--[]-------------[]-------<><>------------------------<>[]------------------<>----<><>-------------------E----<><>[]-------------[]-------<>[>------------------<>----<><>[]----------------<>----<><>-------------------------E<>[]----------------------<><>------------------------<><>-------------------E----<><>[]-------------[]-------<><>------------------------<><>[]-----------------E----<><>------------------------<><>[]-------------[]-------<><>[]---------------------
-[][]---------------[]---------[]---------------<>-----X-[]--------------[]----[]----[][][]-------------[]-------[]--[]-------------[]-------[][]------------------------[][]------------[]----[]----[][][]----------------------[][]---------------[]-<>----<>[][]----------------------[][]---------------[]-------[]--[]-------------[]-------[][][]-------------[]-------[]--[]-------------[]-------[][]-X----------------[]----[][][]----------------[]----[][][]-------------[]-------[][]---------------[]-------[][]---------------[]-------[]--[]-------------[]-------[]--------------[]-[]-------[][]------------------[]--X-[]-----------------[]-------[][]------------------<>----[][][]-------------[]-------[]--------------[]----[]----[]--------------[]----[]----[]--[]-------------[]-------[]--[]----------------------[][]------------------------[][]----<>---------<>-------[]--[]-------------[]-------[][][]----------------<>----[]--[]-------------[]-------[][]------------------------[][]------------------[]----[][]------------------<>----[][][]-------------[]-------[][]------------------[]----[][][]----------------[]----[][]------------------------<>[][]----------------------[][]------------------<>----[][]------------------<>----[][][]-------------[]-------[][]------------------------[][][]----------------<>----[][]------------------------[][][]-------------[]-------[][][]----------------<>---
-[][]---------E-EE--[]-E--E----[]---------EEEE--[]-E-----[]-----E-----E--[]E---[]----[][][]-------E-EE--[]-E-EE--[]-E[]-------E-EE--[]-EE-E--[][]-E-------E-EE-E---------[][]--------EE-E[]----[]----[][][]------EE-EE-E---------[][]---------E-EE--[]-[]----[][][]-E----EE-EE-----E--E--[][]---------E--E--[]-E--E--[]-E[]-------E-EE--[]-E--E--[][][]------EE-EE--[]----E--[]-E[]------EE-EE--[]----E--[][]-X------EE-EE-E---[]----[][][]------EE-EE-E---[]----[][][]------EE-EE--[]-EE-E--[][]---------E-EE--[]-------[][]---------E-EE--[]-EE-E--[]--[]-------E-EE--[]-EE-E--[]-----------E--[]-[]-------[][]--------EE-EE-E---[]-XX-[]-----------E-EE--[]-------[][]---------E-EE-----[]----[][][]------E--E---[]-E--E--[]-----E----EE-E[]E---[]----[]----------EE-E[]----[]----[]-E[]-------EEEE--[]-EE-E--[]--[]-------E-EE-----E-E---[][]---------E-EE-E---------[][]-E--[]---E-EE--[]-EE-E--[]-E[]-------E-EE--[]-E-E---[][][]------EE-EE-E---[]----[]--[]------EE-EE--[]-------[][]-E------EE-EE-----------[][]-E------EE-EE-E---[]----[][]--------EE-EE-E---[]----[][][]------EE-EE--[]--E-E--[][]--------EE-EE-E---[]----[][][]------EE-EE-E---[]----[][]-E------EE-EE--------E--[][][]------EE-EE-----E-----[][]-E------EE-EE-E---[]----[][]-E------EE-EE-E---[]----[][][]------EE-EE--[]-E--E--[][]-E------EE-EE-----------[][][]-E----EE-EE-E---[]----[][]--------EE-EE-E---------[][][]-------E-EE--[]-EE-E--[][][]------EE-EE-E---[]---
-XXXXXXXXXXXXXXXXXXXXXXXXXXXXXXXXXXXXXXXXXXXXXXXXXXXXXXXXXXXXXXXXXXXXXXXXXXXXXXXXXXX-XXXXXXXXXXXXXXXXXXXXXXXXXXXXXXXXXXXXXXXXXXXXXXXXXXXXXXX-XXXXXXXXXXXXXXXXXXXXXXXXXXXXXXXXXXXXXXXXXXXXXXXXXXXXXXX-XXXXXXXXXXXXXXXXXXXXXXXXXXXXXXXXXXXXXXXXXXXXXXXXXXXXXXX-XXXXXXXXXXXXXXXXXXXXXXXXXXX-XXXXXXXXXXXXXXXXXXXXXXXXXXX-XXXXXXXXXXXXXXXXXXXXXXXXXXXXXXXXXXXXXXXXXXXXXXXXXXXXXXX-XXXXXXXXXXXXXXXXXXXXXXXXXXXXXXXXXXXXXXXXXXXXXXXXXXXXXXXXXXXXXXXXXXXXXXXXXXXXXXXXXXX-XXXXXXXXXXXXXXXXXXXXXXXXXXX-XXXXXXXXXXXXXXXXXXXXXXXXXXX-XXXXXXXXXXXXXXXXXXXXXXXXXXXXXXXXXXXXXXXXXXXXXXXXXXXXXXXXXXXXXXXXXXXXXXXXXXXXXXXXXXX-XXXXXXXXXXXXXXXXXXXXXXXXXXX-XXXXXXXXXXXXXXXXXXXXXXXXXXXXXXXXXXXXXXXXXXXXXXXXXXXXXXX-XXXXXXXXXXXXXXXXXXXXXXXXXXX-XXXXXXXXXXXXXXXXXXXXXXXXXXX-XXXXXXXXXXXXXXXXXXXXXXXXXXX-XXXXXXXXXXXXXXXXXXXXXXXXXXX-XXXXXXXXXXXXXXXXXXXXXXXXXXX-XXXXXXXXXXXXXXXXXXXXXXXXXXX-XXXXXXXXXXXXXXXXXXXXXXXXXXX-XXXXXXXXXXXXXXXXXXXXXXXXXXX-XXXXXXXXXXXXXXXXXXXXXXXXXXX-XXXXXXXXXXXXXXXXXXXXXXXXXXX-XXXXXXXXXXXXXXXXXXXXXXXXXXX-XXXXXXXXXXXXXXXXXXXXXXXXXXX-XXXXXXXXXXXXXXXXXXXXXXXXXXX-XXXXXXXXXXXXXXXXXXXXXXXXXXX-XXXXXXXXXXXXXXXXXXXXXXXXXXX-XXXXXXXXXXXXXXXXXXXXXXXXXXX-XXXXXXXXXXXXXXXXXXXXXXXXXXX-XXXXXXXXXXXXXXXXXXXXXXXXXXX-XXXXXXXXXXXXXXXXXXXXXXXXXXX-XXXXXXXXXXXXXXXXXXXXXXXXXXXXXXXXXXXXXXXXXXXXXXXXXXXXXXX-XXXXXXXXXXXXXXXXXXXXXXXXXXX-XXXXXXXXXXXXXXXXXXXXXXXXXXX-XXXXXXXXXXXXXXXXXXXXXXXXXXX-XXXXXXXXXXXXXXXXXXXXXXXXXXX-XXXXXXXXXXXXXXXXXXXXXXXXXXX
