--------------------------------------------------------------------------------------------------------------------------------------------------------------------------------------------------------------------------------------------------------------------------------------------------------------------------------------------------------------------------------------------------------------------------------------------------------------------------------------------------------------------------------------------------------------------------------------------------------------------------------------------------------------------------------------------------------------------------------------------------------------------------------------------------------------------------------------------------------------------------------------------------------------------------------------------------------------------------------------------------------------------------------------------------------------------------------------------------------------------------------------------------------------------------------------------------------------------------------------------------------------------------------------------------------------------------------------------------------------------------------------------------------------------------------------------------------
--------------------------------------------------------------------------------------------------------------------------------------------------------------------------------------------------------------------------------------------------------------------------------------------------------------------------------------------------------------------------------------------------------------------------------------------------------------------------------------------------------------------------------------------------------------------------------------------------------------------------------------------------------------------------------------------------------------------------------------------------------------------------------------------------------------------------------------------------------------------------------------------------------------------------------------------------------------------------------------------------------------------------------------------------------------------------------------------------------------------------------------------------------------------------------------------------------------------------------------------------------------------------------------------------------------------------------------------------------------------------------------------------------------------------------------------------------
--------------------------------------------------------------------------------------------------------------------------------------------------------------------------------------------------------------------------------------------------------------------------------------------------------------------------------------------------------------------------------------------------------------------------------------------------------------------------------------------------------------------------------------------------------------------------------------------------------------------------------------------------------------------------------------------------------------------------------------------------------------------------------------------------------------------------------------------------------------------------------------------------------------------------------------------------------------------------------------------------------------------------------------------------------------------------------------------------------------------------------------------------------------------------------------------------------------------------------------------------------------------------------------------------------------------------------------------------------------------------------------------------------------------------------------------------------
------------------------------------------------------------------------------------------------------------------------------------------------------------------------------------------------------------------------------------------------------------------------------------------------------------------------------------------------------------------------------------------------------------------------------------------------------------------------------------------------------------------------------XX--------------------------------------------------------o---------------------------------------------------------------------------------------------------------------------------------------------------------------------------------------------------------------------------------------------------------------------------------------------------------------------------------------------------------------------------------------------------------------------------------------------------------------------------------------------------------------------------------------------------------------------------------------------------------------------------------------------------------------------------------------------------------------------------------------------------------------------------------------------------------------------------------------------------------------
--------------------------------------------------------------------------------------------------------------------------------------------------------------------------------------------------------------------------------------------------------------------------------------------------------------------------------------------------------------------------------------------------------------------------------------------------------------------------------------------------------------------------------------------------------------------------------------------------------------------------------------------------------------------------------------------------------------------------------------------------------------------------------------------------------------------------------------------------------------------------------------------------------------------------------------------------------------------------------------------------------------------------------------------------------------------------------------------------------------------------------------------------------------------------------------------------------------------------------------------------------------------------------------------------------------------------------------------------------------------------------------------------------------------------------------------------------
---------------------------Q-------------------------------------------------------S---------QQQQ-------------Q----------Q-Q---SS--------------------?-Q----------------------------E------------SSS---------?--E----------------------?-QQQQ------------------------Q-Q------------SSS-o--------?--E-----------SSS--------?-QQ--------------SSS---------?-QE------------SS----------Q-Q-----------------------------------------------------?--E-----------SSSS---------?--E------------SS------------Q-------------------------?--E--------SSSSSSS-------------------------------------?-------------------------Q-QQQQ-------------------------------S-------SSSS---------?--E--------SSSSSSS---------?-QE------------------------Q-Q----S--------------------Q--E------------SSSo--------?S-E-----------SSSS---------?--E----------SSSS----------Q-Q----------------o--------?--------------SS-----------?--E------------------------Q------S--------------------Q-Q--Q-S--------------------?--E-----------SSSS---------?-QE------------------------QQQQ------------------------Q---------------------------?--E------------------------?--E------------------------?--E-----------SSSS----------------------------o--------?-QQ-----------SSS----------?--E----------------------?-?-QE------------------------------SS-------------------------------------S----------?--E-----------S------------Q--E------------------------Q-Q----------------
--------------------------------------------------------------------------------------------------X-------------------------------------------------------XX----------XX--------------X------------------------XXXXX----------------------------------------------------------------------------------XX------------------------XXXX-------------------------XXX---------------------------------------X---------------------------------------XXXXXX-------------------------XX--------------------------XX--------------------------X-------------------------------------------------------XX--------------------------------------------------------------------------------XXXX--------------------------X-----------XX--------------------------XX----------------------------------------XXXX-----------------------XXXXX-----------------------------------------------------XXX-----------------------XXXXX-----------X---------------------------X---------------------------------------XXXXX--------------------------XX----------XX----------------------------------------------------------------------XX-----------X-----------XXXXX-----------------------XXXXXX-----------------------------------------------------XX-----------------------XXXXX-----------------------QXXXX---------XXX------------------------------------------X------------------------XXXXXX--------------------------------------X----------------------------
--------------------------------------------------------------------------------------------------------------------------------------------------------------------------------------------------------------------------------------------------------------------------------------------------------------------------------------------------------------------------------------------------------------------------------------------------------------------------------------------------------------------------------------------------------------------------------------------------------------------------------------------------------------------------E---------------------------------------------------------------------------------------------------------------------------------------------------Q-------------------------------------------------------Q-------------------------------------------------------------------------------------------------------------------------------------------------------------------------------------------------------------------------------------X-----------------------------------------------------------------------------------------------------------------------------------------------------------------Q---XXX-----------------------------------------------------------------------------Q---------------------------------------------------------------------
--E---------------E--------------------------------E-----------------------------------------------------E----------------------------------------E-------------------------E-------------------E--o----E--------------------------------------------E---------------------------E------------E-------------------------E--------------------------------------------E------------E--------------E------------E-----------------------------------------------------------------------------------E--------------E--------E---------------------E------------------------E------------E----------------------------------------------------------------------------------<>-------------------------------------------------------E---------------------------------------E-------------E-----------------------------E---------------------------E--------------E---------------------------E----------------------------------------E--------------E---------------------------E--------E-E-------------------E---------E--------------E---------------------------E----------E-----------------------------E--------------E----------------------------------------------------------E------------------------E------------E--------------E----------E-------------------E--o---------------------E------------E--------------E----------E-----------------------------E-------------------------E-----------------------------E--------------E------
-<>----E---------<>-----E-----E-------------------<>------E--XX-----------------------E<>--E?SQQQ-------<>---QQQ-------Q--QQQQ------------QQ--E-E<>---QQQ-------<>----QQ--E<>----SQ-------E----<>-----E<>-----QQQ-----------------E----E?SQQQ-------<>----E---E<>--E-SQQQ-------<>---QQQ----E<>---QQQQ------<>--------E<>--E?SQQQ-----------------E-E<>--SQQQ-------<>--------E--<>---QQQQ------<>----QQ--E-E<>---QQQQ----------------E---E--SQQQ----<>-----E-----E-E<>--SQQQ-----------------E-E<>---QQQQ------<>-------<>------S-------<>----<>----------Q--QQQ----E--<>---QQQ--E--<>---QQQ----Q---------Q-------Q?QQQQQ-----------QQQ----E-----Q-------------------E--[]----QQ-----------E-----E-E--E-SQQQ--------------Q--E--<>---QQQQ------<>---QQQ--E-E----SQQQ----<>-----------E<>---SSQQQ-----------------E-E<>--SQQQ-----------------E--<>---QQQ-------<>----QQ--E-E<>--SQQQ-------<>--------E<>--E?SQQQ-----------------E--<>---QQQQ------<>---QQQ--E----Q--QQQQ------<>---QQ?-<><>---?S--------E----<>-----E-E<>--SQQQ-------<>-----Q--E--<>--SQQQ-------<>----QQ--E<>--E-SQQQ-----------------E-E<>---QQQQ------<>-----Q--E-E<>--SQQQ-----------E-----E---E--SQQQ----------<>-------E--E--QQQ-------<>----QQ--E-E<>---QQQ-------<>--------E<>---?SQQQ----------<>-----E-E-EE?SQQQ-------<>---QQQ--E-E<>---QQQQ------<>-----Q--E<>-----QQQ-----------E-----E--<>--SQQQ-----------E-----E<>--E?SQQQ-----------------E--<>---QQQ-------<>----QQ
-[]--------------[]----<>----<>-------------------[]--E--<>--XX----------------------<>[]---------------[]-----------------------------------<><>[]-------------[]-------<>[]------------<>----[]----<>[]------------------------<>-----------------[]---<>--<>[]---------------[]-------<><>[]-------------[]-------<>[]-------------------E----<><>[]-------------[]-------<>--[]-------------[]-------<><>[]----------------------<><><>----------[]----<>----<><>[]-----------------E----<><>[]-------------[]-------[]--------------[]----[]-------------------<>--[]-------<>--[]---------------------------------------------------E<>------------------------<>--[]----------------<>----<><>------------------------<>--[]-------------[]-------<><>------------[]-----E----<>[]------------------------<><>[]----------------------<>--[]-------------[]-------<><>[]-------------[]-------<>[]------------------------<>--[]-------------[]-------<>-----------------[]-------[][]------------<>----[]----<><>[]-------------[]-------<>--[]-------------[]-------<>[]------------------------<><>[]-------------[]-------<><>[]----------------<>----<>--<>----------------[]----<><>---------------[]-------<><>[]-------------[]-------<>[]------------------[]----<><><>-------------[]-------<><>[]-------------[]-------<>[]-------------------E----<>--[]----------------<>----<>[]------------------------<>--[]-------------[]------
-[]--------------[]----[]----[]-------------------[]-<>--[]--XX----------------X-----[][]---------------[]-----------------------------------[][][]-------------[]-------[][]------------[]----[]----[][]------------------------[]-----------------[]---[]--[][]---------------[]-------[][][]-------------[]-------[][]------------------<>----[][][]-------------[]-------[]--[]-------------[]-------[][][]----------------------[][][]----------[]----[]----[][][]----------------<>----[][][]-------------[]-------[]--------------[]----[]-------------------[]--[]-------[]--[]-------------<>-------<>--------------------------<>[]------------------------[]--[]----------------[]----[][]------------------------[]--[]-------------[]-------[][]-E----------[]----<>----[][]------------------------[][][]----------------------[]--[]-------------[]-------[][][]-------------[]-------[][]------------------------[]--[]-------------[]-------[]-----------------[]-------[][]------------[]----[]----[][][]-------------[]-------[]--[]-------------[]-------[][]------------------------[][][]-------------[]-------[][][]----------------[]----[]--[]----------------[]----[][]---------------[]-------[][][]-------------[]-------[][]------------------[]----[][][]-------------[]-------[][][]-------------[]-------[][]------------------<>----[]--[]----------------[]----[][]------------------------[]<>[]-------------[]------
-[]----------EE-E[]----[]----[]---------E-E-EE----[]-[]--[]--XX-------E-EE-E---X-----[][]---------E-E---[]-E-----------------EEE-E------E-E--[][][]-------E-EE--[]-EE-E--[][]--------EE-E[]----[]----[][]-E------EE-EE-----E-----[]-----------E--E--[]-E-[]--[][]---------E-EE--[]----E--[][][]------EE-EE--[]-E-----[][]---------E-EE-----[]----[][][]------EE-EE--[]-E--E--[]--[]-------E-EE--[]-EE-E--[][][]------EE-EE-----------[][][]------EE-EXX----[]----[][][]------EE-EE-----[]----[][][]------EE-E---[]-------[]--------E--E--[]-E--[]-----------------E-[]--[]-E--E--[]-E[]-------E-EE--[]-E--E--[]-----------E-E---------E--[][]--------EE--E-----------[]-E[]----E--E-EE-E---[]----[][]---------E-EE------E-E--[]-E[]-------E-EE--[]-EE-E--[][][]-------E--[]----[]----[][]--------EE-EE-E---------[][][]------EE-EE-E---------[]--[]-------E-EE--[]-EE-E--[][][]-------E-EE--[]-E--E--[][]---------E-EE-E---------[]--[]-------E-EE--[]--E-E--[]--------E-EE-----[]-------[][]---------E-EXXE---[]----[][][]-------E-EE--[]----E--[]-E[]-------E-EE--[]-E--E--[][]---------E-EE--------E--[][][]------EE-EE--[]----E--[][][]------EE-EE-E---[]----[]--[]------EE-EE-E---[]----[][]---------E--E--[]--E-E--[][][]------EE-EE--[]-E-E---[][]--------EE-EE-E---[]----[][][]-------E-EE--[]----E--[][][]------EE-EE--[]-EE-E--[][]-E------EE-EE-----[]----[]--[]------EE-EE-E---[]----[][]---------E-EE-----------[][][]-------E-EE--[]-E--E-
-XXXXXXXXXXXXXXXXXXXXXXXXXXX-XXXXXXXXXXXXXXXXXXXXXXXXXXXXXXXXXX--XXXXXXXXXXXXXXXXXXXXXXXXXXXXXXXXXXXXXXXXXXXXXXXXXXX-XXXXXXXXXXXXXXXXXXXXXXX-XXXXXXXXXXXXXXXXXXXXXXXXXXXXXXXXXXXXXXXXXXXXXXXXXXXXXXX-XXXXXXXXXXXXXXXXXXXXXXXXXXX-XXXXXXXXXXXXXXXXXXXXXXXXXXXXXXXXXXXXXXXXXXXXXXXXXXXXXXX-XXXXXXXXXXXXXXXXXXXXXXXXXXXXXXXXXXXXXXXXXXXXXXXXXXXXXXX-XXXXXXXXXXXXXXXXXXXXXXXXXXXXXXXXXXXXXXXXXXXXXXXXXXXXXXX-XXXXXXXXXXXXXXXXXXXXXXXXXXXXXXXXXXXXXXXXXXXXXXXXXXXXXXX-XXXXXXXXXXXXXXXXXXXXXXXXXXX-XXXXXXXXXXXXXXXXXXXXXXXXXXX-XXXXXXXXXXXXXXXXXXXXXXXXXXXXXXXXXXX-XXXXXXXXXXXXXXXXXXX-XXXXXXXXXXXXXXXXXXXXXXXXXXX-XXXXXXXXXXXXXXXXXXXXXXXXXXX-XXXXXXXXXXXXXXXXXXXXXXXXXXX-XXXXXXXXXXXXXXXXXXXXXXXXXXX-XXXXXXXXXXXXXXXXXXXXXXXXXXX-XXXXXXXXXXXXXXXXXXXXXXXXXXXXXXXXXXXXXXXXXXXXXXXXXXXXXXX-XXXXXXXXXXXXXXXXXXXXXXXXXXX-XXXXXXXXXXXXXXXXXXXXXXXXXXXXXXXXXXXXXXXXXXXXXXXXXXXXXXXXXXXXXXXXXXXXXXXXXXXXXXXXXXXXXXXXXXXXXXXXXXXXXXXXXXXXXXXXXXXXXXXXXXXXXXXXXXXXXXXXXXXXXXXXXXXXXXXXXXXXXXXXXXXXXXXXXXXXXXXXXXXXXXXXXXXXXXXXXXX-XXXXXXXXXXXXXXXXXXXXXXXXXXX-XXXXXXXXXXXXXXXXXXXXXXXXXXX-XXXXXXXXXXXXXXXXXXXXXXXXXXX-XXXXXXXXXXXXXXXXXXXXXXXXXXX-XXXXXXXXXXXXXXXXXXXXXXXXXXXXXXXXXXXXXXXXXXXXXXXXXXXXXXX-XXXXXXXXXXXXXXXXXXXXXXXXXXX-XXXXXXXXXXXXXXXXXXXXXXXXXXX-XXXXXXXXXXXXXXXXXXXXXXXXXXXXXXXXXXXXXXXXXXXXXXXXXXXXXXX-XXXXXXXXXXXXXXXXXXXXXXXXXXX-XXXXXXXXXXXXXXXXXXXXXXXXXXXXXXXXXXXXXXXXXXXXXXXXXXXXXXX-XXXXXXXXXXXXXXXXXXXXXXXXXXXXXXXXXXXXXXXXXXXXXXXXXXXXXXX
