--------------------------------------------------------------------------------------------------------------------------------------------------------------------------------------------------------------------------------------------------------------------------------------------------------------------------------------------------------------------------------------------------------------------------------------------------------------------------------------------------------------------------------------------------------------------------------------------------------------------------------------------------------------------------------------------------------------------------------------------------------------------------------------------------------------------------------------------------------------------------------------------------------------------------------------------------------------------------------------------------------------------------------------------------------------------------------------------------------------------------------------------------------------------------------------------------------------------------------------------------------------------------------------------------------------------------------------------------------------------------------------------------------------------------------------------------------
---------------------------------------------------------------------------------------------------------------------------------------------------------------------------------------------------------------------------------------------------------------------------------------------------------------------------------------------------------------------------------------------------------------------------------------------------------------Q---------------------------------------------------------------------------------------------------------------Q------------------------------------------------------------------------------------------------------------------------------------------------------------------------------------------------------------------------------------------------------------------------------------------------------------------------------------------------------------------------------------------------------------------------------------------------------------------------------------------------------------------------------------------------------------------------------------------------------------------------------------------------------------------------------------------------------------------------------------------------------------------------------------------------------------------------------------------------------------------------
--------------------------------------------------------------------------------------------------------------------------------------------------------------------------------------------------------------------------------------------------------------------------------------------------------------------------------------------------------------------------------------------------------------------------------------------------------------------------------------------------------------------------------------------------------------------------------------------------------------------------------------------------------------------------------------------------------------------------------------------------------------------------------------------------------------------------------------------------------------------------------------------------------------------------------------------------------------------------------------------------------------------------------------------------------------------------------------------------------------------------------------------------------------------------------------------------------------------------------------------------------------------------------------------------------------------------------------------------------------------------------------------------------------------------------------------------------
-------------------------------------------------------------------------------------------------------------------------------------------------------------------------------------------------------------------------------------------------------------------------------------------------------------------------------------------------------------------------------------------------------------------------------------------------------------------------------------------------------------------------------------------------------------------------------------------------------------------------------------------------------------------------------------------------------------------------------------------------------------------------------------------------------------------------------------------E------------------------------------------------------------------------------------------------------------------------------------------------------------------------------------------------------------------------------------------------------------------------------------------------------------------------------------------------------------------------------------------------------------------------------------------------------------------------------------------------------------------------------------------------------------------------------------------------------------
--------------------------------------------------------------------------------------------------------------------------------------------------------------------------------------------------------------------------------------------------------------------------------------------------------------------------------------------------------------------------------------------------------------------------------------------------------------------------------------------------------------------------------------------------------------------------------------------------------------------------------------------------------------------------------------------------------------------------------------------------------------------------------------------------------------------------------------------------------------------------------------------------------------------------------------------------------------------------------------------------------------------------------------------------------------------------------------------------------------------------------------------------------------------------------------------------------------------------------------------------------------------------------------------------------------------------------------------------------------------------------------------------------------------------------------------------------
--------------------------Q-o--------?-QQ-----------SSSS---------?--E------------------------Q-QQ------------------------Q---------------SSS---------?--E-----------SS-----------?--E------------------------?--E-----------SSS----------?--E------------------------Q-Q----------------o--------?--E------------SS-o--------?--E-----------SSS-o--------?-QE-----------S------------QQQQ------------------------Q-Q-------------------------?--E-----------SSSS-------------------------SSS-------?-?--E-----------SSSS---------???QSSS-------SSSSS---------Q--E------------SQQ---------?-Q--------------------------------------------o--------?-------------SSSSS---------?--E------------------------QQQQ------------------------Q--E-------------S----------?--E-----------SSS----------?--E----------SSSSSo--------?-QE--------SSSSSS--------?QQQQQ------------------------Q-Q-----------------------------------------------------?--E----------SSSSS---------?---------------------------QQQQ------------S-----------?--E------------------------Q-Q----S-------S------------?--E------------------------?--E-----------SS-----------?--E------------------------Q-Q-------------------------?--E------------------------?--E-----------SSS----------Q-Q-------------------------?-QE------------------------?--E------------------------?--E------------SS----------?--E------------------------?--E------------------------?--E---------------
---------------------------------------??XXX-----------------------XXXXX---------------------------------------X------------------------------------------XX-----------------------XXXXX-----------X-----------QXXXX-----------------------XXXXXX--------------------------------------X--------------XX-----------------------XXXXXX----------------------XXXXXX--o------XX-------------------------------------------------------------------XX-XXX-----------------------------------------------------X--------------------------XXX-------------------------------------------------------X-----------X-----------------------------------------XXX-----------------------XXXXX-------------------------------------------------------------------------------XXXXX------------------------XXXX-----------------------QXXXX---------------------------------------X--------------------------XX--------------XX-----------------------XXXXXX-----------------------------------------------------XX-----------------------XXXXX---------------------------X-----------------------XXXXX-----------------------XXXXXX-------------------------X-----------XX--------------------------XX-----------XXXXX-----------------------XXXXX------------------------------------------------------X-----------XX-----------QXXXX-----------------------XXXXXX----------------------XX-XX----------XX---------------------------------------XXXXX----------XX
------------------------------------------Q---------------E-------------------------------------------------------------------------------------------------------------------------------------------------------Q---------------------------------------------------------------------------------------------------------------Q---------------------------Q---XXX---------------------------------------------------------------------------------------------------------------------------------------------------------------------------------------------------------------------------------------------------------------------------------Q-------------------------------------------------------------------------------------------------------------------------------------------Q---------------------------Q---------------------------------------------------------------------------------------------------------------Q-------------------------------------------------------------------------------------------------------------------------------------------------------------------------------------------------------------------------------------X-------------------------------------------------------------------------------------------------------------------------------------------------------------------------------------------------XXX-----------------------------------------------------XXX-------
----------------------------------E-----------------------E---------------------E--o---------------------E--------E---------------E--E------------E--------------E------------E---------------------------E----------------------------------------------------------------------E----------E-----------------------------E-------------------------------------------------------E--------------E---------------------------E------------------------E--S----------E-------------------E-----E---------------E--S---------------------------E--------E---------------E---------------E--------------E----------E-----------------------------E-------------------------E-----------------------------E--------------E------------------------E---------------E---------------------------E---------------------------------------------------E------------------E------------E--------------E------------E---------------------------------------------E------------------------E---------------------------E----------E-----------------------------E--------------E----------E-----------------------------E-------------------------------------------------------E--------------E----------E-------------------E----------------------------------------------------E------------E--------------E------------E---------------------------------------------E----------------------------------------------------E------------E---------------------
--E----E--QQQ-----------------E-X<>---QQQQ---------------<>----E?SQ------<>----<>-----E<>--E--QQQQ------<>-----Q-<>---EE--QQQ----<>-<>--------E-E<>--SQQQ-------<>--------E-E<>---QQQQ----------------E-E<>--SQQQ-------<>--------E-E<>--SQQQ-----------E-----E-E--E--QQQ-------<>--------E<>-----QQQQ----------------E-E<>--SQQQ-----------------E---E--SQQQ----Q------------E--<>---QQQQ------<>---QQQ--E<>--E--QQQ-------<>-----Q-<>------S-------<>-----E-----E<>-------------E----<>----<>----E?SQ-Q----<>-----E-----E--<>--SSQQ-------<>-------<>----E?SQQQ----<>------QQ?-----<>---QQQQ------<>---QQQ--E<>----------------------X--E-E<>--SQQQ-----------E-----E<>--E?SQQQ-----------------E--<>---QQQ-------<>---QQQ--E----E-SQQQ----<>-------------E<>---QQQQ----------E-----E--<>---QQQ-----------E-----E->--E?SQQQ----------------<>----E?SQQQ-------<>---QQQ--E--<>---QQQQ------<>---QQQ--E-E<>---QQQ----S------------E-E<>--SQQQ-----E----<>-----E<>--E--QQQ-------<>--------E--<>S?SQQQ-------<>-----?--E<>----SQQQ-----------E-----E--<>---QQQQ---Q--<>----QQ--E<>--E?SQQQ-----------E-----E-E<>--SQQQ-----------------E-E--E--QQQQ----------------E--<>---QQQQ------<>---QQQ--E<>--E?SQQQ----------<>-----E-E----SQQQ-----------------E->--E?SQQQ-------<>-----Q--E-E<>--SQQQ-------<>--------E--<>--SQQQ-----------E-----E-E----SQQQ----------<>-----E-E-----QQQ-----------------E-E<>---QQQQ------<>--------E-E<>--SQQQ---------------
-<>--------------------------<>-X[]----------------E-----[]<>------------[]----[]----<>[]---------------[]-------[]--<>----------[]-[]-------<><>[]-------------[]-------<><>[]----------------------<><>[]-------------[]--E----<><>[]----------------<>----<>[]---------------[]-------<>[]------------------------<><>[]----------------------<><>[]----------------------<>--[]-------------[]-------<>[]---------------[]-------[]--<>----------[]----<>----<>[]------------<>----[]----[]--------------[]----<>----<>--[]-------------[]-------[]--------------[]----------<>--[]-------------[]-------<>[]---------------------XX-<><>[]----------------<>----<>[]------------------------<>--[]-------------[]-------<>--------------[]-----E----<><>[]----------------<>----<>--[]----------------<>----<>[]------------------------[]-----------------[]-------<>--[]-------------[]-------<><>[]----------------------<><>[]----------<>----[]----<>[]---------------[]-------<>--[]-------------[]-------<>[]------------------<>----<>--[]-------------[]-------<>[]------------------<>----<><>[]-----------------E----<><>------------------------<>--[]-------------[]-------<>[]------------------[]----<><>oo----------------------<>[]---------------[]-------<><>[]-------------[]-------<>-E[]----------------<>----<><>------------------[]----<><>------------------------<><>[]-------------[]-------<><>[]---------------------
-[]--------------------------[]->[]---------------<>-----[][]------------[]----[]----[][]---------------[]-------[]--[]----------[]-[]-------[][][]-------------[]-------[][][]----------------------[][][]-------------[]-<>----[][][]----------------[]----[][]---------------[]-------[][]------------------------[][][]----------------------[][][]----------------------[]--[]-------------[]-------[][]---------------[]-------[]--[]----------[]----[]----[][]------------[]----[]----[]--------------[]----[]----[]--[]-------------[]-------[]--------------[]-<>-------[]--[]-------------[]-------[][]----------------------X-[][][]----------------[]----[][]------------------------[]--[]-------------[]-------[]--<>----------[]----<>----[][][]----------------[]----[]--[]----------------[]----[][]------------------------[]-----------------[]-------[]--[]-------------[]-------[][][]--------------------X-[][][]----------[]----[]----[][]---------------[]-------[]--[]-------------[]-------[][]------------------[]----[]--[]-------------[]-------[][]------------------[]----[][][]----------------<>----[][]------------------------[]--[]-------------[]-------[][]------------------[]----[][][]----------------------[][]---------------[]-------[][][]-------------[]-------[][][]----------------[]----[][]------------------[]----[][]------------------------[][][]-------------[]-------[][][]----------------<>---
-[]--------E--E-EE------E-E--[][][]-------E-EE-E--[]-----[][]---------E-E[]----[]----[][]---------E-EE--[]-E--E--[]--[]----E-EE--XX-[]-------[][][]------EE-EE--[]-------[][][]------EE-EE-----------[][][]------EE-EE--[]-[]----[][][]------EE-EE-E---[]----[][]---------E-EE--[]----E--[][]--------EE-EE-----E-----[][][]------EE-EE-E---------[][][]-------E-EE-E---------[]--[]-------EE-E--[]-E--E--[][]--------EEE----[]----E--[]--[]------EE--[]----[]----[][]--------EE--[]-E--[]----[]--------E--E--[]----[]----[]--[]-------E-EE--[]-E-----[]-----------E--[]-[]-------[]-E[]-------E-EE--[]-EE-E--[][]--------EE-EE--------XX-[][][]------EE-EE-E---[]----[][]--------EE-EE-E---------[]--[]-------EE----[]-E--E--[]--[]------EE-E[]----[]----[][][]-E----EE-EE-E---[]----[]--[]------EE-EE-E---[]----[][]--------EE-EE-E---------[]-----------E-----[]----E--[]--[]-------E-EE--[]--E-E--[][][]------EE-E---------XX-[][][]------EE-EXXE---[]----[][]-E------EE-EE--[]--E-E--[]--[]-------E-EE--[]-E-E---[][]-E------EE-EE-E---[]----[]-E[]------EE-EE--[]-E--E--[][]--------EE-EE-E---[]----[][][]------EE-EE-E---[]----[][]---------E-EE-E---------[]--[]------EE-EE--[]--E-E--[][]--------EE-EE-E---[]----[][][]-------E-EE-E---------[][]---------E-EE--[]-E--E--[][][]------EE-EE--[]----E--[][][]------EE-EE-E---[]----[][]-E------EE-EE-E---[]----[][]-E------EE-EE------E-E--[][][]------EE-EE--[]-E--E--[][][]------EE-EE-E---[]---
-XXXXXXXXXXXXXXXXXXXXXXXXXXXXXXXXXXXXXXXXXXXXXXXXXXXXXXXXXXXXXXXXXXXXXXXXXXXXXXXXXXXXXXXXXXXXXXXXXXXXXXXXXXXXXXXXXXXXXXXXXXXXXXXXXXXXXXXXXXX-XXXXXXXXXXXXXXXXXXXXXXXXXXX-XXXXXXXXXXXXXXXXXXXXXXXXXXX-XXXXXXXXXXXXXXXXXXXXXXXXXXX-XXXXXXXXXXXXXXXXXXXXXXXXXXXXXXXXXXXXXXXXXXXXXXXXXXXXXXX-XXXXXXXXXXXXXXXXXXXXXXXXXXX-XXXXXXXXXXXXXXXXXXXXXXXXXXX-XXXXXXXXXXXXXXXXXXXXXXXXXXX-XXXXXXXXXXXXXXXXXXXXXXXXXXX-XXXXXXXXXXXXXXXXXXXXXXXXXXX-XXXXXXXXXXXXXXXXXXXXXXXXXXX-XXXXXXXXXXXXXXXXXXXXXXXXXX--XXXXXXXXXXXXXXXXXXXXXXXXXXXXXXXXXXXXXXXXXXXXXXXXXXXXXXX-XXXXXXXXXXXXXXXXXXXXXXXXXXX-XXXXXXXXXXXXXXXXXXXXXXXXXXX-XXXXXXXXXXXXXXXXXXXXXXXXXXXXXXXXXXXXXXXXXXXXXXXXXXXXXXX-XXXXXXXXXXXXXXXXXXXXXXXXXXX-XXXXXXXXXXXXXXXXXXXXXXXXXXX-XXXXXXXXXXXXXXXXXXXXXXXXXXX-XXXXXXXXXXXXXXXXXXXXXXXXXXXXXXXXXXXXXXXXXXXXXXXXXXXXXXX-XXXXXXXXXXXXXXXXXXXXXXXXXXX-XXXXXXXXXXXXXXXXXXXXXXXXXXXXXXXXXXXXXXXXXXXXXXXXXXXXXXXXXXXXXXXXXXXXXXXXXXXXXXXXXXXXXXXXXXXXXXXXXXXXXXXXXXXXXXXXXXXXXXXXXXXXXXXXXXXXXXXXXXX-XXXXXXXXXXXXXXXXXXXXXXXXXXX-XXXXXXXXXXXXXXXXXXXXXXXXXXX-XXXXXXXXXXXXXXXXXXXXXXXXXXX-XXXXXXXXXXXXXXXXXXXXXXXXXXX-XXXXXXXXXXXXXXXXXXXXXXXXXXX-XXXXXXXXXXXXXXXXXXXXXXXXXXXXXXXXXXXXXXXXXXXXXXXXXXXXXXX-XXXXXXXXXXXXXXXXXXXXXXXXXXXXXXXXXXXXXXXXXXXXXXXXXXXXXXX-XXXXXXXXXXXXXXXXXXXXXXXXXXX-XXXXXXXXXXXXXXXXXXXXXXXXXXXXXXXXXXXXXXXXXXXXXXXXXXXXXXX-XXXXXXXXXXXXXXXXXXXXXXXXXXX-XXXXXXXXXXXXXXXXXXXXXXXXXXX-XXXXXXXXXXXXXXXXXXXXXXXXXXX-XXXXXXXXXXXXXXXXXXXXXXXXXXX
