--------------------------------------------------------------------------------------------------------------------------------------------------------------------------------------------------------------------------------------------------------------------------------------------------------------------------------------------------------------------------------------------------------------------------------------------------------------------------------------------------------------------------------------------------------------------------------------------------------------------------------------------------------------------------------------------------------------------------------------------------------------------------------------------------------------------------------------------------------------------------------------------------------------------------------------------------------------------------------------------------------------------------------------------------------------------------------------------------------------------------------------------------------------------------------------------------------------------------------------------------------------------------------------------------------------------------------------------------------------------------------------------------------------------------------------------------------
-------------------------------------------------------Q-----------------------------------------------------------------------------------------------------------------------------------------------------------------------------------------------------------------------------------------------------------Q------------------------------------------------------------------------------------------------------------------------------------------------------------------------------------------------------------------------------------------------------------------------------------------------------------------------------------------------------------------------------------------------------------------------------------------------------------------------------------------------------------------------------------------------------------------------------------------------------------------------------------------------------------------------------------------------------------------------------------------------------------------------------------------------------------------------------------------------------------------------------------------------------------------------------------------------------------------------------------------------------------------------------------------------------------------------------------------------------------------------------------
--------------------------------------------------------------------------------------------------------------------------------------------------------------------------------------------------------------------------------------------------------------------------------------------------------------------------------------------------------------------------------------------------------------------------------------------------------------------------------------------------------------------------------------------------------------------------------------------------------------------------------------------------------------------------------------------------------------------------------------------------------------------------------------------------------------------------------------------------------------------------------------------------------------------------------------------------------------------------------------------------------------------------------------------------------------------------------------------------------------------------------------------------------------------------------------------------------------------------------------------------------------------------------------------------------------------------------------------------------------------------------------------------------------------------------------------------------
-----------------------------------------------------------------------------------------------------------------------------------------------------------------------------------------------------------------------------------------------------------------------------------------------------------------------------------------------------------------------------------------------------------------------------------------------------------------------------------------------------------------------------------------------------------------------------------------------------------E--------------------------------------------------------------------------------------------------------------------------------------------------------------------------------------------------------------------------------------------------------------------------------------------------------------------------------------------------------------------------------------------------------------------------------------------------------------------------------------------------------------------------------------------------------------------------------------------------------------------------------------------------------------------------------------------------------------------------------------------------------------------------------------------------------------------------------------------
--------------------------------------------------------------------------------------------------------------------------------------------------------------------------------------------------------------------------------------------------------------------------------------------------------------------------------------------------------------------------------------------------------------------------------------------------------------------------------------------------------------------------------------------------------------------------------------------------------------------------------------------------------------------------------------------------------------------------------------------------------------------------------------------------------------------------------------------------------------------------------------------------------------------------------------------------------------------------------------------------------------------------------------------------------------------------------------------------------------------------------------------------------------------------------------------------------------------------------------------------------------------------------------------------------------------------------------------------------------------------------------------------------------------------------------------------------
XQ-----------------XX--------------------------------SQ-o--------Q---------------SSS---------------------------So--------Q-Q-------------------------QQQ------------SSSS-------?-Q-QE----------------------------SSSS------------------------------------------------?S-E-----------SSSS-------?-?--E------------SSS---------?-QQ-----------SS------------------------------o--------?--E-----------SSS----------?--E------------------------QQQ------------------------------SSS--------------------?--E-----------SSSS---------?--E-----------SSSS---------Q------Q----SSSS----------?-QQSS-----------SSS-o------?QQQQQ----------------------------QQS-------------------------------------------------?S-E--------SSSSSSS-------------------------------------QQQ-----------------------------------------------------QQQQ------------------------Q---------------------------Q-?E------------SS----------?--------------SSS----------?--E-----------SSS----------?Q-E-----------SSSS---------?-QQ----------SSSS--------?-QQQQ------------------------Q-QE------------------------?-Q--------------------------------S--------------------?--E----------SSSSS---------?--E------------------------?-Q-------------------------?--E---------------o--------?--E-----------SSS----------Q--------------------------------SSS--------------------?--E------------------------?--E-----------SSSS---------Q--------------S---o--------Q-Q----------------
--------------------------------------------------------------------------------------------------------------------------------------------------------------------------------------X------------X--------------------------------------------------------------------XXXX-----------------------XXXXXX-------------------------XX---------------------------------------------------XXXXXX----------------------XXXXXX---------XX---------------------------X---------------------------------------XXXXXX----------------------XXXXX-----------------------------------------------------XXX-------------------------------------------------------------------X----------------------------------------XXXX--------------------------------------------------------------------------------------------------------------XX------------------------------------------------------XX------------------------------------------------------XX------------------------XXXX-----------------------QXXXX------------------------------------------------------X-----------------------------------------------------------------------------------X------------------------XXXXX---------------------------------------------------XXXXX-----------------------XXXXXX--------------------------------------X-----------------------------------------XXX-----------------------XXXXXX--------------------------------------X----------------------------
-----------------X--------------------------------------------------------------------------------------------------------------------------------------------------------------------------------------------------------------------------------------------------------Q-------------------------------------------------------Q-----X-------------------------------------------------Q---------------------------Q-----------------------------------------------------------------------------------------------------------------------------------------------------------------------Q---------------------------------------------------Q-----------------------------------------------------------------------------------------------------------------------------------------------------------------------------------------------------------------------------------------------------------------------------------------------------------------------Q---------------------------Q-----------------------------------------------------------------------------------------------------------------------------------------------------------------------------------------------------------------------------------------------------------Q-------------------------------------------------------------------------------------------------------------------------------------------------------------------------------------
-----------------XXX----------E---E-----------------------------------------------------E-------------------E--o------E--------------E--------E------------------E--------E------------------E------------E--------------E------------E-----------E--E----------E----------------E--------E---------------E--S------------E--------------E----------E----------------E--------------------------------------E-----------------------------E--------------E------------E--------------E------------------------------E---------------------------E---------E-----------------------E------------------E----------E----------------E------------E-----------------------E------------------E--------E---------------------E-------E----------------E---------------------------E------------------------------------E------------------E---------------------------E----------E-----------------------------E--------------E------------E-------------------------E----------------E------------E-----------------------E------------------E----------E----------------E------------E--------------E------------E--------------E--------E---------------E-------------E-----------------------------E--------------E----------E-------------------E-------E--------------------------------------------E------------E--------------E----------E-----------------------------E-----------------E-----------------------------------E----------------E------
-----X----------XXXX---------<>--<>--------------------?-------Q?SQ-Q-----------E-----E<>-------------E----<>-----E-E<>---QQQQ------<>-----Q-<>----E?SQQQ-------<>-------<>----E?SQQQ-------<>---QQQ--E--<>---QQQQ------<>--------E--<>---QQQ----<>-<>--------E<>---?SQQQ----<>-<>-------<>---E??SQQQ----<>-----E-------E<>--SQQQQ---Q--<>--------E<>--Q--QQQ-------<>-----Q--E-E<>--SQQQ-----------------E<>--E?SQQQ-----------------E--<>---QQQQ------<>---QQQ--E--<>---QQQQ------<>--------E-E----SQQQ-----E----<>-----E-E----SQQQ----------<>-------E<>---QQQQ---Q-----------<>----E?SQQQ-------<>--------E<>--E?SQQQ-------<>----E---E--<>---QQQQ---Q--Q------Q-<>----E--QQQ-------<>-----Q-<>---E--S-------<>----<>-----E<>------------E--<>--------E----E?SQQQ-------<>----E-----E------QQ----------------<>---EE?SQQQ-------<>---QQQ--E----E?SQQQ-------<>----QQ--E<>--E-SQQQ-----------------E-E<>---QQQ-------<>----------E<>---QQQ-----------------E<>--E?SQQQ-------<>--------E--<>--SQQQ------------QQ?-<>----E?SQQQ-------<>-----Q--E<>--E?SQQQ-------<>--------E-E<>---QQQQ------<>-----Q--E-E<>---QQQQ------<>-------<>--<>--S-QQ----<>-----E-----E<>----SQQQ-----------E-----E-E<>---QQQQ------<>-----Q--E<>--E?SQQQ----------<>-----E<>----SQQQ-----------E-----E----E-SQQQ-------<>-----Q----E<>---QQQQ------<>-----Q--E<>-----QQQ-----------------E--<>--SQQQ----------<>-----E-E-----QQQQ----------------E<>-----QQQ-------<>------
--------------XXXX-X---------[]--[]--------------------------------------------------<>[]------------<>----[]----<><>[]-------------[]-------[]-----------------[]-------[]-----------------[]-------<>--[]-------------[]-------<>--[]----------[]-[]--E----<>[]------------[]-[]-<>----[]--<>----------[]----<>----<><>[]-------------[]-------<>[]---------------[]-------<><>[]----------------------<>[]------------------------<>--[]-------------[]-------<>--[]-------------[]-------<><>------------------[]----<><>------------------[]-----E<>[]----------------------[]-----------------[]-------<>[]---------------[]---<>--<>--[]----------------------[]-----------------[]-------[]--<>----------[]----[]----<>[]-----------<>--[]-------<>-----------------[]--------E<>------------------------[]--<>-------------[]-------<>-----------------[]-------<>[]------------------------<><>[]-------------[]--------E<>[]----------------------<>[]---------------[]--E----<>--[]----------------------[]-----------------[]-------<>[]---------------[]-------<><>[]-------------[]-------<><>[]-------------[]-------[]--[]----------[]----<>----<>[]------------------<>--X-<><>[]-------------[]-------<>[]------------------[]----<>[]------------------<>----<><>---------------[]--------E<>[]-------------[]-------<>[]-------------------E----<>--[]----------------[]----<><>------------------------<>[]---------------[]------
-------------XXXXX-X---------[]--[]-------------------------------------------<>-----[][]------------[]----[]----[][][]-------------[]-------[]-----------------[]-------[]-----------------[]-------[]--[]-------------[]-------[]--[]----------[]-[]-<>----[][]------------[]-[]-[]----[]--[]----------[]----[]----[][][]-------------[]-------[][]---------------[]-------[][][]----------------<>----[][]------------------------[]--[]-------------[]-------[]--[]-------------[]-------[][]------------------[]----[][]------------------[]----<>[][]----------------------[]-----------------[]-------[][]---------------[]---[]--[]--[]----------------------[]-----------------[]-------[]--[]----------[]----[]----[][]-----------[]--[]-------[]-----------------[]-------<>[]------------------------[]--[]-------------[]-------[]-----------------[]-------[][]------------------------[][][]-------------[]-------<>[][]----------------------[][]---------------[]-------[]--[]----------------------[]-----------------[]-------[][]---------------[]-------[][][]-------------[]-------[][][]-------------[]-------[]--[]----------[]----[]----[][]------------------[]--X-[][][]-------------[]-------[][]------------------[]----[][]------------------[]----[][]---------------[]-------<>[][]-------------[]-------[][]------------------<>----[]--[]----------------[]----[][]------------------------[][]---------------[]------
------------XXXX-------------[]--[]-------E-EE--------E------------E--E-EE-E--[]-----[][]--------EE--[]-E--[]----[][][]-------EEEE--[]-E--E--[]-----------E--E--[]-E-E---[]-----------E-EE--[]----E--[]--[]-------E-EE--[]-E--E--[]--[]------EE--[]-[]-[]----[][]---------E--[]-[]-[]----[]--[]------EE-E[]----[]----[][][]-E-----E-EE--[]-------[][]---------EE-E--[]-EE-E--[][][]------EE-EE-E---[]----[][]---------E-EE-E---------[]--[]-------E-EE--[]-EE-E--[]--[]------EE-EE--[]----E--[][]-E------EE-EE-E---[]----[][]--------EE-EE-E---[]----[][][]------E--EE--------E--[]-----------E-EE--[]-------[][]---------E-EE--[]-E-[]--[]-E[]-------E-EE-----EE-E--[]-Q--------EE-EE--[]-------[]--[]-------E--[]-E--[]----[][]--E--------[]--[]----E--[]-----------E--E--[]-E-----[][]-E-------E-EE-----------[]--[]------EE-EE--[]----E--[]-----------E-EE--[]----E--[][]---------E-EE-E---------[][][]------EE-EE--[]-------[][][]-E----EE-E------------[][]---------E-EE--[]-E-----[]-E[]-------E-EE---o-------[]-----------E-EE--[]-E--E--[][]---------E-EE--[]-E--E--[][][]------EE-EE--[]-EE-E--[][][]------EE-EE--[]-------[]--[]------EE-EXXE---[]----[][]--------EE-EE-E---[]----[][][]------EE-EE--[]-EE-E--[][]--------EE-EE-E---[]----[][]-E------EE-EE-E---[]----[][]---------E-EE--[]--E-E--[][][]------EE-EE--[]-EE-E--[][]-E------EE-EE-E---[]----[]-E[]------EE-EE-E---[]----[][]-E------EE-EE--------E--[][]---------E--E--[]-E--E-
-XXX-----XXXXXX------XXXXXS--XXXXXXXXXXXXXXXXXXXXXXXXXXXXXXXXXXXXXXXXXXXXXXXXXXXXXXXXXXXXXXXXXXXXXXXXXXXXXXXXXXX-XXXXXXXXXXXXXXXXXXXXXXXXXXX-XXXXXXXXXXXXXXXXXXXXXXXXXXX-XXXXXXXXXXXXXXXXXXXXXXXXXXXXXXXXXXXXXXXXXXXXXXXXXXXXXXXXXXXXXXXXXXXXXXXXXXXXXXXXXXXXXXXXXXXXXXXXXXXXXXXXXXXXXXX-XXXXXXXXXXXXXXXXXXXXXXXXXXX-XXXXXXXXXXXXXXXXXXXXXXXXXXX-XXXXXXXXXXXXXXXXXXXXXXXXXXXXXXXXXXXXXXXXXXXXXXXXXXXXXXX-XXXXXXXXXXXXXXXXXXXXXXXXXXX-XXXXXXXXXXXXXXXXXXXXXXXXXXXXXXXXXXXXXXXXXXXXXXXXXXXXXXX-XXXXXXXXXXXXXXXXXXXXXXXXXXX-XXXXXXXXXXXXXXXXXXXXXXXXXXX-XXXXXXXXXXXXXXXXXXXXXXXXXXXXXXXXXXXXXXXXXXXXXXXXXXXXXXXXXXXXXXXXXXXXXXXXXXXXXXXXXXX-XXXXXXXXXXXXXXXXXXXXXXXXXXX-XXXXXXXXXXXXXXXXXXXXXXXXXXXXXXXXXXXXXXXXXXXXXXXXXXXXXXX-XXXXXXXXXXXXXXXXXXXXXXXXXXX-XXXXXXXXXXXXXXXXXXXXXXXXXXXXXXXXXXXXXXXXXXXXXXXXXXXXXXX-XXXXXXXXXXXXXXXXXXXXXXXXXXX-XXXXXXXXXXXXXXXXXXXXXXXXXXX-XXXXXXXXXXXXXXXXXXXXXXXXXXX-XXXXXXXXXXXXXXXXXXXXXXXXXXX-XXXXXXXXXXXXXXXXXXXXXXXXXXXXXXXXXXXXXXXXXXXXXXXXXXXXXXXXXXXXXXXXXXXXXXXXXXXXXXXXXXX-XXXXXXXXXXXXXXXXXXXXXXXXXXX-XXXXXXXXXXXXXXXXXXXXXXXXXXX-XXXXXXXXXXXXXXXXXXXXXXXXXXX-XXXXXXXXXXXXXXXXXXXXXXXXXXXXXXXXXXXXXXXXXXXXXXXXXXXXXXX-XXXXXXXXXXXXXXXXXXXXXXXXXXXXXXXXXXXXXXXXXXXXXXXXXXXXXXX-XXXXXXXXXXXXXXXXXXXXXXXXXXX-XXXXXXXXXXXXXXXXXXXXXXXXXXXXXXXXXXXXXXXXXXXXXXXXXXXXXXX-XXXXXXXXXXXXXXXXXXXXXXXXXXX-XXXXXXXXXXXXXXXXXXXXXXXXXXX-XXXXXXXXXXXXXXXXXXXXXXXXXXX-XXXXXXXXXXXXXXXXXXXXXXXXXXX-XXXXXXXXXXXXXXXXXXXXXXXXXXX
