--------------------------------------------------------------------------------------------------------------------------------------------------------------------------------------------------------------------------------------------------------------------------------------------------------------------------------------------------------------------------------------------------------------------------------------------------------------------------------------------------------------------------------------------------------------------------------------------------------------------------------------------------------------------------------------------------------------------------------------------------------------------------------------------------------------------------------------------------------------------------------------------------------------------------------------------------------------------------------------------------------------------------------------------------------------------------------------------------------------------------------------------------------------------------------------------------------------------------------------------------------------------------------------------------------------------------------------------------------------------------------------------------------------------------------------------------------
--------------------------------------------------------------------------------------------------------------------------------------------------------------------------------------------------------------------------------------------------------------------------------------------------------------------------------------------------------------------------------------------------------------------------------------------------------------------------------------------------------------------------------------------------------------------------------------------------------------------------------------------------------------------------------------------------------------------------------------------------------------------------------------------------------------------------------------------------------------------------------------------------------------------------------------------------------------------------------------------------------------------------------------------------------------------------------------------------------------------------------------------------------------------------------------------------------------------------------------------------------------------------------------------------------------------------------------------------------------------------------------------------------------------------------------------------------
--------------------------------oo--------------------------oo------------------------------------------------------oo--------------------------oo--------------------------oo--------------------------oo--------------------------oo--------------------------oo------------------------------------------------------oo--------------------------oo--------------------------oo--------------------------oo--------------------------oo--------------------------oo------------------------------------------------------oo--------------------------oo--------------------------oo--------------------------oo--------------------------o---------------------------oo--------------------------oo--------------------------oo------------------------------------------------------oo--------------------------oo--------------------------oo------------------------------------------------------oo--------------------------oo--------------------------oo--------------------------oo--------------------------o---------------------------o---------------------------oo--------------------------oo--------------------------oo------------------------------------------------------oo--------------------------oo--------------------------oo--------------------------oo--------------------------oo--------------------------oo--------------------------oo--------------------------o---------------------------oo----------------------
-------------------------------XXXX-----------------------XXXXX--------------------E-------------------------------XXXX-----------------------XXXXX--------------------E----XXX------------------------XXXX------------------------XXXX------------------------XXXX-----------------------------------------------------XXX------------------------XXXX--------------------E--XXXXX--------------------E---XXXX-----------------------XXXXX-----------------------XXXXX---------------------------------------------------XXXXXX-------------------E---XXXX-------------------------XXX-----------------------XXXXX--------------------E----XX--------------------------XXX------------------------XXXX------------------------XXXX-----------------------------------------------------XXX------------------------XXXX------------------------XXXX----------------------------------------------------XXXX-------------------------XXX------------------------XXXX-----------------------XXXXX-------------------------X------------------------------------------------------XXXX------------------------XXXX-------------------------XXX----------------------------------------------------XXXX-------------------------XXX------------------------XXXX-------------------------XXX-------------------------XXX-------------------------X---------------------------XXX-------------------------X---------------------------XXX---------------------
-----------------?-----------------------------------------------------------------------------------?-----------------------------------------------------------------------------------?---------------------------E---------------------------E---------------------------E---------------------------?---------------------------E---------------------------E-------------------------------------------------------------------------------------------------------------------------------------------------------------------------------------------------------------------------------E-------------------------------------------------------?---------------------------?-----------------------------------------------------------------------------------?---------------------------?---------------------------?---------------------------?---------------------------?---------------------------?---------------------------E---------------------------?---------------------------?---------------------------?---------------------------?---------------------------?---------------------------?---------------------------?---------------------------?---------------------------?---------------------------?---------------------------?---------------------------E---------------------------?---------------------------?---------------------------?---------------------------?---------------------------?----------
-----------ooo--XXXS----?--------------ooo---ESS----SSS----------oooo----XX----SSSS------------ooo---XXS----?--------------ooo---SSS----SSS-------------oo---XXS----SSS-----------Xooo--XXXS----?--------------ooo---XSS----SSS-------------oo---XSS----SSS------------ooo---XXS----SSS-----------Xooo--XXXS----?-------------oooo---XXS----SSS------------oo----XXS----SSS------------ooo---XXS----SSS----------oooo----XX-----SSS----------oooo----XX-----SSS------------ooo---XXS----SSS------------ooo---EXS----?------------oooo----XX----SSSS------------ooo---ESS----?--------------ooo---XSS----SSS------------ooo---ESS----SSS-----------Xooo---XXS----S-------------Xooo---XSS----SSS----------ooooo---XX-----SSSS------------o----E------SSSS----------Xooo--XXX-----?--------------ooo---XXS----S-------------ooo----XXS----SSS------------oo---XXXS----SSS-----------Xoo---XXXS----S-------------Xooo---XXS----S-------------Xooo---XX-----SS------------Xoo---XXXS----S--------------oo---XXXS----SSS-----------Xooo---XXS----S-------------oooo--XXXS----S-------------Xooo--XXXS----S-------------Xooo---XSS----SSS-----------Xooo---XXS----S-------------Xooo---XXS----S-------------Xooo--XXXS----S-------------Xoo----XXS----S-------------Xooo--XXXS----S-------------Xooo---XXS----SSS-----------oooo---XXS----S-------------Xooo--XXXS----S-------------Xooo---XXS----S-------------Xoo---XXX-----SS------------oooo---XXS----S---
--------------------o---------------------------o---------------------------o---------------------------oo--------------------------------------------------------------------------------------------------------------o--------------------------oo---------------------------o--------------------------oo---------------------------o---------------------------o---------------------------o---------------------------o---------------------------o--------------------------oo--------------------------ooo------------------------------------------------------o---------------------------o-------------------------------------------------------o-------------------------------------------------------o---------------------------o---------------------------oo--------------------------o-----------------------------------------------------------------------------------o-------------------------------------------------------o---------------------------o-----------------------------------------------------------------------------------o---------------------------------------------------------------------------------------------------------------o-------------------------------------------------------------------------------------------------------------------------------------------o---------------------------o-------------------------------------------------------------------------------------------
----------------------------------------------------------------------------------------------------------------------------------------------------------------------------------------------------------------------------------------------------------------------------------------------------------------------------------------------------------------------------------------------------------------S-------------------o-------S-----------------------------------------------------------------------------------------------------------------------------------------------------------------------------------------------------------------------------------------------------------S--S------------------------S-------------------------------------------------------------------------------------------------------------------------------------------------------------------------------------------------------------------------------------------------------------------------------------------------------------------------------------------------------------------------------------------------------------------------------------------------------------------------------------------------------------------------------------------------------------------------------------------------------------------------------------------------------------------------------------------------------------------
-------------------------------------?--------------------------------------------------------------------------------------------------------------XXX-------------------------------------------------------------------------------------------------------------------------------------------------------------------------------------------------------------------------------------------------------SoS---------E---------------SoS---------------------------------------------------------------------------------------------E--------------------------------------------------------------------------X----------------------------------------------------------------------------------S---Q---------------------SoS---------E---------------------------------------------------------------------------------------------------------------------------------------------------------------------------------------------------------------------------------------------------------------------------------------------------------------------------------------------------------------------------------------------------------------------------------------------------------------------------------------------------------------------------------------------------------------------------------------------------------------------------------------------------------------------------------------------------------
-------------XXX----XXX------------------XXX----XXX-----XX-----------XX-----XXX--XXX-------------XXX----XXX------------------XXX----XXX--X---X-----------XXX----XXX--XX--------------XXX---XXXX--X--XX-----------XXX----XXX--X---------------XXX----XXX------------------XXX----XXX-----X------------XXX----XXX------------------XXX----XXX--XXX-------------XXX----XXX--XXXXX-----------XXX----XXX--XXXXX-----SS----XX--<>-XXX--XXXXXX---SSS----XX-----XXX--XXXXX-----------XXX----XXX------------------XXX----XXX------------------XX--<>-XXX--XXX-------------XXX----XXX------------------XXX----XXX-----XX-----------XXX----XXX--XXX-------------XXX---XXXX------------------XXX---XXXX--XX-XX-----SS----XX--<>-XXX--E---------SS--------<>------E?S-------------XXX----XXX------------------XXX---XXXX------------------XXX---XXXX--XXX-------------XXX---XXXX--XXX-------------XXX----XXX------------------XXX---XXXX--XXX-------------XXX---XXXX--XXX-------------XXX---XXXX------------------XXX---XXXX--XX--------------XXX---XXXX--XXXX------------XXX----XXX------------------XXX---XXXX--XXXX------------XXX---XXXXXXXXXXX-----------XXX---XXXX--XXX-------------XXX---XXXX--XX--------------XXX---XXXX--XXXX------------XXX---XXXX--XXX-------------XXX---XXXX--X---------------XXX---XXXX--XXX-------------XXX----XXX--XX-XX-----------XXX---XXXX--X---------------XXX---XXXX--XX--------------XXX---XXXX--XXX-------------XXX---XXXX--XXX
--Eo---------------------------o---------------------------o-------------<>-----------Eo---------------------------o------------------------------------------E-----------Eo---------------------------o---------------------------o---------------------------o--------------E-----------Eo--------------------------Eo---------------------------o--------------E------------o--------------E-----------Eo-------------[]------------o-------------XX------------o--------------E-----------Eo---------------------------o-------------[]-----------Eo--------------------------Eo---------------------------o--------------E-----------Eo---------------------------o---------------------------o-------------[]-----------Eo-------------[]-----E-----Eo--------------------------Eo--------------------------Eo--------------------------Eo--------------------------Eo---------------------------o--------------------------Eo--------------------------Eo---------------------------o--------------------------Eo--------------------------Eo--------------------------Eo---------------------------o---------------------------o---------------------------o--------------------------Eo---------------------------o--------------------------Eo---------------------------o--------------------------Eo--------------------------Eo---------------------------o--------------------------Eo--------------------------Eo------------------------
--XXXXX-----------------------XXXXXX---------<>-----------XXXXX----------[]-----------XXXXXX---------<>-----------XXXXXX-----------------------XXXXX---------<>-----------XXXXX-----------------------XXXXXX----------------------XXXXXX----------------------XXXXXX---------<>-----------XXXXXX----------------------XXXXXX----------------------XXXXXX---------<>-----------XXXXXX---------<>-----------XXXXX----------[]-----------XXXXX----------[]-----------XXXXXX---------<>-----------XXXXX----------<>-----------XXXXX----------[]-----------XXXXXX---------<>-----------XXXXXX----------------------XXXXXX---------<>-----------XXXXX-----------------------XXXXXX----------------------XXXXX----------[]-----------XXXXX----------[]-----------XXXXX-----------------------XXXXX-----------------------XXXXXX----------------------XXXXX-----------------------XXXXXX----------------------XXXXXX----------------------XXXXX-----------------------XXXXXX----------------------XXXXXX----------------------XXXXX-----------------------XXXXXX----------------------XXXXX-----------------------XXXXXX----------------------XXXXXX----------------------XXXXXX----------------------XXXXXX----------------------XXXXXX----------------------XXXXXX----------------------XXXXXX----------------------XXXXX-----------------------XXXXXX----------------------XXXXXX----------------------XXXXX-----------------------XXXXXX--------------------
---------------------------------------------[]--------------------------[]--------------------------[]------------------------------------------------------[]--------------------------------------------------------------------------------------------------------------[]----------------------------------------------------------------------------------[]--------------------------[]--------------------------[]--------------------------[]--------------------------[]--------------------------[]--------------------------[]--------------------------[]------------------------------------------------------[]----------------------------------------------------------------------------------[]--------------------------[]---------------------------------------------------------------------------------------------------------------------------------------------------------------------------------------------------------------------------------------------------------------------------------------------------------------------------------------------------------------------------------------------------------------------------------------------------------------------------------------------------------------------------------------------------------------------------------------------------------------------------------------------------------------------------------------------------------
-----------X---XXXX----XXXXX---------------XXXXXXXXXXXXX---------------XXXXXXXX-XXXX-----------XX--XXXX--XXXXXXX---------------XXXX------XXX---------------XXXXXXX---XXX---------------XXXX------XXX---------------XXXXXXX---XXX---------------XXXX------XXXX--------------XXXXXXX--XXXX----------------XXX-----XXXX---------------XXXX------XXX---------------XXXXXXX---XXX---------------XXXXXXX---XXX-----------XX--XXXXXXXXXXXXX---------------XXXXXXXXXXXXX---------------XXXXXXXX-XXXX---------------XXXXXXXXXXXXX-----------XX--XXXXXXXXXXXXX---------------XXXXXXXXXXXXX---------------XXXX-----XXXX---------------XXXXXXX---XXX---------------XXXX------XXX---------------XXXX------XXX------------X--XXXXXXXXXXXXX----------XXXXXXXXXXXXXXXXXX-----------X---XXXX----XXXXX---------------XXXX-----XXXX---------------XXXX------XXX---------------XXXX------XXX---------------XXXX-----XXXX---------------XXXX------XXX---------------XXXX------XXX---------------XXXX----XXXXXX--------------XXXX------XXX---------------XXXX------XXX---------------XXXX-----XXXX---------------XXXX------XXX----------------XXX------XXX----------------XXX------XXX----------------XXX------XXX---------------XXXX------XXX---------------XXXX------XXX---------------XXXX------XXX---------------XXXX------XXX---------------XXXX-----XXXX----------------XXX------XXX----------------XXX------XXX---------------XXXX------XXX---------------XXXX------XXX
