--------------------------------------------------------------------------------------------------------------------------------------------------------------------------------------------------------------------------------------------------------------------------------------------------------------------------------------------------------------------------------------------------------------------------------------------------------------------------------------------------------------------------------------------------------------------------------------------------------------------------------------------------------------------------------------------------------------------------------------------------------------------------------------------------------------------------------------------------------------------------------------------------------------------------------------------------------------------------------------------------------------------------------------------------------------------------------------------------------------------------------------------------------------------------------------------------------------------------------------------------------------------------------------------------------------------------------------------------------------------------------------------------------------------------------------------------------
-----------------------------------------------------------------------------------------------------------------------------------------------------------------------------------------------------------------------------------------------------------------------------------------------------------------------------------------------------------------------------------------------------------------------------------------------------------------------------------------------------------------------------------------------------------------------------------------------------------------------------------------------------------------------------------------------Q--------------------------------------------------------------------------------------------------------------------------------------------------------------------------------------------------------------------------------------------------------------------------------------------------------------------------------------------------------------------------------------------------------------------------------------------------------------------------------------------------------------------------------------------------------------------------------------------------------------------------------------------------------------------------------------------------------------------------------------------------------
--------------------------------------------------------------------------------------------------------------------------------------------------------------------------------------------------------------------------------------------------------------------------------------------------------------------------------------------------------------------------------------------------------------------------------------------------------------------------------------------------------------------------------------------------------------------------------------------------------------------------------------------------------------------------------------------------------------------------------------------------------------------------------------------------------------------------------------------------------------------------------------------------------------------------------------------------------------------------------------------------------------------------------------------------------------------------------------------------------------------------------------------------------------------------------------------------------------------------------------------------------------------------------------------------------------------------------------------------------------------------------------------------------------------------------------------------------
--------------------------------------------------------------------------------------------------------------------------------------------------------------------------------------------------------------------------------------------------------------------------------------------------------------------------------------------------------------------------------------------------------------------------------------------------------------------------------------------------------------------------------------------------------------------------------------------------------------------------------------------------------------------------------------------------------------------------------------------------------------------------------------------------------------------------------------------------------------------------------------------------------------------------------------------------------------------------------------------------------------------------------------------------------------------------------------------------------------------------------------------------------------------------------------------------------------------------------------------------------------------------------------------------------------------------------------------------------------------------------------------------------------------------------------------------------
--------------------------------------------------------------------------------------------------------------------------------------------------------------------------------------------------------------------------------------------------------------------------------------------------------------------------------------------------------------------------------------------------------------------------------------------------------------------------------------------------------------------------------------------------------------------------------------------------------------------------------------------------------------------------------------------------------------------------------------------------------------------------------------------------------------------------------------------------------------------------------------------------------------------------------------------------------------------------------------------------------------------------------------------------------------------------------------------------------------------------------------------------------------------------------------------------------------------------------------------------------------------------------------------------------------------------------------------------------------------------------------------------------------------------------------------------------
-------?-Q-Q-----------------------------------------QS----------?-?E------------------------Q--E---------------o--------?--E--------SSSSSSS---------?--E------------SSSo--------QQQQ------------S-----------Q-Q-------------------------?--E------------SS----------?--E------------------------?--E------------------------Q-Q----S-----------o--------Q-QQ-----------SS-----------?--E---------------o--------Q-Q----S--------------------Q------------------o--------?--E-----------SSS----------?--E----------SSSSSo--------QQQQQQQQ------SQ----------?-QQQQ------------------------QQQQ----------------------------------------------------?--E----------SSSSS---------?--E------------SSS-----------Q-------------------------QQQ----------SSSSSS---------Q-QE------------------------Q-----SS------------------------------------------------?---------------SSS------------E------------SSS--------------------------Q----------?--E----------SSS--o------?-QQQQ----------------------------------------------------?--E------------------------?--E---------------o--------?--E-------------SS---------Q---------------------------Q-Q-------------------------?--E------------------------?--E-----------SS-----------?--E------------S--o--------?--E-----------SS-----------?-QE-----------SSS----------Q-Q-------------------------?--E------------------------?S-E------------SSS---------?--E------------------------Q-Q----------------
---------------------------X---------------------------------------XXXXX--------------------------XX-------------------------XXX-----------------------XXXXX--------------------------XX---------------------------------------X---------------------------------------XXXXXX----------------------XXXXXX---------XX--------------------------XX-----------Q?XXX-----------X-----------XXXXXX---------XX---------------------------X---------------------------------------XXXXX-----------------------XXXXXX-----------------------------------------------------XX---------------------------------------------------------------------------------XXX--------------------------X---------------------------------------XX----------------------------------------------------------------------------------------------------------------------------------------------------------X---------------------------X------------------------XXXXXX---------XX--------------XX----------XX---------------------------X-----------QXXXX-----------------------XXXXX-----------------------XXXXX--------------------------------------XX------------------------------------------XX-------------------------XXX-----------------------Q?XXX-----------------------XXXXXX----------X--------------XX--------------------------------------------------------------------------------XXXXX----------------------XXXXX----------XX----------------------------
----------------------------------E-------------------------------------------------------------------------------------------------------------------------------------------------------------------------------------------------------------------------------------------------------------------Q---XXX-------------------------------------------------Q---------------------------Q---XXX-----------------------------------------------------------------------------------------------------------------------------------------------------------------Q---------------------------------------------------------------------------------------------------------------------------------------------------------------------------------------------------------------------------------------------------------------------------------------------------------------------------------------------------------------------------Q---X-----------------------------------------------Q---------------------------------------------------------------------------------------------------------------------------------------------------------------------------------------------------------------------------------------------------------------Q-------------------------------------------------------------------------------------------------------------------------------------------------------------------------------------
--E------------------E--------E--<>-----------------------E---E-------------------------E-----------------------------E-------------------------E-----------------------------E--------------E------------E--------------E----------------------------------------------------------E-------------------------------------E--------------E--------------------------------------E-----------------------------E--------------E----------E----------------E------------E--------------E------------------------------E------------------------E--------E------------------E----------E----------------E---------------------------E------------E-----------------------E---------------E-----E--o----E----------------E----------E----------------E----------E-----------------------------E--------------E------------E--------------E------------------------E--E----------E-------------------E---------E-----------E--E--------------------------------------E----------------E------------E--------------E------------E-------------------------E---------------------------E-------------------E--o----E---------------------------E----------------E----------E-------------------------------------------------------E------------------------------------------------------------------------E---------------------------E------------E-------------------------E-------------------E-------------------------------------E--------------E------
-<>----E?-QQQQ------<>---QQQ-<>--[]----------------------<>--<>--S--------------------E<>--E?SQQQ-----------------E-E<>---QQQ-------S---------E<>--E?SQQQ-----------E-----E--<>--SQQQ-------<>----QQ--E-E<>---QQQQ------<>-----Q----E<>--SQQQ--------S--------E-E----SQQQ----------<>-----E-E<>--SQQQ-----------------E--<>---QQQQ------<>---QQQ--E<>--E?SQQQ-------<>--------E<>--E?SQQQ-----------------E-E<>---QQQQ------<>-----Q--E<>--Q--QQQQ------<>--------E-E<>--SQQQ-------<>--------E-E--E?SQQQ----------<>--------<>---QQQQ---Q--<>---QQQ-<>---E??SQQQ-------<>---QQQ--E-E--E?SQQQ-------<>--------E<>-----QQQ-------<>-----Q--E--<>--SQQQ----------------<>----E?S-------<>----<>-----E<>--E--QQQQ------<>-----Q--E<>-----QQQ-------<>--------E<>--E?SQQQ-----------------E--<>---QQQQ------<>---QQQ--E--<>---QQQQ------<>--------E-E<>--SQQQ----<>-<>-----?--E<>----Q--------E----<>-----E--<>---QQQ----<>-<>---QQ?--E---ES?SQQQ-----------------E<>--E?SQQQ-------<>----QQ--E--<>---QQQQ------<>----QQ--E-E<>--SQQQ-----------------E<>----SQQQ-----------E-----E<>----SQQQ----------<>-----E<>--E?-QQQQ------<>-----Q--E<>--Q--QQQQ------<>--------E<>----SQQQ-------------------E<>--SQQQ-----------------E<>----SQQQ-----------------E-E<>--SQQQ-----------------E-E<>--SQQQ-------<>-----Q--E----E--QQQ-------<>----QQ--E-E<>---QQQQ----------------E<>--E?SQQQ----------<>-----E-E<>--SQQQ-----------------E-E<>---QQQQ------<>----QQ
-[]-----------------[]-------[]--[]----------------------[]--[]----------------<>----<>[]-------------------E----<><>[]----------------------<>[]------------------<>----<>--[]-------------[]-------<><>[]-------------[]-------<><>[]----------------------<><>------------------[]----<><>[]-----------------E----<>--[]-------------[]-------<>[]---------------[]-------<>[]------------------------<><>[]-------------[]-------<>[]---------------[]-------<><>[]-------------[]-------<>[>------------------[]-----E--[]-------------[]-------[]--<>-------------[]-------<><>---------------[]-------<>[]---------------[]-------<>--[]-----------------E----[]--------------[]----[]----<>[]---------------[]-------<>[]---------------[]-------<>[]------------------------<>--[]-------------[]-------<>--[]-------------[]-------<><>[]----------[]-[]-------<>[]------------<>----[]-X--<>--[]----------[]-[]-------<>--<>----------------------<>[]---------------[]-------<>--[]-------------[]-------<><>[]-----------------E----<>[]------------------<>----<>[]------------------[]----<>[]---------------[]-------<>[]---------------[]-------<>[]-------------------E----<><>[]----------------------<>[]------------------------<><>[]----------------------<><>[]-------------[]-------<><>---------------[]-------<><>[]----------------------<>[]------------------[]----<><>[]-----------------E----<><>[]-------------[]------
-[]-----------------[]-------[]--[]----------------------[]--[]----------------[]----[][]------------------<>----[][][]--------------E-------[][]------------------[]----[]--[]-------------[]-------[][][]-------------[]-------[][][]----------------------[][]------------------[]----[][][]----------------<>----[]--[]-------------[]-------[][]---------------[]-------[][]------------------------[][][]-------------[]-------[][]---------------[]-------[][][]-------------[]-------[][]------------------[]----<>--[]-------------[]-------[]--[]-------------[]-------[][]---------------[]-------[][]---------------[]-------[]--[]----------------<>----[]--------------[]----[]----[][]---------------[]-------[][]---------------[]-------[][]------------------------[]--[]-------------[]-------[]-E[]-------------[]-------[][][]----------[]-[]-------[][]------------[]----[]-X--[]--[]----------[]-[]-------[]--[]----------------------[][]---------------[]-------[]--[]-------------[]-------[][][]----------------<>----[][]------------------[]----[][]------------------[]----[][]---------------[]-------[][]---------------[]-------[][]------------------<>----[][][]----------------------[][]------------------------[][][]----------------------[][][]-------------[]-------[][]---------------[]-------[][][]----------------------[][]------------------[]----[][][]----------------<>----[][][]-------------[]------
-[]-----------E-EE--[]--E-E--[]--[]-------E-EE----X--E---[]--[]-------E-EE-E---[]----[][]--------EE-EE-E---[]----[][][]------EE-EE-----------[][]---------E-EE-E---[]----[]--[]-------E-EE--[]-E--E--[][][]-------E-EE--[]-EE-E--[][][]------EE-EE-----------[][]--------EE-EE-E---[]----[][][]------EE-EE-E---[]----[]--[]-------E-EE--[]--E-E--[][]--------EE-EE--[]-E-----[][]--------EE-EE-E---------[][][]------EE-EE--[]-EE-E--[][]--------EE-EE--[]-EE-E--[][][]------EE-EE--[]-------[][]---------E-EE-E---[]----[]--[]-------E--E--[]----E--[]--[]-------E--E--[]----E--[][]---------E-EE--[]-E-E---[][]-E------EE-EE--[]--E-E--[]--[]------EE-EE-E---[]----[]-----------E--[]E---[]----[][]--------EE-EE--[]-EE-E--[][]---------E-EE--[]-E-E---[][]---------E-EE-----------[]-E[]-------E-EE--[]-E--E--[][][]------EE-EE--[]----E--[][][]------EE--[]-[]-------[][]--------EE--[]-E--[]----[]-E[]------EE--[]-[]-------[]--[]-------E-EE-E---------[][]---------E-EE--[]-E--E--[]--[]-------E-EE--[]-EE-E--[][][]------EE-EE-----[]----[][]-E------EE-EE-E---[]----[][]--------EE-EE-E---[]----[][]---------E-EE--[]--E-E--[][]---------E-EE--[]-E--E--[][]--------EE-EE-----[]----[][][]------EE-EE-E---------[][]--------EE-EE-----------[][][]------EE-EE-E---------[][][]-------E-EE--[]-E--E--[][]---------E-EE--[]--E-E--[][][]------EE-EE-----------[][]--------EE-EE-E---[]----[][][]------EE-EE-E---[]----[][][]-------E-EE--[]-E--E-
-XXXXXXXXXXXXXXXXXXXXXXXXXXXXXXXXXXXXXXXXXXXXXXXXXXXXXXX-XXXXXXXXXXXXXXXXXXXXXXXXXXX-XXXXXXXXXXXXXXXXXXXXXXXXXXX-XXXXXXXXXXXXXXXXXXXXXXXXXXX-XXXXXXXXXXXXXXXXXXXXXXXXXXXXXXXXXXXXXXXXXXXXXXXXXXXXXXX-XXXXXXXXXXXXXXXXXXXXXXXXXXXXXXXXXXXXXXXXXXXXXXXXXXXXXXX-XXXXXXXXXXXXXXXXXXXXXXXXXXXXXXXXXXXXXXXXXXXXXXXXXXXXXXXXXXXXXXXXXXXXXXXXXXXXXXXXXXXXXXXXXXXXXXXXXXXXXXXXXXXXXXXXXXXXXXXXXXXXXXXXXXXXXXXXXXX-XXXXXXXXXXXXXXXXXXXXXXXXXXX-XXXXXXXXXXXXXXXXXXXXXXXXXXXXXXXXXXXXXXXXXXXXXXXXXXXXXXX-XXXXXXXXXXXXXXXXXXXXXXXXXXX-XXXXXXXXXXXXXXXXXXXXXXXXXXX-XXXXXXXXXXXXXXXXXXXXXXXXXXXXXXXXXXXXXXXXXXXXXXXXXXXXXXXXXXXXXXXXXXXXXXXXXXXXXXXXXXXXXXXXXXXXXXXXXXXXXXXXXXXXXXX-XXXXXXXXXXXXXXXXXXXXXXXXXXX-XXXXXXXXXXXXXXXXXXXXXXXXXXX-XXXXXXXXXXXXXXXXXXXXXXXXXXX-XXXXXXXXXXXXXXXXXXXXXXXXXXX-XXXXXXXXXXXXXXXXXXXXXXXXXXX-XXXXXXXXXXXXXXXXXXXXXXXXXXX-XXXXXXXXXXXXXXXXXXXXXXXXXXX-XXXXXXXXXXXXXXXXXXXXXXXXXX--XXXXXXXXXXXXXXXXXXXXXXXXXXX-XXXXXXXXXXXXXXXXXXXXXXXXXXX-XXXXXXXXXXXXXXXXXXXXXXXXXXXXXXXXXXXXXXXXXXXXXXXXXXXXXXX-XXXXXXXXXXXXXXXXXXXXXXXXXXX-XXXXXXXXXXXXXXXXXXXXXXXXXXX-XXXXXXXXXXXXXXXXXXXXXXXXXXX-XXXXXXXXXXXXXXXXXXXXXXXXXXX-XXXXXXXXXXXXXXXXXXXXXXXXXXX-XXXXXXXXXXXXXXXXXXXXXXXXXXX-XXXXXXXXXXXXXXXXXXXXXXXXXXX-XXXXXXXXXXXXXXXXXXXXXXXXXXX-XXXXXXXXXXXXXXXXXXXXXXXXXXX-XXXXXXXXXXXXXXXXXXXXXXXXXXXXXXXXXXXXXXXXXXXXXXXXXXXXXXXXXXXXXXXXXXXXXXXXXXXXXXXXXXX-XXXXXXXXXXXXXXXXXXXXXXXXXXX-XXXXXXXXXXXXXXXXXXXXXXXXXXX-XXXXXXXXXXXXXXXXXXXXXXXXXXX
