--------------------------------------------------------------------------------------------------------------------------------------------------------------------------------------------------------------------------------------------------------------------------------------------------------------------------------------------------------------------------------------------------------------------------------------------------------------------------------------------------------------------------------------------------------------------------------------------------------------------------------------------------------------------------------------------------------------------------------------------------------------------------------------------------------------------------------------------------------------------------------------------------------------------------------------------------------------------------------------------------------------------------------------------------------------------------------------------------------------------------------------------------------------------------------------------------------------------------------------------------------------------------------------------------------------------------------------------------------------------------------------------------------------------------------------------------------
-----------------------------------------------------------------------------------------------------------------------------------------------------------------------------------------------------------------------------------------------------------------------------------------------------------------------------------------------------------------------------------------------------------------------------------------------------------------------------------------------------------------------------------------------------------------------------------------------------------------------------------------------------------------------------------------------------------------------------------------------------------------------------------------------------------------------------------------Q-----------------------------Q--------------------------------------------------------------------------------------------------------------------------------------------------------------------------------------------------------------------------------------------------------------------------------------------------------------------------------------------------------------------------------------------------------------------------------------------------------------------------------------------------------------------------------------------------------------------------------
--------------------------------------------------------------------------------------------------------------------------------------------------------------------------------------------------------------------------------------------------------------------------------------------------------------------------------------------------------------------------------------------------------------------------------------------------------------------------------------------------------------------------------------------------------------------------------------------------------------------------------------------------------------------------------------------------------------------------------------------------------------------------------------------------------------------------------------------------------------------------------------------------------------------------------------------------------------------------------------------------------------------------------------------------------------------------------------------------------------------------------------------------------------------------------------------------------------------------------------------------------------------------------------------------------------------------------------------------------------------------------------------------------------------------------------------------------
-----------------------------------------------------------------------------------------------------------------------------------------------------------------------------------------------------------------------------------------------------------------------------------------------------------------------------------------------------------------------------------------------------------------------------------------------------------------------X-------------------------------------------------------------------------------------------------------------------------------------------------------------------------------------------------------------------------------oo----------------------------------------------------------------------------------------------------------------------------------------------------------------------------------------------------------------------E------------------------------------------------------------------------------------------------------------------------------------------------------------------------------------------------------------------------------------------------------------------------------------------------------------------------------------------------------------------------------------------------------------------------------------------------------------------------------------------------------------------------
--------------------------------------------------------------------------------------------------------------------------------ooo---------------------------------------------------------------------------------------------------------------------------------------------------------------------------------------------------------------------------------------------------------------------------------------------------------------------------------------------------------------------------------------------------------------------------------------------------------------------------------------------------------------------------------------------------------------------------------------------------------------------------------------------------------------------------------------------------------------------------------------------------------------------------------------------------------------------------------------------------------------------------------------------------------------------------------------------------------------------------------------------------------------------------------------------------------------------------------------------------------------------------------------------------------------------------------------------------------------------------------------------------------------------------------------------------------------------
-------------------------------------Q------------SSSSSS----------------------------o--------Q-QQ--SS-----QSSSS----------?--E----XXX-----------------Q-QQ------------------------Q------------------o--------?--E-----------SSSS---------?--E------------------------QQQQ------------------------Q---------------------------?--E-----------SSSS---------?--E--------------S---------?--E---------------o--------?-QQ------------------------Q-Q----------------o--------QQQQ----------SSSS----------QQ---------------QQ---------Q--QSQSS---------QQ---------?--E------------SSS---------------------------S------------------------SSS-o--------?--E---------SSS------------Q-Q----S--------------------?--E----------------------?-QQQ-------------SSS---------Q---------------------------?--E------------------------?-?E----------SSSSS---------?--E----------SSSSS-------------QQSS-----QSSSSQo--------?--E----------SSSS-o------?QQQQQ------------------------QQQ-----------------------------------------SS----------?--E----------SSSS----------------SS-----------o--------?--E-----------SSS----------?--E----------------------?-QQQQ------------------------Q-QQ------------S-----------?--E------------------------?--E------------------------?--E------------------------Q-Q-------------------------Q------------------o--------?--E-----------SSSS---------?--E------------------------QQQQ------------------------Q------------------
--------------------------------------------------------------------------------------------------XX------------------------X-X--------------------------------------------------------------------X-----------XXXXXX----------------------XXXXX---------------------------------------X---------------------------------------QXXXX--------------------------X----------------------------------------------------QXXXX---o------XX--------------------------XX-----------------------------------------------------------------------------------------------XXXXX-------------------------------------------------------------------------------XXXXX---------------------------------------------------XXXXX----------------------------------------------------------------------------------XX-------------------------XXX-------------------------------------------------------------------------------XXXXXX-------------------------------------XX-------------------------------------------------------------------XXXX----------------------------------------------------XXXXX-----------------------XXXXXX--o-----XXX--------------------------XX---------------------------------------XXXXX-----------------------XXXXX-----------X-----------XXXXX---------------------------------------X---------------------------------------XXXXXX----------------------QXXXX----------XX---------------------------X----------------------------
------------------------------------------------------------------------------------------------------------------------------------------------------------------------------------------------------------------Q---------------------------------------------------------------------------------------------------------------------------------------------------------------------------XXX---------------------Q---XXX-------------------------------------------------------------------------------------------------------------------------------------------------------------------------------------------------------------------------------------------------Q-----------------------------------------------------------------------------------------------------------------------------------------------------------------------------------------------------------------------------------Q---------------------------------------------------------------------------------------------------------------------------------------------------------------------------------------------------QX--XXX---------------------------------------------------------------------------------------------------------Q-------------------------------------------------------------------------------------------------------------------------------------------Q---------------------------------------------------------------------
----E-------------------------------------------------------E-----------------------------E-----------------------E-------------------------------E--------------E----------E----------------E------------------------------E----------------------------------------------------E------------------------E--E------------------------------E-------E-------------------E-------------------------------------E------------------------------------------E---------------------------E--------E---------------E--E--------E---------------E--E------------E-----------------E-----E---------------------E-------E------------------------------------------------------------------------E----------E-------------------------E------------------E----------E----------------E------------E-----------E---------------E-----------------------E---------------E--S--------E---E-----------E--E--------------------------------------E----------------E--------E------------------E------------E-----------E--E------------E---------------------------E--------------E----------E------------------------------------------------------------------------E------------E--------------E------------------------------------------------------------------E-----------------------------E--------------E---------------------------E------------------------------E-------------------------------------E--------------E---------------------------E------
--E<>-----------------------------------Q--------------X--E<>-----QQ------------------E--<>---QQQQ---Q--<>-------<>---E--SQQQ-----------E-----E--<>---QQQQ------<>---QQQ--E<>--E--QQQ-------<>--------E<>----SQQQ----------<>-----E-E----SQQQ-----------------E--<>---QQQQ------<>----QQ--E<>--E--QQQ----<>-<>--------E-E<>--SQQQ-----E----<>-----E<>---?S-------------<>-----E<>--E--QQQ-------------------E<>--SQQQQ---Q--Q---------E---EE?-QQQ-------<>---QQQ--E--<>---QQQ-------<>-----Q-<>----E?-Q------<>-<>-------<>---E---QQQ----<>-<>---QQQ--E-E<>--SQQQ-----E----<>----<>---------------E----<>-----E<>------------<>-----E-------E<>--QQQQ-------------XX------E---QQQ-------<>---QQQ--E<>---SSSQQ-------<>-------<>----E?SQQQ-------<>--------E<>--E--QQQ-------<>--------E-E<>---QQQ----<>-----------E--<>---QQQ----------------<>------S-------<>-----E----<>--<>---Q------<>-<>---QQQ--E-E<>--SQQQ-----------------E<>--E?SQQQ-------<>----QQ-<>----Q--QQQ-------<>----QQ--E-E<>---QQQ----<>-<>--------E--<>--S-QQ-----------------E--<>---QQQ-------<>---QQQ--E<>----SQQQ-----------------E-E---?SQQQ----Q--Q---------E----E?SQQQQ------<>---QQQ--E--<>---QQQQ------<>---QQQ--E-E<>--SQQQ-----------E-----E-E----SQQQ-----------------E<>--E?SQQQ-----------------E-E<>---QQQQ------<>-----Q--E-E<>---QQQQ------<>--------E-E<>--SQQQ----------<>-----E-E----SQQQ-----------------E--<>--SQQQ-------<>----QQ--E----E--QQQ-------<>-----Q
-<>[]----------------------------------------------------<>[]------------------------<>--[]-------------[]-------[]--<>----------------<>----<>--[]-------------[]-------<>[]---------------[]-------<>[]------------------[]----<><>------------------------<>--[]-------------[]-------<>[]------------[]-[]-------<><>[]----------------[]----<>[]------------------[]----<>[]-------------------E-----E<>[]----------------------<>--<>-------------[]-------<>--[]-------------[]-------[]--------------[]-[]-------[]--<>----------[]-[]-------<><>[]----------------[]----[]--------------<>----[]----<>[]------------[]----<>-----E<>[]-------------------X------<>-------------[]-------<>[]---------------[]-------[]--------------X--[]-------<>[]---------------[]-------<><>[]----------[]-----E----<>--[]-----------------E----[]--------------[]----<>----[]--[]----------[]-[]-------<><>[]----------------------<>[]---------------[]-------[]-----------------[]-------<><>[]----------[]-[]-------<>--[]----------------<>----<>--[]-------------[]-------<>[]-------------------E----<><>------------------------<>-----------------[]-------<>--[]-------------[]-------<><>[]----------------<>--X-<><>------------------------<>[]-------------------E----<><>[]-------------[]-------<><>[]-------------[]-------<><>[]----------------[]----<><>------------------------<>--[]-------------[]-------<>-----------------[]------
-[][]----------------------------------------------------[][]------------------------[]--[]-------------[]-------[]--[]----------------[]----[]--[]-------------[]-------[][]---------------[]-------[][]------------------[]----[][]<>-----------------S----[]--[]-------------[]-------[][]------------]--[]-------[][][]----------------[]----[][]------------------[]----[][]------------------<>--X-<>[][]----------------------[]--[]-------------[]-------[]--[]-------------[]-------[]--------------[]-[]-------[]--[]---------->--[]-------[][][]----------------[]----[]--------------[]----[]----[][]------------[]----[]----<>[][]--------------------X-----[]-------------[]-------[][]---------------[]-------[]--------------X--[]-------[][]---------------[]-------[][][]----------[]----<>----[]--[]----------------<>----[]--------------[]----[]----[]--[]----------[]-[]-------[][][]-----------------S----[][]---------------[]-------[]-----------------[]-------[][][]----------[]-[]-------[]--[]----------------[]----[]--[]-------------[]-------[][]------------------<>----[][]------------------------[]-----------------[]-------[]--[]-------------[]-------[][][]----------------[]--X-[][]------------------------[][]------------------<>----[][][]-------------[]-------[][][]-------------[]-------[][][]----------------[]----[][]------------------------[]--[]-------------[]-------[]-----------------[]------
-[][]--------EE-EE-----E---------------E--E-EE-----E-----[][]--------EE-EE-----E-----[]--[]------EE-EE--[]-E-E---[]--[]-------E-EE-E---[]----[]-E[]-------E-EE--[]--E-E--[][]--------EE-EE--[]-EE-E--[][]-E------EE-EE-E---[]----[][][]-------E-EE-E---------[]--[]-------E-EE--[]-E--E--[][]--------EE-EE--[]-------[][][]------EE-EE-E---[]----[][]--------EE-E--EE--[]----[][]--------EE-E--E---[]-XX-[][][]-------E-EE-----E-----[]--[]-------E-EE--[]-EE-E--[]--[]-------E-EE--[]-E--E--[]--------E--E--[]-[]-------[]--[]-------E-----[]-------[][][]------EE-EE-E---[]----[]--------E--E--[]----[]----[][]--------EE--[]----[]----[][][]-E----EE-E-----E---XX-----[]-------EE----[]--E-E--[][]-E-------E-EE--[]-E-----[]-----------E--E--[]-E-----[][]--------EE-EE--[]-------[][][]------EE-E[]----[]----[]--[]------E--EE-E---[]----[]-----------E--[]----[]----[]-E[]----E-----[]-[]-------[][][]-------E-EE-E---------[][]---------E-EE--[]-E--E--[]--------E--E--E--[]-E--E--[][][]------E---[]-[]-------[]--[]------EE-EE-E---[]----[]-E[]------EE-----[]-EE-E--[][]--------EE-EE-----[]----[][]---------E-EE------E-E--[]-----------E-EE--[]-EE-E--[]-E[]-------E--E--[]----E--[][][]------EE-E------[]-XX-[][]-E------EE-EE-E---------[][]--------EE-EE-E---[]----[][][]------EE-EE--[]--E-E--[][][]------EE-EE--[]-E--E--[][][]------EE-EE-E---[]----[][]-E------EE-EE-E---------[]--[]-------E--E--[]-E--E--[]-----------E-EE--[]----E-
XXXXXXXXXXXXXXXXXXXXXXXXXXXXXXXXXXXXXXXXXXXXXXXXXXXXXXXX-XXXXXXXXXXXXXXXXXXXXXXXXXXXXXXXXXXXXXXXXXXXXXXXXXXXXXXXXXXXXXXXXXXXXXXXXXXXXXXXXXXX-XXXXXXXXXXXXXXXXXXXXXXXXXXX-XXXXXXXXXXXXXXXXXXXXXXXXXXX-XXXXXXXXXXXXXXXXXXXXXXXXXXXXXXXXXXXXXXXXXXXXXXXXXXXXXXX-XXXXXXXXXXXXXXXXXXXXXXXXXXX-XXXXXXXXXXXXXXXXXXXXXXXXXXX-XXXXXXXXXXXXXXXXXXXXXXXXXXX-XXXXXXXXXXXXXXXXXXXXXXXXXS-XXXXXXXXXXXXXXXXXXXXXXXXXXXX-XXXXXXXXXXXXXXXXXXXXXXXXXXX-XXXXXXXXXXXXXXXXXXXXXXXXXXX-XXXXXXXXXXXXXXXXXXXXXXXXXXX-XXXXXXXXXXXXXXXXXXXXXXXXXXXXXXXXXXXXXXXXXXXXXXXXXXXXXXX-XXXXXXXXXXXXXXXXXXXXXXXXXXX-XXXXXXXXXXXXXXXXXXXXXXXXXXX-XXXXX--XXXXXXXXXXXXXXXXXXXX-XXXXXXXXXXXXXXXXXXXXXXXXXXXXXXXXXXXXXXXXXXXXXXXXXXXXXXX-XXXXXXXXXXXXXXXXXXXXXXXXXXXXXXXXXXXXXXXXXXXXXXXXXXXXXXX-XXXXXXXXXXXXXXXXXXXXXXXXXXXXXXXXXXXXXXXXXXXXXXXXXXXXXXXXXXXXXXXXXXXXXXXXXXXXXXXXXXX-XXXXXXXXXXXXXXXXXXXXXXXXXXX-XXXXXXXXXXXXXXXXXXXXXXXXXXXXXXXXXXXXXXXXXXXXXXXXXXXXXXX-XXXXXXXXXXXXXXXXXXXXXXXXXXX-XXXXXXXXXXXXXXXXXXXXXXXXXXX-XXXXXXXXXXXXXXXXXXXXXXXXXXXXXXXXXXXXXXXXXXXXXXXXXXXXXXX-XXXXXXXXXXXXXXXXXXXXXXXXXXX-XXXXXXXXXXXXXXXXXXXXXXXXXXX-XXXXXXXXXXXXXXXXXXXXXXXXXXX-XXXXXXXXXXXXXXXXXXXXXXXXXXX-XXXXXXXXXXXXXXXXXXXXXXXXXXXXXXXXXXXXXXXXXXXXXXXXXXXXXXX-XXXXXXXXXXXXXXXXXXXXXXXXXXX-XXXXXXXXXXXXXXXXXXXXXXXXXXX-XXXXXXXXXXXXXXXXXXXXXXXXXXXXXXXXXXXXXXXXXXXXXXXXXXXXXXXXXXXXXXXXXXXXXXXXXXXXXXXXXXX-XXXXXXXXXXXXXXXXXXXXXXXXXXX-XXXXXXXXXXXXXXXXXXXXXXXXXXX-XXXXXXXXXXXXXXXXXXXXXXXXXXX
