--------------------------------------------------------------------------------------------------------------------------------------------------------------------------------------------------------------------------------------------------------------------------------------------------------------------------------------------------------------------------------------------------------------------------------------------------------------------------------------------------------------------------------------------------------------------------------------------------------------------------------------------------------------------------------------------------------------------------------------------------------------------------------------------------------------------------------------------------------------------------------------------------------------------------------------------------------------------------------------------------------------------------------------------------------------------------------------------------------------------------------------------------------------------------------------------------------------------------------------------------------------------------------------------------------------------------------------------------------------------------------------------------------------------------------------------------------
-------------------------------------------------------Q-----------------------------------------------------------------------------------------------------------------------------------------------------------------------------------------------------------------------------------------------------------------------------------------------------------------------------------------------------------------------------------------------------------------------------------------------------------------------------------------Q------------------------------------------------------------------------------------------------------------------------------------------------------------------------------------------------------------------------------------------------------------------------------------------------------------------------------------------------------------------------------------------------------------------------------------------------------------------------------------------------------------------------------------------------------------------------------------------------------------------------------------------------------------------------------------------------------------------------------------------------------------------------------------------------------------------------------------------------------------------------------------------------------
------------------------------------------------------------------------------------------------------------------------------------------------------------------------------------------------------------------------------------------------------------------------------------------------------------------------------------------------------------------------------------------------------------------------------------------------------------------------------------------------------------------------------o-------------------------------------------------------------------------------------------------------------------------------------------------------------------------------------------------------------------------------------------------------------------------------------------------------------------------------------------------------------------------------------------------------------------------------------------------------------------------------------------------------------------------------------------------------------------------------------------------------------------------------------------------------------------------------------------------------------------------------------------------------------------------------------------------------------------------------------------------------------------------------------------------------------------------
-----------------------------------------------------------------------------------------------------------------------------------------------------------------------------------------------------------------------------------------------------------------------------------------------------------------------------------------------------------------------------------------------------------------------------------------------------------------------------------------------------------------------------XXX------------------------------------------------------XX---------------------------------------------------------------------------------------------------------------------------------------------------------------------------------------------------------------------------------------------------------------------------------------------------------------------------------------------------------------------------------------------------------------------------E------------------------------------------------------------------------------------------------------------------------------------------------------------------------------------------------------------------------------------------------------------------------------------------------------------------------------------------------------------------------------------------------------------------------------------
-----------------------------------------------------------------------------------------------------------------------------------------------------------------------------------------------------------------------------------------------------------------------------------------------------------------------------------------------------------------------------------------------------------------------------------------------------------------------------------------------------------------------------------------------------------------------------------------------------------------------------------------------------------------------------------------------------------------------------------------------------------------------------------------------------------------------------------------------------------------------------------------------------------------------------------------------------------------------------------------------------------------E--------------------------------------------------------------------------------------------------------------------------------------------------------------------------------------------------------------------------------------------------------------------------------------------------------------------------------------------------------------------------------------------------------------------------------------
-------------------------------------?---------------------------?--E------------SSS-------------------------------------Q---SSSS----SSSSSSS---------?--E---------------o--------?--E------------------------Q-QQ------------------------Q-Q----------------o--------?--E-----------SSS----------?--E-----------SSSS---------?--E-----------SSSS---------?--------------SS-----------QQQQ--------------------------Q----S--------------------?--E----------SSSSS-------------------------SSS----------------------------o--------?-QQ--------SSSSSSS---------Q-Q-------------SS-o--------QQQE----------SSSSS-------?-QQ-E------------------------Q-Q---S------------------------E------------------------?--E---------SSSSSS-------?-QQ--------------SQQ---------?-QE-----------SS--o------?-QQQ-------------SS----------?--E------------------------QQQQ----------------------------------------------------?--E------------SSS---------?--E-----------SSSS--------------SSSS-------------------?-Q----------SSSSSS---------?--E----------------------?-QQQQ----------------------------------------------------?--E------------------------?--E-----------SSSS---------?------------------o--------QQQQ------------S-----------?--E------------------------QQQQ----------------------------------------------------?--E------------------------?S-E-----------SSSS---------?--E----------------------------------------------------?--E---------------
-------------------------------------------------------------------XXXXXX--------------------------------------X---------------------------------------XXXXX-----------------------QXXXXX--o------XX-------------------------------------------------------------------XXXXXX----------------------XXXXXX-------------------------XX-----------------------XXXXX----------------------------------------------------------------------------------XX----------------------------------------------------------------------------------XX------------------------------------------------------XX-----------------------------------------------------------------------------------------------------------XXXXXX--------------------------------------------------QXXXXX----------X------------------------------------------X----------------------------------------X---------------------------------------XXXXX------------------------X-X--------------------------------------------------------------------------------XXXXXX---------XX--------------------------XX----------------------------------------XXXX-----------------------XXXXXX-------------------------------------XX--------------XX-----------------------XXXXX---------------------------------------------------------------------------------XXX------------------------XXXX-----------------------XXXXX---------------------------------------------------XXXXXX-----------
--------------------------------------------------------------------------------------------------------------------------------------------------------------------------------------Q---XXX-----------------------------------------------------------------------------Q-----------------------------------------------------------------------------------Q-----------------------------------------------------------------------------------Q-----------------------------------------------------------------------------------Q-------------------------------------------------------Q-----------------------------------------------------------------------------------------------------------------------------------------------------------------------Q-----------------------------------------------------------------------------------------------------------------------------------------------------------------------------------------------------------------------------------------------------------Q-------------------------------------------------------------------------------------------------------------------------------------------------X-----------------------------------------------------------------------------------------------------------------------------------------------------------------------------------------------------------------------------------------------------Q-------------
------------------------------E---------------E-------------E-------------------E-------E----------------E------------E--------------E----------E-------------------E---------E--------------E----------E-----------------------------E--------------E--------------------------------------E-------------------E-----E---------------E--E---------------------------E----------E----------------E---------------------------E------------E--------------E--------E-E-------------E-----E-----E---------------E---------------E-----------E---------------E--------------E------------------------E-----------E---------------E--E------------E--------------E------------------------E-----------E---------------------E-----E------------------E------------E-------------------------E----------------E----------E----------------E------------E--------------E---------------------------E----------E-------------------E-----E---------------------E---------E---------------------------E--------------E----------E---------------------------E----------------E------------E--------------E----------------------------------------------------------E--o------E-------------------------E----------------E----------E-----------------------------E--------------E----------E-------------------------------------------------------E----------------E----------E-----------------------------E--------------E------------E-----------------E---
--E--------------------------<>----S?S-------<>-----E-----E<>----S-QQ----------<>-----E<>--Q--QQQ-------<>-----Q--E--<>---QQQ-------<>--------E<>----SQQQ----------<>-------E<>--SQQQ-------<>--------E<>--E-SQQQQ------<>--------E-E<>---QQQ-------<>---QQQ--E-E<>--SQQQ-----------------E<>----SQQQ----------<>----<>----E?SQQQ----<>-<>----E?--E-E--E?SQQQ-------<>--------E<>--E?SQQQ-------<>-----?--E----E--QQQQ------<>--------E--<>---QQQ----<>-<>-------<><>----S-------<>----<>----<>----E--QQQ----<>-----------E--<>--SQQQ----<>-------?S--E--<>--QQQ--------<>---QQQ--E---E--SQQQ----<>--------S-<>----E?SQQ-----<>-<>--------E--<>---QQQQ------<>---QQQ--E-E----SQQQ----<>-----E----<>--<>--S-------<>----<>----<>----E?S-------S--<>---QQQ--E-E<>--SQQQQ----------------E<>--E?SQQQ-------<>--------E<>--E?SQQQ-------<>--------E--<>--SQQQQ------<>---QQQ--E<>--E--QQQ-------<>--------E<>----SQQQ-----E----<>----<>----E?S--------E----<>-------E<>---QQQQ--Q-------------E--<>--SQQQ-------<>----QQ--E<>--E?SQQQ-----------------E<>--E?SQQQ-------<>-----Q--E--<>---QQQ-------<>-----Q--E-E<>--SQQQ----<>-----------E<>----SQQQ-----E----<>-------E<>---QQQQ---Q------------E<>--E?SQQQ-------<>--------E<>--E?SQQQ-----------E-----E--<>--SQQQQ------<>---QQQ--E<>--E--QQQQ----------------E-E<>---QQQ-----------E-----E<>----SQQQ-------<>--------E<>--E?SQQQ-----------------E-E<>---QQQ-------<>-----Q--E-E<>--SQQQ----------<>---
-<>--------------------------[]--------------[]----<>----<>[]------------------[]----<>[]---------------[]-------<>--[]-------------[]-------<>[]------------------[]----<><>[]-------------[]-------<>[]---------------[]-------<><>[]-------------[]-------<><>[]-----------------E----<>[]------------------[]----[]<>------------[]-[]-------<><>---------------[]-------<>[]---------------[]-------<><>---------------[]-------<>--[]----------[]-[]--E----[][]------------[]----[]----[]--------------[]--E-------<>--[]----------[]----------<>--[]-------------[]-------<>--<>----------[]----------[]--------------[]-[]-------<>--[]-------------[]-------<>[]------------[]----<>----[]--[]----------[]----[]----[]-----------------[]-------<><>[]----------------------<>[]---------------[]-------<>[]---------------[]-------<>--[]-------------[]-------<>[]---------------[]-------<>[]------------------[]----[]--------------------[]-----E<>[]----------------------<>--[]-------------[]-------<>[]------------------------<>[]---------------[]-------<>--[]-------------[]-------<><>[]----------[]-----E----<>[]------------E-----[]-----E<>[]----------------------<>[]---------------[]-------<>[]------------------<>----<>--[]-------------[]-------<>[]---------------<>-------<><>[]----------------<>----<>[]---------------[]-------<>[]-------------------E----<><>[]-------------[]-------<><>[]----------------[]---
-[]--------------------------[]--------------[]----[]----[][]------------------[]----[][]---------------[]-------[]--[]-------------[]-------[][]------------------[]----[][][]-------------[]-------[][]---------------[]-------[][][]-------------[]-------[][][]----------------<>----[][]------------------[]----[][]------------[]-[]-------[][]<>-------------[]-------[][]---------------[]-------[][]<>-------------[]-------[]--[]----------[]-[]-<>----[][]------------[]----[]----[]-E------------[]-<>-----X-[]--[]----------[]----------[]--[]-------------[]-------[]--[]----------[]----------[]--------------[]-[]-------[]--[]-------------[]-------[][]------------[]----[]----[]--[]----------[]----[]----[]-----------------[]-------[][][]----------------------[][]---------------[]-------[][]---------------[]-------[]--[]-------------[]-------[][]---------------[]-------[][]------------------[]----[]--------------------[]----<>[][]----------------------[]--[]-------------[]-------[][]------------------------[][]---------------[]-------[]--[]-------------[]-------[][][]----------XX----<>----[][]------------------[]----<][][]----------------------[][]---------------[]---<>--[][]------------------[]----[]--[]-------------[]-------[][]---------------[]-------[][][]----------------[]--X-[][]---------------[]-------[][]------------------<>----[][][]-------------[]-------[][][]----------------[]---
-[]-----------E-EE-----E--E--[]-----E-----E--[]----[]----[][]--------EE-E--E---[]----[][]---------EE----[]-EE-E--[]--[]-------E--E--[]-E-E---[][]--------EE-EE-E---[]----[][][]-E----EE-EE--[]-------[][]---------E-EE--[]-E--E--[][][]------EE-E---[]----E--[][][]------EE-EE-----[]----[][]-E------EE-EE-E---[]----[][]---------E--[]-[]-------[][][]-------E-EE--[]-E--E--[][]---------E-EE--[]-E--E--[][][]------EE-EE--[]--E-E--[]-E[]------E------[]-[]----[][]---------E--[]----[]----[][]--------EE--[]-[]----XX-[]--[]-------E--[]----------[]--[]-------E-----[]----E--[]--[]-------E--[]----------[]-----E-----E--XX-[]-------[]--[]-------EE-E--[]-E--E--[][]-E------EE--[]----[]----[]--[]------EE--[]----[]----[]-----------E-----[]-------[][][]-E----EE-EE-E---------[][]---------E--E--[]-E-----[][]---------E-EE--[]-E-----[]-E[]-------E-EE--[]--E-E--[][]---------E-EE--[]----E--[][]-E------EE-EE-E---[]----[]----------EE-EE-E---[]----[][][]------E--EE---E-EE-E--[]--[]-------E-EE--[]-E--E--[][]---------E-EE--------E--[][]---------E-EE--[]-EE-E--[]-E[]-------E-EE--[]-EE-E--[][][]------EE-EE-----[]----[][]-E------EE-EE-E---[]----[][][]------EE-EE-----EE-E--[][]---------E-EE--[]-E-[]--[][]---------E-EE-E---[]----[]-E[]-------E-EE--[]--E-E--[][]--------EE-EE--[]-EE-E--[][][]------EE-E----E-[]----[][]-E------EE-EE--[]-------[][]---------E-EE-E---[]----[][][]------EE-EE--[]--E-E--[][][]------EE-EE-E---[]---
-XXXXXXXXXXXXXXXXXXXXXXXXXXX-XXXXXXXXXXXXXXXXXXXXXXXXXXX-XXXXXXXXXXXXXXXXXXXXXXXXXXX-XXXXXXXXXXXXXXXXXXXXXXXXXXXXXXXXXXXXXXXXXXXXXXXXXXXXXXX-XXXXXXXXXXXXXXXXXXXXXXXXXXX-XXXXXXXXXXXXXXXXXXXXXXXXXXX-XXXXXXXXXXXXXXXXXXXXXXXXXXX-XXXXXXXXXXXXXXXXXXXXXXXXXXX-XXXXXXXXXXXXXXXXXXXXXXXXXXXXXXXXXXXXXXXXXXXXXXXXXXXXXXXXXXXXXXXXXXXXXXXXXXXXXXXXXXXXXXXXXXXXXXXXXXXXXXXXXXXXXXX-XXXXXXXXXXXXXXXXXXXXXXXXXXXXXXXXXXXXXXXXXXXXXXXXXXXXXXXXXXXXXXXXXXXXXXXXXXXXXXXXXXX-XXXXXXXXXXXXXXXXXXXXXXXXXXXXXXXXXXXXXXXXXXXXXXXXXXXXXXX-XXXXXXXXXXXXXXXXXXXXXXXXXXX-XXXXXXXXXXXXXXXXXXXXXXXXXXX-XXXXXXXXXXXXXXXXXXXXXXXXXXXXXXXXXXXXXXXXXXXXXXXXXXXXXXXXXXXXXXXXXXXXXXXXXXXXXXXXXXXXXXXXXXXXXXXXXXXXXXXXXXXXXXXXXXXXXXXXXXXXXXXXXXXXXXXXXXXXXXXXXXXXXXXXXXXXXXXXXXXXXXXXXXXXXXXXXXXXXXXXXXXXXXXXXXX-XXXXXXXXXXXXXXXXXXXXXXXXXXX-XXXXXXXXXXXXXXXXXXXXXXXXXXX-XXXXXXXXXXXXXXXXXXXXXXXXXXXXXXXXXXXXXXXXXXXXXXXXXXXXXXX-XXXXXXXXXXXXXXXXXXXXXXXXXXX-XXXXXXXXXXXXXXXXXXXXXXXXXXX-XXXXXXXXXXXXXXXXXXXXXXXXXXX-XXXXXXXXXXXXXXXXXXXXXXXXXXX-XXXXXXXXXXXXXXXXXXXXXXXXXXX-XXXXXXXXXXXXXXXXXXXXXXXXXXX-XXXXXXXXXXXXXXXXXXXXXXXXXXXXXXXXXXXXXXXXXXXXXXXXXXXXXXXXXXXXXXXXXXXXXXXXXXXXXXXXXXXXXXXXXXXXXXXXXXXXXXXXXXXXXXXXXXXXXXXXXXXXXXXXXXXXXXXXXXX-XXXXXXXXXXXXXXXXXXXXXXXXXXX-XXXXXXXXXXXXXXXXXXXXXXXXXXX-XXXXXXXXXXXXXXXXXXXXXXXXXXX-XXXXXXXXXXXXXXXXXXXXXXXXXXXXXXXXXXXXXXXXXXXXXXXXXXXXXXX-XXXXXXXXXXXXXXXXXXXXXXXXXXX-XXXXXXXXXXXXXXXXXXXXXXXXXXX-XXXXXXXXXXXXXXXXXXXXXXXXXXX
