--------------------------------------------------------------------------------------------------------------------------------------------------------------------------------------------------------------------------------------------------------------------------------------------------------------------------------------------------------------------------------------------------------------------------------------------------------------------------------------------------------------------------------------------------------------------------------------------------------------------------------------------------------------------------------------------------------------------------------------------------------------------------------------------------------------------------------------------------------------------------------------------------------------------------------------------------------------------------------------------------------------------------------------------------------------------------------------------------------------------------------------------------------------------------------------------------------------------------------------------------------------------------------------------------------------------------------------------------------------------------------------------------------------------------------------------------------
--------------------------------------------------------------------------------------------------------------------------------------------------------------------------------------------------------------------------------------------------------------------------------------------------------------------------------------------------------------------------------------------------------------------------------------------------------------------------------------------------------------------------------------------------------------------------------------------------------------------------------------------------------------------------------------------------------------------------------------------------------------------------------------------------------------------------------------------------------------------------------------------------------------------------------------------------------------------------------------------------------------------------------------------------------------------------------------------------------------------------------------------------------------------------------------------------------------------------------------------------------------------------------------------------------------------------------------------------------------------------------------------------------------------------------------------------------
--------------------------------------------------------------------------------------------------------------------------------------------------------------------------------------------------------------------------------------------------------------------------------------------------------------------------------------------------------------------------------------------------------------------------------------------------------------------------------------------------------------------------------------------------------------------------------------------------------------------------------------------------------------------------------------------------------------------------------------------------------------------------------------------------------------------------------------------------------------------------------------------------------------------------------------------------------------------------------------------------------------------------------------------------------------------------------------------------------------------------------------------------------------------------------------------------------------------------------------------------------------------------------------------------------------------------------------------------------------------------------------------------------------------------------------------------------
--------------------------------------------------------------------------------------------------------------------------------------------------------------------------------------------------------------------------------------------------------------------------------------------------------------------------------------------------------------------------------------------------------------------------------------------------------------------------------------------------------------------------------------------------------------------------------------------------------------------------------------------------------------------------------------------------------------------------------------------------------------------------------------------------------------------------------------------------------------------------------------------------------------------------------------------------------------------------------------------------------------------------------------------------------------------------------------------------------------------------------------------------------------------------------------------------------------------------------------------------------------------------------------------------------------------------------------------------------------------------------------------------------------------------------------------------------
--------------------------------------------------------------------------------------------------------------------------------------------------------------------------------------------------------------------------------------------------------------------------------------------------------------------------------------------------------------------------------------------------------------------------------------------------------------------------------------------------------------------------------------------------------------------------------------------------------------------------------------------------------------------------------------------------------------------------------------------------------------------------------------------------------------------------------------------------------------------------------------------------------------------------------------------------------------------------------------------------------------------------------------------------------------------------------------------------------------------------------------------------------------------------------------------------------------------------------------------------------------------------------------------------------------------------------------------------------------------------------------------------------------------------------------------------------
-------------SSS---------SSS-------------------------SS----------QQQ-------------------------?------------------o--------?-QQ----------SSSS----------?--E-----------SS--o------?QQQQQ------------S-----------Q-Q----S--------------------Q-Q----S--------------------?--E-----------SSSS---------?--E------------S-----------Q-Q-------------------------Q---------------------------?--E-----------SS--o--------?--E---------------o--------QQQQ------------------------Q-Q-------------------------?--E-----------SSSS---------?--E-----------SSSS---------?-?QSQS-----SSSSSSS---------?---------------SS-o--------?-------------SSSS----------QQQ-------------------------Q-Q-----------------------?-QQQ---------------------------------------------------------------------SSS---------?--E--------SSSSSSS---------?--E------------------------?--E----------------------?-QQQQ------------S-----------?--E-----------SS-----------QQQQ----------------------------------------------------?--E-----------SSSS---------?--E------------------------?-------------------------------------------------------?--E------------SSS---------?--E-----------SSS----------QQQQ------------------------Q-Q-------------------------?--E------------------------?--E----------SSSSS---------?--E------------------------?-QE-----------SSS----------?--E------------SS----------?--E--------------------------Q--QSS---------------------------------------
-------------------------------------------------------------------------------------------------------o------XX--------------XX-----------------------XX-X---------------------------XX-------------------------------------------------------------------------------XXXXX-----------------------XXXXX-------------------------------------------------------------------------------XXXXXX----------X-----------XXXXXX----------X-------------------------XXX--------------------------------------------------------------------X-X---------------------------XX-------------------------XXX-------------------------XXX-------------------------------------------------------------------------------------------------------------------------------------------------------------------XXXXXX-------------------------XX-----------------------XXXXXX---------XX---------------------------------------XXXXX---------------------------------------------------------------------------------XXX-----------------------XXXXX--------------------------XX---o-------X---------------------------------------XXXXX-----------------------XXXXXX-------------------------------------XX-------------------------------------------------------------------XXXXXX------------------------XXX--------------------------XX-----------------------XXXXXX----------------------XXXXX---------XXX--------------------------------------------------------
------------------------------------------------------------------------------------------------------XXX-----------------------------------------------------------------------------Q-------------------------------------------------------------------------------------------------------------------------------------------------------------------------------------------------------------------------------Q-------------------------------X-X---------------------------------------------------------------------------------------------------------Q---------------------------Q---------------------------Q-------------------------------------------------------------------------------------------------------------------------------------------------------------------------------------------------------------------------------Q---XXX-------------------------------------------------Q------------------------------------------------------------------------------------------------------------------------------------------------XX-----------------------------------------------------------------------------Q-----------------------------------------------------------------------------------------------------------------------------------------------------------------------------------------------------------------------------------------------------------------------------------------------------
----------------------------------------------E------------------------------E----------E-----------------------------E-----------------------------------------------------E----------------E------------E--------------E------------E--------------E------------------------------E----------------------------------------------------E---------------------------E--------------------------------------E--------------------------------------------E------------E--------------E------------------------E-----------E-E-------------E--S--E---------E-----------------------E---E--------------E--?---------E--------------E----------E----------------E------------E--------------E--------E------------------E--------------------------------------E-----------------------------E------------------------------------------E------------E--------------E--------E------------------E--?------------------------E---------------------------E---------------------------E------------E-----------------E-----E---------------------E--o------E---------------------------E--------------E----------E-------------E-----E--o-------------------------------------------------E------------E--------------E---------------------------------------------------------------------------------------------------------------E----------E--------------------------------------------E------------E--------------E----------E-----------------------
--E<>------QQ-----------E-----E--------------<>--------?-------E?S-QQ----E--<>--------E<>--E--QQQ-----------------E-E<>---QQQQ------<>--------E-E--E?SQQQ-----------------E<>--E?SQQQQ------<>--------E--<>---QQQQ------<>----QQ--E-E<>---QQQQ------<>--------E---E--SQQQ----<>----<>-----E-E<>--SQQQ-----------------E->--E--QQQQ------<>--------E<>--E--QQQQ------<>--------E-E<>--SQQQ-----------------E<>---?SQQQ---------------------E--SQQQQ------<>----QQ--E--<>---QQQQ------<>---QQQ----E<>--SQQQ----<>----------<><>--E?SQ------<>----<>-----E--<>---QQQQ---------------<>--<>--SQQQ----Q--<>----QQ--E-E<>--SQQQ-------<>--------E<>---?-QQQ-------<>--------E--<>---QQQ-------<>---QQQ-<>----E?SQQQ-------<>--------E-ES----QQQ-----------------E<>-----QQQ----<>----------<>--<>--SQQQ----<>-----E-----E-E<>--SQQQ-------<>-----Q--E--<>--SQQQ-------<>---QQ?-<>----E?SQQQ-------<>----QQ--E-E<>--SQQQ-------<>--------E--<>--SQQQ-------<>----QQ----E<>---QQQQ------<>-----Q--E-E<>--SQQQ----------<>----<><>--E?SQQQ----------<>-------E<>---QQQQ---Q------------E-E<>---QQQQ------<>--------E<>---?SQQQ----<>----<>-----E-E<>--SQQQ-----------E-----E-E--E?SQQQ-------<>----QQ--E--<>---QQQQ------<>-----Q--E-E<>---QQQQ----------------E-E----SQQQ-----E-----E-------E----SQQQQ----------E-----E-E----SQQQ-------<>--------E<>---?SQQQ-----------E-----E---E??SQQQ-------<>-----Q--E--<>---QQQQ------<>---QQQ--E<>-----QQQ---------------
-<>[]------------------<>----<>--------------[]-----------E-------------<>--[]-------<>[]------------------------<><>[]-------------[]-------<><>-------------------E----<>[]---------------[]-------<>--[]-------------[]-------<><>[]-------------[]-------<><><>----------[]----[]----<><>[]-----------------E----<>[]---------------[]-------<>[]---------------[]-------<><>[]-----------------E----<>[]-------------------E-----E<><>-------------[]-------<>--[]-------------[]-------<><>[]----------[]-----E----[][]------------[]----[]----<>--[]----------------------[]--[]-------------[]-------<><>[]-------------[]-------<>[]---------------[]-------<>--[]-------------[]-------[]-----------------[]-------<><>------------------------<>[]------------[]-----E----[]--[]----------[]----<>----<><>[]-------------[]-------<>--[]-------------[]-------[]-----------------[]-------<><>[]-------------[]-------<>--[]-------------[]--------E<>[]-------------[]-------<><>[]----------------[]----[][]------------------[]-----E<>[]----------------------<><>[]-------------[]-------<>[]------------[]----[]----<><>[]----------------<>----<><>---------------[]-------<>--[]-------------[]-------<><>[]-----------------E----<><>------------------<>----<><>------------------<>----<><>---------------[]-------<>[]------------------<>----<>--<>-------------[]-------<>--[]-------------[]-------<>[]-----------------------
-[][]------------------[]----[]--------------[]----------<>-------------[]--[]-------[][]------------------------[][][]-------------[]-------[][]------------------<>----[][]---------------[]-------[]--[]-------------[]-------[][][]-------------[]-------[][][]----------[]----[]----[][][]----------------<>----[][]---------------[]-------[][]---------------[]-------[][][]----------------<>----[][]------------------<>----<>[][]-------------[]-------[]--[]-------------[]-------[][][]----------[]----<>----[][]------------[]----[]----[]--[]----------------------[]--[]-------------[]-------[][][]-------------[]-------[][]---------------[]---X---[]--[]-------------[]-------[]-----------------[]-------[][]------------------------[][]------------[]-<>-<>----[]--[]----------[]----[]----[][][]-------------[]-------[]--[]-------------[]-------[]-----------------[]-------[][][]-------------[]-------[]--[]-------------[]-------<>[][]-------------[]-------[][][]----------------[]----[][]------------------[]----<>[][]----------------------[][][]-------------[]-------[][]------------[]----[]----[][][]----------------[]----[][]---------------[]-------[]--[]-------------[]-------[][][]----------------<>----[][]------------------[]----[][]------------------[]--X-[][]SS-------------[]-------[][]------------------[]----[]--[]-------------[]-------[]--[]-------------[]-------[][]-----------------------
-[][]--------EE-EE-E---[]----[]-------EE-EE--[]----------[]-----------E-[]--[]-E-E---[][]--------EE-EE-----------[][][]-------E-EE--[]-E-----[][]---------E-EE-E---[]----[][]---------E-EE--[]-E-EE--[]--[]-------E-EE--[]-EE-E--[][][]------EEE----[]-E-----[][][]------EE-E[]----[]----[][][]------EE-EE-E---[]----[][]---------E-EE--[]-E--E--[][]--------EE-EE--[]----E--[][][]------EE-EE-E---[]----[][]--------EE-EE-E---[]----[][][]-------E-EE--[]--E-E--[]-E[]-------EE-E--[]--E-E--[][][]------EE--[]----[]----[][]------E--E--[]----[]----[]-E[]------EE-EE-E---------[]--[]-------E-----[]-------[][][]-------E-EE--[]-E-----[][]---------E-----[]-E-X---[]--[]-------E-EE--[]-E--E--[]-----------E-EE--[]-E-E---[][]-E------EE-EE-----E-----[][]--------EE-EX--[]-[]----[]-E[]------EE-EXXE---[]----[][][]------EE-EE--[]----E--[]--[]------EE-EE--[]-------[]-----------E-----[]-------[][][]------EE-EE--[]-------[]-E[]-------E-EE--[]-E--E--[][][]-------E-EE--[]--E-E--[][][]------EE-EE-E---[]----[][]--------EE-EE-E---[]----[][][]-E-------EE-----EE-E--[][][]------EE-EE--[]-EE-E--[][]--------EE--[]----[]----[][][]------EE-EE-E---[]----[][]---------E-EE--[]-EE-E--[]--[]-------E-EE--[]-EE-E--[][][]------EE-EE-----[]----[][]-E------EE-EE-E---[]----[][]-E------EE-EE-E---[]----[][]--------EE-EE--[]-E-----[][]---------E-EE-E---[]----[]--[]-------E-EE--[]----E--[]-E[]-------E-EE--[]--E-E--[][]-E------EE-E------E----
-XXXXXXXXXXXXXXXXXXXXXXXXXXX-XXXXXXXXXXXXXXXXXXXXXXXXXXX-XXXXXXXXXXXXXXXXXXXXXXXXXXX-XXXXXXXXXXXXXXXXXXXXXXXXXXX-XXXXXXXXXXXXXXXXXXXXXXXXXXX-XXXXXXXXXXXXXXXXXXXXXXXXXXX-XXXXXXXXXXXXXXXXXXXXXXXXXXXXXXXXXXXXXXXXXXXXXXXXXXXXXXXXXXXXXXXXXXXXXXXXXXXXXXXXXXXXXXXXXXXXXXXXXXXXXXXXXXXXXXX-XXXXXXXXXXXXXXXXXXXXXXXXXXX-XXXXXXXXXXXXXXXXXXXXXXXXXXX-XXXXXXXXXXXXXXXXXXXXXXXXXXX-XXXXXXXXXXXXXXXXXXXXXXXXXXX-XXXXXXXXXXXXXXXXXXXXXXXXXXXXXXXXXXXXXXXXXXXXXXXXXXXXXXX-XXXXXXXXXXXXXXXXXXXXXXXXXXX-XXXXXXXXXXXXXXXXXXXXXXXXXXX-XXXXXXXXXXXXXXXXXXXXXXXXXXX-XXXXXXXXXXXXXXXXXXXXXXXXXXXXXXXXXXXXXXXXXXXXXXXXXXXXXXXXXXXXXXXXXXXXXXXXXXXXXXXXXXX-XXXXXXXXXXXXXXXXXXXXXXXXXXXXXXXXXXXXXXXXXXXXXXXXXXXXXXX-XXXXXXXXXXXXXXXXXXXXXXXXXXXXXXXXXXXXXXXXXXXXXXXXXXXXXXX-XXXXXXXXXXXXXXXXXXXXXXXXXXXXXXXXXXXXXXXXXXXXXXXXXXXXXXX-XXXXXXXXXXXXXXXXXXXXXXXXXXXXXXXXXXXXXXXXXXXXXXXXXXXXXXX-XXXXXXXXXXXXXXXXXXXXXXXXXXX-XXXXXXXXXXXXXXXXXXXXXXXXXXX-XXXXXXXXXXXXXXXXXXXXXXXXXXX-XXXXXXXXXXXXXXXXXXXXXXXXXXXXXXXXXXXXXXXXXXXXXXXXXXXXXXXXXXXXXXXXXXXXXXXXXXXXXXXXXXX-XXXXXXXXXXXXXXXXXXXXXXXXXXX-XXXXXXXXXXXXXXXXXXXXXXXXXXXXXXXXXXXXXXXXXXXXXXXXXXXXXXX-XXXXXXXXXXXXXXXXXXXXXXXXXXX-XXXXXXXXXXXXXXXXXXXXXXXXXXXXXXXXXXXXXXXXXXXXXXXXXXXXXXX-XXXXXXXXXXXXXXXXXXXXXXXXXXX-XXXXXXXXXXXXXXXXXXXXXXXXXXX-XXXXXXXXXXXXXXXXXXXXXXXXXXXXXXXXXXXXXXXXXXXXXXXXXXXXXXX-XXXXXXXXXXXXXXXXXXXXXXXXXXX-XXXXXXXXXXXXXXXXXXXXXXXXXXX-XXXXXXXXXXXXXXXXXXXXXXXXXXX-XXXXXXXXXXXXXXXXXXXXXXXXXXX
