--------------------------------------------------------------------------------------------------------------------------------------------------------------------------------------------------------------------------------------------------------------------------------------------------------------------------------------------------------------------------------------------------------------------------------------------------------------------------------------------------------------------------------------------------------------------------------------------------------------------------------------------------------------------------------------------------------------------------------------------------------------------------------------------------------------------------------------------------------------------------------------------------------------------------------------------------------------------------------------------------------------------------------------------------------------------------------------------------------------------------------------------------------------------------------------------------------------------------------------------------------------------------------------------------------------------------------------------------------------------------------------------------------------------------------------------------------
--------------------------------------------------------------------------------------------------------------------------------------------------------------------------------------------------------------------------------------------------------------------------------------------------------------------------------------------------------------------------------------------------------------------------------------------------------------------------------------------------------------------------------------------------------------------------------------------------------------------------------------------------------------------------------------------------------------------------------------------------------------------------------------------------------------------------------------------------------------------------------------------------------------------------------------------------------------------------------------------------------------------------------------------------------------------------------------------------------------------------------------------------------------------------------------------------------------------------------------------------------------------------------------------------------------------------------------------------------------------------------------------------------------------------------------------------------
--------------------------------------------------------------------------------------------------------------------------------------------------------------------------------------------------------------------------------------------------------------------------------------------------------------------------------------------------------------------------------------------------------------------------------------------------------------------------------------------------------------------------------------------------------------------------------------------------------------------------------------------------------------------------------------------------------------------------------------------------------------------------------------------------------------------------------------------------------------------------------------------------------------------------------------------------------------------------------------------------------------------------------------------------------------------------------------------------------------------------------------------------------------------------------------------------------------------------------------------------------------------------------------------------------------------------------------------------------------------------------------------------------------------------------------------------------
--------------------------------------------------------------------------------------------------------------------------------------------------------------------------------------------------------------------------------------------------------------------------------------------------------------------------------------------------------------------------------------------------------------------------------------------------------------------------------------------------------------------------------------------------------------------------------------------------------------------------------------------------------------------------------------------------------------------------------------------------------------------------------------------------------------------------------------------------------------------------------------------------------------------------------------------------------------------------------------------------------------------------------------------------------------------------------------------------------------------------------------------------------------------------------------------------------------------------------------------------------------------------------------------------------------------------------------------------------------------------------------------------------------------------------------------------------
--------------------------------------------------------------------------------------------------------------------------------------------------------------------------------------------------------------------------------------------------------------------------------------------------------------------------------------------------------------------------------------------------------------------------------------------------------------------------------------------------------------------------------------------------------------------------------------------------------------------------------------------------------------------------------------------------------------------------------------------------------------------------------------------------------------------------------------------------------------------------------------------------------------------------------------------------------------------------------------------------------------------------------------------------------------------------------------------------------------------------------------------------------------------------------------------------------------------------------------------------------------------------------------------------------------------------------------------------------------------------------------------------------------------------------------------------------
----------E--------------------------?---------------------------?--E-----------SSSS-------?-Q-QE-------------------------------------------o--------?-QE-----------SSS----------?-QE-----------SSS----------Q-Q-----------------------------------------------------?--E--------SSSSSSS---------?--E------------------------Q-Q-----------SS------------?-Q-------------------------?--E----------SSSS----------QQQQ----------------------?-QQQQ------------------------QQQQ------------------------?-QE------------------------?S----------SSSSSSS---------Q-QE------------------------Q-QQ------------------------Q-Q-------------------------?--E------------SS----------?--E----------SSSSS--------------------------S----------?-QQ---------QSSSS--------?-?Q-E------------S-----------QQQQ------------------------Q-Q-------------------------?--E------------SS----------?--E---------SSSSSS---------?--E------------------------?--E------------------------QQQ-----------------------?-?---------------------------Q-?Q-----------SSS----------Q-QE------------------------?--E---------------o------?-?--E-----------SSSSo--------?--E------------------------Q-QE------------------------Q-Q---S---------------------?--E------------------------?--E-----------S------------?--E-----------SSS----------?---------------------------?--E------------------------?--E-----------SSS----------Q-QQ--------------------------Q----------------
---------<>--------o--E---XX-----------XX-XX---o-------------------XXXXX-----------------------Q?-XX-----------------------------------------------------XXX--------------------------X--------------------------------------------------------------------------------XXXXXX-------------------------X--------------------------------------------------------------------------------XXXXX--------------------------XX----------XX--------------XX----------XX--------------------------XX--------------XX-------------------------XXX--------------------------X----------------------------------------X------------------------------------------------------------------------------------------------------------------------------XX------------------------XXXX--------------------------XX----------XX---------------------------X--------------XX--------------------------XX-------------------------XXX-----------------------XXXXX---o------XX------------------------------------------X---------------------------XX------------------------------------------------------XX----------XX-----------XXXXXX----------------------XXXXXX----------X--------------------------XX------------------------------------------X------------------------XXXXX----------XX-----------XXXXXX-------------------------XX--------------------------XX-----------------------XXXXXX-------------------------------------XX----------------------------
---------[]-------XXXXXX------------------QX--XXX---------------------------------------------------------------------------------------------------------Q---------------------------------------------------------------------------------------------------------------Q-----------------------------------------------------------------------------------------------------------------------------------------------X-X-------------------------------------------------------------------------------------------------------------------------------------------------------------------------------------------------------------------------------------------------------------------------------------------------------------Q---------------------------Q---------------------------Q---X-X-----------------------------------------------------------------------------------------------------------------------------------------XXXX----------------------------------------------------------------------------------------------------------------------------------------XXX---------------------Q---------------------------Q-----------------------------------------------------------------------------------------------------------------------------------------------------------------------------------------------------------------------------------------------------------------------------------------------------
------E--[]-----------------------E---------------------------------------E-----E---------------------------E-------E----------------E------------E--------------E----------E----------------E------------E--------------E----------------------------------------E-----------------E-------E-------------------E---------E--------------E------------E--------------E-------------------------------------------------------E--------E-E----------------E------------E-----------------------E---E-----------E--E------------E-------------------------E----------------E------------E--------------E---------------------------E------------------------E-----------E---------------E-----E-----E---------------E---------------E--------------E--------E------------------E---------------------------E------------E--------------E------------E-----------E--E------------E---------------------------E--------------E------------E------------------------------------------E----------E-----------------------------E--------------E----------------------------------------E-------------------------E------------------------------------------------------------------------E---------------------------E----------E-----------------------------E-------------------------------------------------------E--------------E------------E---------------------------E------------------------------------------E---------------------------E------
--E--<>--[]-------------------E-E<>---QQQ-----------------E<>----SQQQ----<>----<>-----E<>--E?SQQQQ---------<>-----E<>--E--QQQ-------<>--------E-E<>--SQQQ-------<>--------E<>--E?SQQQ-------<>--------E-E<>---QQQQ------<>-----Q--E->-----QQQQ----------------E--<>--SQQQ-----E----<>-----E<>---?S--------E----<>-----E--<>---QQQQ---Q--<>-----?--E-E<>---QQQQ------<>--------E-E<>---QQQ-----------------E-E--E?SQQQ-------<>---QQQ-<><>--E?SQQQ-------<>----QQ--E--<>---QQQQ------<>---QQQ-<>--<>--SQQQ----<>-<>----QQ--E--<>----QQ--------------S--E<>--E?SQQQ-------<>--------E--<>--SQQQQ------<>---QQQ--E---EE-SQQQ-------<>----QQ--E-E<>--SQQQ----<>----------<>--<>--S-------<>----<>----<>----E-QQ------<>-----E-----E--<>---QQQ----Q--<>---QQQ-<>----E?SQQQ-------<>--------E--<>--SQQQ-------<>---QQQ--E--<>---QQQQ------<>-----Q--E-E<>--SQQQ----<>-<>--------E--<>--SQQQ----<>-----------E-E<>--SQQQ----QQ-<>--------E-E<>---QQQQ----------------E----E--QQQ-------<>----QQ--E<>--E?-QQQ-----------------E--<>--SQQQ-------<>----------E--E-SQQQQ------------------E<>---QQQQ------<>--------E<>--E?SQQQ-----E-----E-------E<>--SQQQ-----------E-----E-E--E?SQQQ-------<>-----Q--E----E--QQQ-------<>-----?--E<>----SQQQ-----------------E--<>---QQQ-----------------E-E--E?SQQQ-----------E-----E-E<>---QQQ-------<>--------E-E<>---QQQQ----------------E--<>--SQQQ-----------E-----E-E<>--SQQQQ------<>-----Q--E-E<>---QQQQ------<>-----Q
-<>--[]--[]------------------<><>[]----------------------<>[]------------[]----[]----<>[]------------------[]----<>[]---------------[]-------<><>[]-------------[]-------<>[]---------------[]-------<><>[]-------------[]-------<>[]-------------------E----<>-E[]----------------[]----<>[]------------------[]----<>--[]-------------[]-------<><>[]-------------[]-------<><>[]--------------------X-<><>---------------[]-------[][]---------------[]-------<>--[]-------------[]-------[]--[]----------[]-[]-------<>--[]----------------------<>[]---------------[]-------<>--[]-------------[]-------<>--<>-------------[]-------<><>[]----------[]-----E----[]--[]----------[]----[]----[]--------------[]----<>----<>--[]-------------[]-------[]-----------------[]-------<>--[]-------------[]-------<>--[]-------------[]-------<><>[]----------[]-[]-------<>--[]----------[]-----E----<><>[]-------------[]--E----<><>[]----------------------<>-----------------[]-------<>[]------------------------<>--[]-------------[]-------<><>-------------------------E<>[]-------------[]-------<>[]------------------<>----<><>[]----------------<>----<>[>---------------[]-------<>-----------------[]-------<>[]-------------------E----<>--[]----------------------<><>------------------<>----<><>[]-------------[]-------<><>[]----------------------<>--[]----------------<>----<><>[]-------------[]-------<><>[]-------------[]------
-[]--[]--[]------------------[][][]----------------------[][]------------[]----[]----[][]------------------[]----[][]---------------[]-------[][][]-------------[]-------[][]---------------[]-------[][][]-------------[]-------[][]-E----------------------[][][]----------------[]----[][]------------------[]----[]--[]-------------[]-------[][][]-------------[]-------[][][]--------------------X-[][]---------------[]-------[][]---------------[]-------[]--[]-------------[]-------[]--[]-------------[]-------[]--[]----------------------[][]---------------[]-------[]--[]-------------[]-------[]--[]-------------[]-------[][][]----------[]----<>----[]--[]----------[]----[]----[]--------------[]----[]----[]--[]-------------[]-------[]-----------------[]-------[]--[]-------------[]-------[]--[]-------------[]-------[][][]----------[]-[]-------[]-E[]----------[]E---<>----[][][]-------------[]-<>----[][][]----------------------[]-----------------[]-------[][]------------------------[]--[]-------------[]-------[][]------------------------<>[][]-------------[]-------[][]------------------[]----[][][]----------------[]----[][]---------------[]-------[]-----------------[]-------[][]------------------<>----[]--[]----------------------[][]------------------[]----[][][]-------------[]-------[][][]----------------------[]--[]----------------[]----[][][]-------------[]-------[][][]-------------[]------
-[]-E[]--[]-----EE------E----[][][]-------E-EE----EE-----[][]--------EE-E[]----[]----[][]---------E-EE-E---[]----[][]--------EE-EE--[]-E--E--[][][]------EE-EE--[]-E-----[][]---------E-EE--[]-------[][][]-------E-EE--[]-EE-E--[][][]------EE-E------------[][][]------EE-EE-E---[]----[][]--------EE-EE-E---[]----[]--[]------EE-EE--[]-------[][][]------EE-EE--[]-E-E---[][]XX------EE-EE--------XX-[][]---------E-EE--[]-E--E--[][]---------E-EE--[]-E--E--[]--[]-------E-EE--[]--E-E--[]--[]------EE-E---[]-------[]-E[]------EE-EE-E---------[][]---------E-EE--[]-------[]-E[]-------E-EE--[]-E--E--[]--[]-------E-EE--[]--E-E--[][][]------EE--[]----[]----[]--[]----E-EE--[]----[]----[]--------E-EE--[]----[]-E--[]--[]------EE-E---[]-------[]-----------E-EE--[]-E-----[]--[]-------E-EE--[]-EE-E--[]--[]-------E-EE--[]-EE-E--[][][]------EE-EXX-[]-------[][][]------EE-EX[]---[]----[][][]------EE-E---[]-[]----[][][]------EE-EE-E---------[]-----------E--E--[]-E--E--[][]--------EE-EE-----------[]-E[]-------E-EE--[]-E-E---[][]---------E-EE--------E--[][][]-E----EE-EE--[]----E--[][]--------EE-EE-E---[]----[][][]------EE-EE-E---[]----[][]---------E-EE--[]--E-E--[]-E---------E--E--[]-E-EE--[][]--------EE-EE-----[]----[]--[]------EE-EE-E---------[][]---------E-EE-E---[]----[][][]------EE-EE--[]-EE-E--[][][]------EE-EE-----E-----[]--[]------EE-EE-E---[]----[][][]-------E-EE--[]--E-E--[][][]------EE-EE--[]-EE-E-
-XXXXXXXXXXXXXXXXXXXXXXXXXXX-XXXXXXXXXXXXXXXXXXXXXXXXXXXXXXXXXXXXXXXXXXXXXXXXXXXXXXX-XXXXXXXXXXXXXXXXXXXXXXXXXXX-XXXXXXXXXXXXXXXXXXXXXXXXXXXXXXXXXXXXXXXXXXXXXXXXXXXXXXX-XXXXXXXXXXXXXXXXXXXXXXXXXXX-XXXXXXXXXXXXXXXXXXXXXXXXXXXXXXXXXXXXXXXXXXXXXXXXXXXXXXXXXXXXXXXXXXXXXXXXXXXXXXXXXXX-XXXXXXXXXXXXXXXXXXXXXXXXXXXXXXXXXXXXXXXXXXXXXXXXXXXXXXXXXXXXXXXXXXXXXXXXXXXXXXXXXXXXXXXXXXXXXXXXXXXXXXXXXXXXXXX-XXXXXXXXXXXXXXXXXXXXXXXXXXXXXXXXXXXXXXXXXXXXXXXXXXXXXXXXXXXXXXXXXXXXXXXXXXXXXXXXXXX-XXXXXXXXXXXXXXXXXXXXXXXXXXXXXXXXXXXXXXXXXXXXXXXXXXXXXXX-XXXXXXXXXXXXXXXXXXXXXXXXXXX-XXXXXXXXXXXXXXXXXXXXXXXXXXX-XXXXXXXXXXXXXXXXXXXXXXXXXXXXXXXXXXXXXXXXXXXXXXXXXXXXXXX-XXXXXXXXXXXXXXXXXXXXXXXXXXX-XXXXXXXXXXXXXXXXXXXXXXXXXXXXXXXXXXXXXXXXXXXXXXXXXXXXXXXXXXXXXXXXXXXXXXXXXXXXXXXXXXXXXXXXXXXXXXXXXXXXXXXXXXXXXXXXXXXXXXXXXXXXXXXXXXXXXXXXXXX-XXXXXXXXXXXXXXXXXXXXXXXXXXXXXXXXXXXXXXXXXXXXXXXXXXXXXXX-XXXXXXXXXXXXXXXXXXXXXXXXXXX-XXXXXXXXXXXXXXXXXXXXXXXXXXX-XXXXXXXXXXXXXXXXXXXXXXXXXXX-XXXXXXXXXXXXXXXXXXXXXXXXXXX-XXXXXXXXXXXXXXXXXXXXXXXXXXX-XXXXXXXXXXXXXXXXXXXXXXXXXXX-XXXXXXXXXXXXXXXXXXXXXXXXXXX-XXXXXXXXXXXXXXXXXXXXXXXXXXX-XXXXXXXXXXXXXXXXXXXXXXXXXXX-XXXXXXXXXXXXXXXXXXXXXXXXXXXXXXXXXXXXXXXXXXXXXXXXXXXXXXX-XXXXXXXXXXXXXXXXXXXXXXXXXXXXXXXXXXXXXXXXXXXXXXXXXXXXXXX-XXXXXXXXXXXXXXXXXXXXXXXXXXX-XXXXXXXXXXXXXXXXXXXXXXXXXXX-XXXXXXXXXXXXXXXXXXXXXXXXXXXXXXXXXXXXXXXXXXXXXXXXXXXXXXX-XXXXXXXXXXXXXXXXXXXXXXXXXXX-XXXXXXXXXXXXXXXXXXXXXXXXXXX
