--------------------------------------------------------------------------------------------------------------------------------------------------------------------------------------------------------------------------------------------------------------------------------------------------------------------------------------------------------------------------------------------------------------------------------------------------------------------------------------------------------------------------------------------------------------------------------------------------------------------------------------------------------------------------------------------------------------------------------------------------------------------------------------------------------------------------------------------------------------------------------------------------------------------------------------------------------------------------------------------------------------------------------------------------------------------------------------------------------------------------------------------------------------------------------------------------------------------------------------------------------------------------------------------------------------------------------------------------------------------------------------------------------------------------------------------------------
--------------------------------------------------------------------------------------------------------------------------------------------------------------------------------------------------------------------------------------------------------------------------------------------------------------------------------------------------------------------------------------------------------------------------------------------------------------------------------------------------------------------------------------------------------------------------------------------------------------------------------------------------------------------------------------------------------------------------------------------------------------------------------------------------------------------------------------------------------------------------------------------------------------------------------------------------------------------------------------------------------------------------------------------------------------------------------------------------------------------------------------------------------------------------------------------------------------------------------------------------------------------------------------------------------------------------------------------------------------------------------------------------------------------------------------------------------
---------------------------------o--------------------------ooo-------------------------oooS--SSSS--------------SSSSSSSSSSSSSSSSSSSS--------SSS-oSSSSSSSSSSS----------------ooo---------------------SSSSSSSSSSSSSSSSSSSS------------ooo-------------------------oo--------------------------ooo-------------------------ooo-------------------------ooo-------------------------oooS------------------------oo--------------------------oo--------------------------oo--------------------------oo--------------------------ooo-------------------------oo--------------------------ooSS--SSSS------------------ooo-------------------------ooo-------------------------ooo---------------------SSS-oSSSSSSSSSS-----------------oooS--SSSS------------------ooo---------------------------------------------------------------------------------ooo--------------------------o--------------------------ooo---------------------------o-------------------------oo--------------------------o---------------------------ooo-------------------------oo--------------------------oo--------------------------oo--------------------------oo--------------------------oo--------------------------oo--------------------------oo--------------------------ooo-------------------------oo------------------------------------------------------ooo-------------------------oo--------------------------oo--------------------------oo----------------------
--------------------------------XXX------------------------XXXXX------------------------XXXX------------------------XXX-------------------------XXX------------------------XXXXX---------------------------------------------------XXXXX----------------------XXXXXX-----------------------XXXXX-----------------------XXXXX------------------------XXXX-----------------------XXXXX-----------------------XXXX------------------------XXXX------------------------XXXX------------------------XXXXX-----------------------XXXXX-----------------------XXXXX------------------------XXX------------------------XXXXX-----------------------XXXXX-----------------------XXXXX------------------------XXXX------------------------XXXX------------------------XXXX--------------------------------------------------------------------------------XXXX-----------------------XXXXX-----------------------XXXXX------------------------XXX------------------------XXXXX------------------------XX-------------------------XXXXX----------------------XXXXXX-----------------------XXXXX----------------------XXXXX------------------------XXXX------------------------XXXX------------------------XXXX-----------------------XXXXX------------------------XXXXX----------------------XXXXXX---------------------------------------------------XXXXX-----------------------XXXX-----------------------XXXXXX-----------------------XXXX---------------------
--------------------------------------------------------------------------------------------------------------------------------------------------------------------------------------------------------------------------------------------------------------------------------------------------------------------------------------------------------------------------------------------------------------------------------------------------------------------------------------------------------------------------------------------------------------------------------------------------------------------------------------------------------------------------------------------------------------------------------------------------------------------------------------------------------------------------------------------------------------------------------------------------------------------------------------------------------------------------------------------------------------------------------------------------------------------------------------------------------------------------------------------------------------------------------------------------------------------------------------------------------------------------------------------------------------------------------------------------------------------------------------------------------------------------------------------------------
------------------------SSSS------------------------SSSS-----------ooo----------SSSS------------------------SSSS------------o------------SSS------------o------------SSS------------o-----------SSSS--------------E----------SQS------------o------------SSS------------o-----------SSSS------------------------SSSS------------o-----------SSSS------------o-----------SSSS------------o-----------SSSS------------o-----------SSSS------------o-----------SSSS---------o--o-----------SSSS-----------oo-----------SSS-------------o-----------SSSS------------o-----------SSSS------S-----o------------SSS------------o-----------SSSS-----------oooo---------SSSS------------o-----------SSSS------------o------------SSS------------o------------SSS--------------E------S--SSSS---------QQQ-Q---------------------------------------SSS---------------------SSSSSSS---------------------SQSSSQQ------------------------SSSS-------------------------SSQ------------o-----------SSSS------------o------------SSS------------------------SSSS---------oooo----X------SSS------------oo-----------SSSS---------oooo----E------SSS----------oooo----E------SSSS---------o--o-----------SSSS---------oooo----E------SSSS---------o-------E------SSSS------------o-----------SSSS---------oooo----E------SSSS---------oo-o-----------SSSS------------o-----------SSSS------------o-----------SSSS----------oooo---E------SSS----------oooo----E------SSSS
--------------------------------------------------------------------------------------------------------------------------------------------------------------------------------------------------------------------------------------------------------------------------------------------------------------------------------------------------------------------------------------------------------------------------------------------------------------------------------------------------------------------------------------------------------------------------------------------------------------------------------------------------------------------------------------------------------------------------------------------------------------------------------------------------------------------------------------------------------------------------------------------------------------------------------------------------------------------------------------------------------------------------------------------------------------------o-----------------------------------------------------------------------------------o-----------------------------------------------------------------------------------o-------------------------------------------------------o---------------------------oo--------------------------------------------------------------------------------------------------------------o-------
-------------------------------------------------------------------------------------------------------------------E----SS---------------------E----SS------------------------------------------------------------------------------------------------------------------------------------------S---------------------------SS------------------------------------------------------SS------------------------S-SS--------------------------S----------------------S--S-SS------------------------S-SS---------------------o-----S--------------------------SS---------------------E--S-SS--------------------------SS--------------------------SS-SSS----------------------S---------------------------SS---------------------o---------------------------o--------------------------------------------------------------------------------------------------------------------------------------------------------------------------------------------------------S-----------------------------------------------------------------------------------S---------------------------S---------------------------S-------------------------S-SS--------------------------SS------------------------S-SSS-------------------------S-------------------------------------------------------S----------------------S--S-SS---------------------E----SS--------------------------SS------------------------------------------------------S-------------------
-----o------------E--S------------------------E---------------------------E---------------------------E---------------SoS---------E--o------------SoS---------E--o------------------------E-----------------S---------E--o------------------------E---------------------------E-----------------S---------E----------------oS---------E---------------------------E---------------SoS---------E---------------SoS---------E--o------------SoS---------E----------oSS--SoS---------E---------------SoS---------E-----------------S---------E---------------SoS---------E----------oS---SoS---------E--o------------SoS---------E-----------------S---Q-----E---------------SoS---------E-----------------S---------E--o------------------------E---------------------------E-------------------------------------------------------E-----E--o------------------E---------------------------E---------------------------E---------------------------E---------------SoS---------E---------------------------E---------------------------E-----------------S---------E---------------SoS---------E---------------SoS---------E---------------SoS---------E---------------SoS---------E---------------SoS---------E---------------------------E-----------------S---------E---------------SoS---------E---------------SoS---------E---------------SoS---------E--o------------SoS---------E---------------------------E---------------SoS---------E---------
-----------------<>-----E--------------------<>--------------------------<>------E?S-----------------<>------E?S-SS---SSS--------<>------E?S-SS---SSS--------<>------E?S-----------------<>------E?S-------S---------<>------E?S-----------------<>------E?S-----------------<>--S-----------------------<>-----ES?S-------SS--------<>------E?S-----------------<>------E?S-------SS--------<>------E?S--S---SSS--------<>------E?SXXS---SSS--------<>------E?SSSS---SSS--------<>------E?SXSS---SSS--------<>------S?S-----------------<>------E?S--S----SS--------<>------E?SSSS---SSS--------<>------E?S-------SS--------<>------E?S-----------------<>------S?S-------SS--------<>------E?S-------S---------<>------E?S-----------------<>------E?S-----------------<>------E?S--o---QQQQQQ-Q-------------------------------<>----<>--------------------<>-----E--S-----------------<>------S?S-----------------<>------E?S-----------------<>------E?S-------SS--------<>------E?S-----------------<>--------S-----------------<>-----ES?S-------------XX--<>-XXX--E?X-------SS--------<>------E?SXXS----SS----XX--<>-XX---E?XXXS---SSS----XX--<>------E?X--S---SSS--------<>------E?SXXS---SSS--------<>------E?XXXS----SS----XX--<>------E-------------------<>------E?SXX-----SS--------<>------E?XSSSS--SSS--------<>-----E-----S---SSS--------<>------E?SXSS---SSS--------<>------E?S--------------X--<>-XXX--E?XXXS---SSS----XX--<>-X----E--
-----------------[]----<>--------------------[]--------------------------[]--------------------------[]--------------------------[]--------------------------[]--------------------------[]--------------------------[]--------------------------[]--------------------------[]------------o-------------[]----<>--------------------[]--------------------------[]--------------------------[]------------o-------------[]------------o-------------[]-----E--------------------[]--------------------------[]--------------------------[]------------o-------------[]------------o-------------[]--------------------------[]--------------------------[]--------------------------[]--------------------------[]--------------------------[]--------------------------[]------------------------------------------------------[]----[]--------------------[]--------------------------[]--------------------------[]--------------------------[]------------o-------------[]--------------------------[]--------------------------[]----<>-----Eo-------------[]------------o-------------[]------------o-------------[]------------o-------------[]------------o-------------[]------------o-------------[]------------o-------------[]--------------------------[]------------o-------------[]--------------------------[]----<>------o-------------[]------------o-------------[]------------o-------------[]------------o-------------[]---------
-----------------[]----[]--------------------[]-----------XXXXX----------[]------------XX------------[]------------XX------------[]------------XX------------[]-----------XXXXX----------[]-----------XXXX-----------[]------------X-------------[]-----------XXXXXX---------[]-----------XXXXX----------[]----[]-----XXXX-----------[]--------------------------[]-----------XXXX-----------[]-----------XXXXX----------[]-----------XXXXX----------[]-----------XXXX-----------[]-----------XXXXX----------[]------------XXXX----------[]-----------XXXXX----------[]-----------XXXXX----------[]-----------XXXX-----------[]-----------XXXXX----------[]-----------XXXXX----------[]-----------XXXX-----------[]------------X-------------[]-------------XX-----------[]------------------------------------------------------[]----[]--------------------[]--------------------------[]--------------------------[]--------------------------[]-----------XXXXX----------[]------------XX------------[]------------XX------------[]----[]-----XXXXXX---------[]-----------XXXXX----------[]-----------XXXXX----------[]-----------XXXXX----------[]-----------XXXXX----------[]-----------XXXXX----------[]-----------XXXXX----------[]------------XXXX----------[]-----------XXXXX----------[]------------XXX-----------[]----[]-----XXXXX----------[]-----------XXXXX----------[]----<>-----XXXXXX---------[]-----------XXXXX----------[]---------
----------EE--E--[]----[]-----------------E--[]--------------------------[]--------------------E-----[]--------------------------[]--------------------------[]--------------------------[]------------------EEE-----[]--------------------------[]--------------------------[]------------------E-E-----[]----[]--------------------[]--------------------E-----[]--------------------------[]--------------------------[]--------------------------[]--------------------------[]--------------------------[]--------------------------[]--------------------------[]------------------E-------[]-----------------------E--[]--------------------------[]------------------E-------[]--------------------E-----[]----------------------E---[]--------------------E-E---[]-----------------------E--E----EE---------------E--E--[]----[]--------------E--E--[]--------------------E--E--[]--------------------E-----[]--------------------E-E---[]--------------------------[]--------------------------[]------------------E-E--E--[]----[]--------------------[]--------------------------[]--------------------------[]--------------------------[]--------------------------[]--------------------------[]-----------------------E--[]--------------------------[]--------------------------[]--------------------------[]----[]--------------------[]--------------------------[]----[]--------------------[]--------------------------[]---------
XXX----XXXXXXXXXXXXXXXXXXXXXXXX------XXXXXXXXXXXXXXXXXXXX---------XXXXXXXXXXXXXXXXXXXX-------XXXXXXXXXXXXXXXXXXX---------XXXXXXXXXXXXXXXXXXX---------XXXXXXXXXXXXXXXXXXXX---------XXXXXXXXXXXXXXXXXXX-----XXXXXXXXXXXXXXXXXXXXXXXX-------XXXXXXXXXXXXXXXXXXXX---------XXXXXXXXXXXXXXXXXXX---------XXXXXXXXXXXXXXXXXXX--------XXXXXXXXXXXXXXXXXXXXX-------XXXXXXXXXXXXXXXXXXX---------XXXXXXXXXXXXXXXXXXX----------XXXXXXXXXXXXXXXXXX----------XXXXXXXXXXXXXXXXXX----------XXXXXXXXXXXXXXXXXX----------XXXXXXXXXXXXXXXXXXX---------XXXXXXXXXXXXXXXXXX----------XXXXXXXXXXXXXXXXXX----------XXXXXXXXXXXXXXXXXX----------XXXXXXXXXXXXXXXXXX----------XXXXXXXXXXXXXXXXXX----------XXXXXXXXXXXXXXXXXXX--------XXXXXXXXXXXXXXXXXXXXX-------XXXXXXXXXXXXXXXXXXXXX-------XXXXXXXXXXXXXXXXXXXXXXXXXXXXXXXXXXXXXXXXXXXXXXXXXXXX--XXXXXXXXXXXXXXXXXXXXXXXX------XXXXXXXXXXXXXXXXXXXXXX-----XXXXXXXXXXXXXXXXXXXXXX-------XXXXXXXXXXXXXXXXXXXXXX------XXXXXXXXXXXXXXXXXXX----------XXXXXXXXXXXXXXXXXX---------XXXXXXXXXXXXXXXXXXXXX------XXXXXXXXXXXXXXXXXXXX----------XXXXXXXXXXXXXXXXXX----------XXXXXXXXXXXXXXXXXX----------XXXXXXXXXXXXXXXXXX----------XXXXXXXXXXXXXXXXXX----------XXXXXXXXXXXXXXXXXX----------XXXXXXXXXXXXXXXXXX----------XXXXXXXXXXXXXXXXXXX---------XXXXXXXXXXXXXXXXXX----------XXXXXXXXXXXXXXXXXX----------XXXXXXXXXXXXXXXXXX----------XXXXXXXXXXXXXXXXXX----------XXXXXXXXXXXXXXXXXX-----------XXXXXXXXXXXXXXXXX-----------XXX-XXXXXXXXXXXXX
