--------------------------------------------------------------------------------------------------------------------------------------------------------------------------------------------------------------------------------------------------------------------------------------------------------------------------------------------------------------------------------------------------------------------------------------------------------------------------------------------------------------------------------------------------------------------------------------------------------------------------------------------------------------------------------------------------------------------------------------------------------------------------------------------------------------------------------------------------------------------------------------------------------------------------------------------------------------------------------------------------------------------------------------------------------------------------------------------------------------------------------------------------------------------------------------------------------------------------------------------------------------------------------------------------------------------------------------------------------------------------------------------------------------------------------------------------------
--------------------------------------------------------------------------------------------------------------------------------------------------------------------------------------------------------------------------------------------------------------------------------------------------------------------------------------------------------------------------------------------------------------------------------------------------------------------------------------------------------------------------------------------------------------------------------------------------------------------------------------------------------------------------------------------------------------------------------------------------------------------------------------------------------------------------------------------------------------------------------------------------------------------------------------------------------------------------------------------------------------------------------------------------------------------------------------------------------------------------------------------------------------------------------------------------------------------------------------------------------------------------------------------------------------------------------------------------------------------------------------------------------------------------------------------------------
--------------------------------ooo-------------------------ooo-------------------------oo--------------------------oo--------------------------ooo-------------------------oooS------------------------ooo-------------------------oo--------------------------oo-S------------------------oo--------------------------oo--------------------------ooo-------------------------oo--------------------------oo--------------------------oo--------------------------oo--------------------------oo--------------------------oo--------------------------oo--------------------------ooo-------------------------ooo-------------------------oooS------------------------oo------------------------------------------------------ooo-------------------------ooo-------------------------oo--------------------------oo--------------------------oo--------------------------oo--------------------------oo--------------------------oo--------------------------oo--------------------------oo--------------------------oo--------------------------oo--------------------------oo--------------------------oo--------------------------oo--------------------------oo--------------------------oo--------------------------oo--------------------------oo--------------------------oo--------------------------oooS------------------------oooS------------------------ooo-------------------------oo--------------------------ooo---------------------
-------------------------------XXXXX-----------------------XXXXX-----------------------XXXXX-----------------------XXXX------------------------XXXXX-----------------------XXXX------------------------XXXXX-----------------------XXXXX-----------------------XXXX------------------------XXXXX-----------------------XXXXX-----------------------XXXXX----------------------XXXXXX-----------------------XXXX------------------------XXXX------------------------XXXXX-----------------------XXXXX-----------------------XXXX------------------------XXXX------------------------XXXXX------------------------XXXX------------------------XXXX-----------------------XXXXX----------------------------------------------------XXXX------------------------XXXX-----------------------XXXX-----------------------XXXXX-----------------------XXXXX-----------------------XXXXX-----------------------XXXXXX----------------------XXXXX------------------------XXXX------------------------XXXXX-----------------------XXXXX-----------------------XXXXX-----------------------XXXX------------------------XXX-------------------------XXXXX-----------------------XXXX------------------------XXXX-----------------------XXXXXX----------------------XXXXXX-----------------------XXXX------------------------XXXXX-----------------------XXXXX-----------------------XXXXX-----------------------XXXXX-----------------------XXXXX--------------------
----------------oo--------------------------------------------------------------------------------------------------------------------------------------------------------------------------------------------------------------------------------------------------------------------------------------------------------------------------------------------------------------------------------------------------------------------------------------------------------------------------------------------------------------------------------------------------------------------------------------------------------------------------------------------------------------------------------------------------------------------------------------------------------------------------------------------------------------------------------------------------------------------------------------------------------------------------------------------------------------------------------------------------------------------------------------------------------------------------------------------------------------------------------------------------------------------------------------------------------------------------------------------------------------------------------------------------------------------------------------------------------------------------------------------------------------------------------------
----------------XXX----SSSSS------------------------SSSS---------------------S--SSS------------oo-----------SSSS------------------------SSSS--------------E---------SSSS--------------E----------SSS------------o-----------SSSS------------o-----------SSSS------S--oooo-------------S-------------o-----------SSSS-----------oo----E------SSSS------------o-----------SSSS---------oooo----E------SSSS---------oooo----E------SSS----------oooo------------SSS-----------oo-----------SSSS------------o-----------SSSS-----------------E------SSSS---------oo-o----E------SSSS--------------E---------SSSS------------------------SSSS------------o--------S--SSSS------------o-----------SSSS-------------------------SSS---------------------SSSSSSS------------------------SSSS---------o--o-----------SSSS---------o--------------SSSS---------oooo----E------SSSS-----------------E------SSSS----------ooo----E------SSSS---------oooo----E------SSSS---------oooo----E------SSSS------------o-----------SSSS------------o-----------SSSS-----------oo-----------SSSS---------oooo----XX-----SSSS---------oo-o-----------SSSS-----------oo-----------SSSS---------oooo----E------SSSS---------oooo----E------SSSS---------oooo----E------SSS?----------ooo----E------SSSS---------oooo----E------SSSS------------o-----------SSSS-----------oo-E----------SSS------------o-----------SSSS------------o-----------SSSS------------------------SSSS
---------------------------------------------------------------------------------------------------------------------------------------------------------<>-----------------------------------------------------------------------------------------------------------------------------------------------------------------------------o-------------------------------------------------------o---------------------------o---------------------------------------------------------------------------------------------------------------o------------------------------------------------<>-------------------------------------------------------------------------------------------------------------------------------------------------------------------------------------------------------------------------------------o---------------------------o---------------------------o-----------------------------------------------------------------------------------o---------------------------------------------------------------------------------------------------------------o---------------------------o-------------------------------------------------------o---------------------------o---------------------------o-------------------------------------------------------o---------------------------------------------------------------------------------------------------------------------------------------------------
--------------------------------------------------------------------------------------------S----------------------E----SS---------------------o--S-SS---[]----------------S--S-SS--------------------------SS--------------------------S----------------------E--S-SSS-------------------------SS------------------------------------------------------S---------------------------S---------------------------S-------------------------S-SSS-----------------------------------------------------SS--------------------------S-------------------------S-SS---------------------o----SS---[]-----------------------------------------------------------------------------SS--------------------------------------------------------------------------------------------------------------SS--------------------------S---------------------------SS----------------------------------------------------------------------------------SSS-------------------------S---------------------------SS--------------------------SS--------------------------S---------------------------S----------------------S--S-SSS-------------------------SS------------------------S-SSS-------------------------S---------------------------S---------------------------S-------------------o-----S-SSS--------------------E----SS---------------------E--S-SSS--S----------------------S----------------------E----SS---------------------o------------------------
--E--o------------E--S------------------------E---------------------------E---------------SoS---------E-----------S---SoS---------E--o------------SoS----[]---E----------oSS--SoS---------E--o--------------S---------E-----------------S---------E-----------o---SoS---------E--o------------SoS---------E-----------------S---------E-----------------S---------E---------------SoS---------E---------------SoS---------E---------------SoS---------E--o--------------S---------E---------------SoS---------E--o------------SoS---------E---------------SoS---------E---------------SoS----<----E--o------------------------E---------------------------E---------------SoS---------E-------------------------------------------------------E---------------------------E---------------SoS---------E---------------S-----------E---------------SoS---------E---------------------------E-----------------S---------E---------------SoS---------E---------------SoS---------E---------------SoS---------E---------------SoS---------E---------------SoS---------E---------------SoS---------E----------oSS--SoS---------E--o------------SoS---------E---------------SoS---------E---------------SoS---------E---------------SoS---------E-----------------S---------E---------------SoS---------E---------------SoS---------E--o------------SoS---------E--o-------------oS---------E--o------------SoS---------E---------------------------E---------
-<>--------------<>-----E--------------------<>------E?S-----------------<>--S-------------SS--------<>------E?SSSS---SSS--------<>------E?S-SS---SSS--------<>------S?SSSSS--SSS--------<>------E?S-----------------<>------E?S-----------------<>------E?S-SS---SSS--------<>------S?S--S---SSS--------<>------E?S-----------------<>------E?S-----------------<>------E?SXXS----SS----XX--<>------E?S-------SS----XX--<>------E----S---SSS--------<>------E?S-----------------<>------E?S-------SS--------<>------E?SXSS---SSS----XX--<>------E?-XXS---SSS----X---<>------E?SSSS----SS--------<>------E?S-----------------<>------E?S-----------------<>------E?S--S---SSS--------<>------E?S---------------------------------------------<>-----E--------------------<>------E?SSSS---SSS--------<>-----E--SXXS----SS--------<>------E?X-------SS----XX--<>------E?S-----------------<>--------------------------<>-X----E?-XXS---SSS--------<>-XX---E?XXXS---SSS-----X--<>------E-X-------SS--------<>------E?S--S---SSS--------<>------E?S--S---SSS--------<>------E?S-------SS----XX--<>------E?-XSS---SSS--------<>------E?S-------SS--------<>------E?SXXS---SSS----XX--<>------E?XXXS---SSS--------<>------E?XXX-----SS----XX--<>-XXX--E?XXX-----------XX--<>-XXX--E?XXXS---SSS----XX--<>-XX---EXXSSS---SSS--------<>------E?S-SS---SSS--------<>------S?S-------SS--------<>------E?S--S----SS--------<>------E?S-----------------<>------E?S
-[]--------------[]----<>--------------------[]--------------------------[]------------o-------------[]--------------------------[]-----E--------------------[]--------------------------[]--------------------------[]------------o-------------[]-----------oo-------------[]------------o-------------[]-----E------o-------------[]------------o-------------[]------------o-------------[]-----------Eo-------------[]------------o-------------[]--------------------------[]------------o-------------[]------------o-------------[]------------o-------------[]--------------------------[]--------------------------[]--------------------------[]------------o-------------[]-------------------------------<>---------------------[]----<>--------XX----------[]------------o-------------[]----<>------o-------------[]-----------Eo-------------[]------------o-------------[]-----E------o-------------[]------------o-------------[]------------o-------------[]--------------------------[]------------o-------------[]--------------------------[]-----------Eo-------------[]------------o-------------[]------------o-------------[]------------o-------------[]------------o-------------[]------------o-------------[]------------o-------------[]------------o-------------[]--------------------------[]--------------------------[]--------------------------[]------------o-------------[]-----E--------------------[]---------
-[]--------------[]----[]--------------------[]--------------------------[]-----------XXXXX----------[]-----------XXXX-----------[]-----------XXXXX----------[]-----------XXXXX----------[]-----------XXXXXX---------[]-----------XXXXX----------[]-----------XXXXX----------[]-----------XXXX-----------[]-----------XXXXX----------[]-----------XXXXX----------[]-----------XXXXXX---------[]-----------XXXXX----------[]-----------XXXXX----------[]-----------XXXX-----------[]-----------XXXXX----------[]-----------XXXXX----------[]-----------XXXXX----------[]-----------XXXXX----------[]--------------------------[]------------XXX-----------[]-----------XXXXX----------[]-------------------------------[]---------------------[]----[]-------X------------[]-----------XXXXX----------[]----[]-----XXXXX----------[]-----------XXXXX----------[]-----------XXXXX----------[]----<>-----XXXXX----------[]-----------XXXXX----------[]-----------XXXXX----------[]-----------XXXX-----------[]-----------XXXXX----------[]-----------XXXX-----------[]----<>-----XXXXX----------[]-----------XXXXX----------[]-----------XXXXX----------[]-----------XXXXX----------[]-----------XXXXX----------[]-----------XXXXXX---------[]-----------XXXXXX---------[]-----------XXXXX----------[]-----------XXXX-----------[]-----------XXXXX----------[]------------XXXX----------[]-----------XXXXX----------[]------------XX------------[]---------
-[]------EEE--E--[]----[]-E------------E--E--[]--------------------E-EE--[]--------------------------[]------------------E-E-----[]--------------------------[]--------------------------[]--------------------------[]--------------------------[]--------------------------[]--------------------------[]--------------------------[]-----------------------E--[]--------------------------[]--------------------------[]--------------------------[]--------------------------[]--------------------------[]------------------E-------[]--------------------------[]--------------------------[]-------------------EE-----[]--------------------E-E---[]--------------------------[]--------------EE-----E-E-EE----[]---------------E--E--[]----[]-----------------E--[]--------------------------[]----[]------------E----E--[]--------------------------[]--------------------------[]----[]--------------------[]--------------------------[]--------------------------[]--------------------------[]--------------------------[]-----------------------E--[]----[]--------------------[]--------------------------[]--------------------------[]--------------------------[]--------------------------[]--------------------------[]--------------------------[]--------------------------[]--------------------------[]--------------------------[]------------------E-E-----[]------------------E-------[]------------------E-E-----[]---------
-XXXX-XXXXXXXXXXXXXXXXXXXXXXXXX-----XXXXXXXXXXXXXXXXXXXXXXX-------XXXXXXXXXXXXXXXXXX----------XXXXXXXXXXXXXXXXXX--------XXXXXXXXXXXXXXXXXXXX----------XXXXXXXXXXXXXXXXXX----------XXXXXXXXXXXXXXXXXX----------XXXXXXXXXXXXXXXXXX----------XXXXXXXXXXXXXXXXXX----------XXXXXXXXXXXXXXXXXX----------XXXXXXXXXXXXXXXXXX----------XXXXXXXXXXXXXXXXXX----------XXXXXXXXXXXXXXXXXX----------XXXXXXXXXXXXXXXXXX----------XXXXXXXXXXXXXXXXXX----------XXXXXXXXXXXXXXXXXX----------XXXXXXXXXXXXXXXXXX----------XXXXXXXXXXXXXXXXXX----------XXXXXXXXXXXXXXXXXX----------XXXXXXXXXXXXXXXXXX---------XXXXXXXXXXXXXXXXXXXXXX-----XXXXXXXXXXXXXXXXXXXXXX-------XXXXXXXXXXXXXXXXXXX----------XXXXXXXXXXXXXXXXXXXXXXXXXXXXXXXXXXXXXXXXXXXXXXXX-------XXXXXXXXXXXXXXXXXXXX---------XXXXXXXXXXXXXXXXXX----------XXXXXXXXXXXXXXXXXX----------XXXXXXXXXXXXXXXXXX----------XXXXXXXXXXXXXXXXXX----------XXXXXXXXXXXXXXXXXX-----------XXXXXXXXXXXXXXXXX-----------XXXXXXXXXXXXXXXXX----------XXXXXXXXXXXXXXXXXX----------XXXXXXXXXXXXXXXXXX----------XXXXXXXXXXXXXXXXXX----------XXXXXXXXXXXXXXXXXX----------XXXXXXXXXXXXXXXXXX----------XXXXXXXXXXXXXXXXXX----------XXXXXXXXXXXXXXXXXX-----------XXXXXXXXXXXXXXXXX----------XXXXXXXXXXXXXXXXXX-----------XXX-XXXXXXXXXXXXX-----------XXXXXXXXXXXXXXXXX-----------XXXXXXXXXXXXXXXXX----------XXXXXXXXXXXXXXXXXX----------XXXXXXXXXXXXXXXXXXX--------XXXXXXXXXXXXXXXXXXX----------XXXXXXXXXXXXXXXXXXXX-------XXXXXXXXXXXXXXXXXXX
