--------------------------------------------------------------------------------------------------------------------------------------------------------------------------------------------------------------------------------------------------------------------------------------------------------------------------------------------------------------------------------------------------------------------------------------------------------------------------------------------------------------------------------------------------------------------------------------------------------------------------------------------------------------------------------------------------------------------------------------------------------------------------------------------------------------------------------------------------------------------------------------------------------------------------------------------------------------------------------------------------------------------------------------------------------------------------------------------------------------------------------------------------------------------------------------------------------------------------------------------------------------------------------------------------------------------------------------------------------------------------------------------------------------------------------------------------------
--------------------------------------------------------------------------------------------------------------------------------------------------------------------------------------------------------------------------------------------------------------------------------------------------------------------------------------------------------------------------------------------------------------------------------------------------------------------------------------------------------------------------------------------------------------------------------------------------------------------------------------------------------------------------------------------------------------------------------------------------------------------------------------------------------------------------------------------------------------------------------------------------------------------------------------------------------------------------------------------------------------------------------------------------------------------------------------------------------------------------------------------------------------------------------------------------------------------------------------------------------------------------------------------------------------------------------------------------------------------------------------------------------------------------------------------------------
----ooo-------------------------ooo-------------------------ooo-------------------------ooo-------------------------oo--------------------------oo--------------------------oo--------------------------oo--------------------------oo--------------------------oSSSSSSSSS--------------SSS-SSSS-SSSSSS-----------------ooo-------------------------oo--------------------------ooSS--S-----------------SSSSSSSSSSSSSS------------------ooo-------------------------ooSSSSSSSSS-----------------oo--------------------------oo--------------------------oo--------------------------oooS--SSSS--------------------------------------------------------------------------ooo-------------------------ooo-------------------------o-o-------------------------oSoS--SSSS------------------ooo-------------------------ooo-------------------------ooo-------------------------ooo-------------------------oo--------------------------oo--------------------------oo--------------------------oo--------------------------oo--------------------------oo--------------------------oo--------------------------oo--------------------------oo--------------------------oo--------------------------oo--------------------------oo--------------------------oo--------------------------oo--------------------------oo--------------------------oo--------------------------oo----------------------SSSSSSSSSSSSSSSS----------------oSoS--SSSS--------------
--XXXXXX------------------------XXXX------------------------XXXX-----------------------XXXXX----------------------XXXXXX-----------------------XXXX------------------------XXXX------------------------XXXX------------------------XXXX------------------------XXXX-------------------------XXXX-----------------------XXXXX-----------------------XXXX-------------------------XXX----------------------------------------------------XXXXX------------------------XXXX-----------------------XXXXX-----------------------XXXX------------------------XXXX------------------------XXXXX---------------------------------------------------XXXXX------------------------XXXX-----------------------XXXXX-----------------------XXXXX-----------------------XXXXX-----------------------XXXXX-----------------------XXXXX-----------------------XXXXX-----------------------XXXXX-----------------------XXXX------------------------XXXX-----------------------XXXXXX----------------------XXXXX------------------------XXXXX-----------------------XXXX------------------------XXXX------------------------XXXX-----------------------XXXXX-----------------------XXXXX------------------------XXXXX-----------------------XXXX------------------------XXXX------------------------XXXX------------------------XXXX-----------------------XXXXXX-----------------------XXXXX-------------------------X---------------------------XXX--------------------
--------------------------------------------------------------------------------------------------------------------------------------------------------------------------------------------------------------------------------------------------------------------------------------------------------------------------------------------------------------------------------------------------------------------------------------------------------------------------------------------------------------------------------------------------------------------------------------------------------------------------------------------------------------------------------------------------------------------------------------------------------------------------------------------------------------------------------------------------------------------------------------------------------------------------------------------------------------------------------------------------------------------------------------------------------------------------------------------------------------------------------------------------------------------------------------------------------------------------------------------------------------------------------------------------------------------------------------------------------------------------------------------------------------------------------------------------------
----------------------SSSSSS-----------------------SSSSS------------------------SSSS-----------oo----------SSSSS-----------------E------SSSS---------oo-------------SSSS------------------------SSSS---------oooo----E------SSSS---------o--------------SSSS-----------ooo-----------SSS--------------E------S---SSS----------oooo----------SSSS------------o----E------SSSS------------o------------SSS-------------------------SSS------------o-----------SSSS-------------------------SSS----------oooo----------SSSS-------------------------SSS------------------------SSSS-------------------------SSS--------QQQQ----------------------------------------SSSS---------------------SSSSSSS------------o-----------SSSS-------------------------SSS------------------------SSSS------------o-----------SSSS-----------ooo----------SSSS------------o-----------SSSS-----------oooo---------SSSS---------oooo----XX-----oS-----------ooo-----E------SSSS------------o----------SSSSS-----------oo----E------SSS----------oooo----E------SSSS---------oooo----E------SSSS---------oooo----E------SSSS---------ooooo---E------SSS----------oooo----E------SSSS---------oooo----E------SSSS---------oooo-----------SSSS---------oooo----E------SSSS---------oooo----E------SSSS---------oooo----E------SSSS---------oo-o----E------SSSS------------------------SSSS------------o-----------SSSS-------------------------SQQ---------------------S----SS
------------------------------------------------------------------------------------------------------------------------------------o---------------------------o---------------------------------------------------------------------------------------------------------------------------------------------------------------------------------------------------o---------------------------------------------------------------------------------------------------------------------------------------------------------------------------------------------------------------------------------------------------------------------------------------------------------------------------------------------------------------------------------------------------------------------------------------------------------------------------------------------------------------------------------------------------o---------------------------o-------------------------------------------------------o-------------------------------------------------------o-----------------------------------------------------------------------------------o---------------------------o-------------------------------------------------------o---------------------------o-------------------------------------------------------------------------------------------------------------------------------------------------------------------------------
-----------------------------------------------------------------------------------------------------------------------------------------------S--S-SS--------------------------S-------------------------S-SSS--------------------S--S-SS---------------------E----SS---------------------o--------------------------------SS--------------------------S----------------------E--S-SS------------------------------------------------------SS------------------------------------------------------SSSS------------------------S---------------------------SS---------------------o------------------------------------------------------------------------------------------------------------------------------------------------------------------------------------------------------------------------------------SS----------------------------------------------------------SS----------------------S-------------------o-------S-----------------------------------------------------------------------------------SS------------------------S-SS------------------o-------SS--------------------------SSS-------------------------S---------------------------S---------------------------SS--------------------------SS------------------------S-SS------------------------S-SSS-----------------------S-SS--------------------------S---------------------------SS---------------------o-----------------------------------------o----------
------------------E---------------------------E---------------------------E---------------------------E---------------------------E----------o-S--SoS---------E--o------------SoS---------E---------------SoS---------E---------------SoS---------E---------------SoS---------E--o------------------------E---------------SoS---------E---------------SoS---------E----------oS---SoS---------E--o------------------------E--o------------SoS---------E---------------------------E--o------------SoS---Q-----E---------------SoS---------E---------------SoS---------E--o------------------------E--o----------------------------------------------------E---------------------------E---------------------------E---------------------------E---------------------------E---------------------------E---------------S-S---------E-----------------S---------E---------------------------E---------------SoS---------E---------------SoS---------E---------------------------E---------------------------E---------------SoS---------E---------------SoS---------E---------------SoS---------E---------------SoS---------E---------------SoS---------E---------------SoS---------E---------------SoS---------E---------------SoS---------E---------------SoS---------E---------------SoS---------E---------------SoS---------E---------------SoS---------E---------------SoS---------E---------------------------E--o------------------------E---------
-----------------<>-----E--S-----------------<>------E?S-----------------<>------E?S-----------------<>------E?S-----------------<>------E?SSSS---SSS--------<>------E?---S----SS--------<>------E?SXXS---SSS----XX--<>------E?SSSS---SSS--------<>------E?S-SS---SSS--------<>------E?S-----------------<>-------?S-------SS--------<>------S?SXXS---SSS--------<>------E-SSSS---SSS--------<>------E?S-----------------<>------E?S------SSS--------<>------E?S-----------------<>------E?S-------SS--------<>------E?S--S----SS--------<>-----E--S-SS----SS--------<>------E?S--S--------------<>------E?So-o----QQQQQ-Q-------------------------------<>-----E--S-----------------<>------E?S-----------------<>------E?S-----------------<>------E?S-----------------<>------E?S-----------------<>------E?S-------SS--------<>------S?S-----------------<>------E?S-----------------<>------E?SXXS---SSS----XX--<>-XX---EXXXXS---SSS----XX--<>------EXX-----------------<>------E?XXX-----------XX--<>-XXX--E--------SSS--------<>------E?SXXS---SSS----XX--<>------E?XXXS---SSS--------<>------E?XX------SS----XX--<>-XXX--E?XXX-----SS----XX--<>------E--XXS----SS----XX--<>-XX---EXX------SSS--------<>------E?SX-S---SSS--------<>------E?SXXS---SSS----XX--<>------E?XXXS---SSS--------<>------E?XXXS---SSS--------<>------E?XXSS----SS--------<>------E?S--S---SSS--------<>------E?S-----------------<>------E?S-----------------<>-------SS
-----------------[]----<>--------------------[]--------------------------[]--------------------------[]--------------------------[]--------------------------[]------------o-------------[]-----E------o-------------[]------------o-------------[]--------------------------[]--------------------------[]------------o-------------[]------------o-------------[]--------------------------[]--------------------------[]--------------------------[]--------------------------[]------------o-------------[]------------o-------------[]----<>--------------------[]--------------------------[]------------------------------------------------------[]----<>--------------------[]--------------------------[]--------------------------[]--------------------------[]--------------------------[]--------------------------[]------------o-------------[]------------o-------------[]-----------Eo-------------[]------------o-------------[]------------o-------------[]------------o-------------[]------------o-------------[]------------o-------------[]------------o-------------[]-----------oo-------------[]------------o-------------[]------------o-------------[]------------o-------------[]------------o-------------[]------------o-------------[]------------o-------------[]------------o-------------[]------------o-------------[]-----XX-----o-------------[]--------------------------[]--------------------------[]---------
-----------------[]----[]--------------------[]--------------------------[]-----------XXXXX----------[]-----------XXXXXX---------[]-----------XXXX-----------[]-----------XXXXX----------[]-----------XXXXX----------[]-----------XXXXX----------[]-----------XXXX-----------[]--------------------------[]-----------XXXXXX---------[]-----------XXXXX----------[]----<>-----XXXX-----------[]--------------------------[]-----------XXXXX----------[]------------X-------------[]-----------XXXXX----------[]-----------XXXX-----------[]----[]------XXX-----------[]--------------------------[]------------------------------------------------------[]----[]-------XX-----------[]------------XXXX----------[]--------------------------[]--------------------------[]-------------X------------[]-----------XXXX-----------[]-----------XXXXX----------[]-----------XXXXX----------[]-----------XXXXX----------[]-----------XXXXX----------[]-----------XXXXX----------[]-----------XXXXX----------[]-----------XXXXX----------[]-----------XXXXX----------[]-----------XXXXX----------[]-----------XXXXX----------[]-----------XXXXX----------[]-----------XXXXX----------[]-----------XXXXX----------[]-----------XXXXX----------[]-----------XXXXX----------[]-----------XXXXX----------[]-----------XXXXX----------[]-----------XXXXX----------[]----<>-----XXXXX----------[]--------------------------[]--------------------------[]---------
---------E-E--E--[]----[]-----------------E--[]---E----------------E-----[]--------------------------[]------------------E-------[]------------------E-------[]------------------E----E--[]--------------------------[]--------------------------[]--------------------------[]-------------------EE-E---[]--------------------------[]--------------------------[]----[]------------E-------[]--------------------------[]--------------------------[]--------------------E-----[]--------------------------[]------------------E-------[]----[]--------------------[]--------------------------[]-----------------------E--E-----E--E-------------E-E--[]----[]--------------E--E--[]-----------------------E--[]--------------------E-----[]--------------------E-----[]--------------------------[]--------------------------[]------------------E-------[]--------------------E-----[]--------------------------[]--------------------------[]-----------------------E--[]--------------------------[]--------------------------[]--------------------------[]--------------------------[]--------------------------[]--------------------------[]--------------------------[]--------------------------[]--------------------------[]--------------------------[]--------------------------[]--------------------------[]------------------E----E--[]----[]--------------------[]--------------------E-----[]--------------------E-E---[]---------
XXX----XXXXXXXXXXXXXXXXXXXXXXXX------XXXXXXXXXXXXXXXXXXXXXX------XXXXXXXXXXXXXXXXXXX----------XXXXXXXXXXXXXXXXXX----------XXXXXXXXXXXXXXXXXX---------XXXXXXXXXXXXXXXXXXX----------XXXXXXXXXXXXXXXXXX-----------XXXXXXXXXXXXXXXXX----------XXXXXXXXXXXXXXXXXX----------XXXXXXXXXXXXXXXXXXXXX----XXXXXXXXXXXXXXXXXXXXX----------XXXXXXXXXXXXXXXXXX----------XXXXXXXXXXXXXXXXXX----------XXXXXXXXXXXXXXXXXXXX-------XXXXXXXXXXXXXXXXXXX----------XXXXXXXXXXXXXXXXXXXX-------XXXXXXXXXXXXXXXXXXX----------XXXXXXXXXXXXXXXXXX---------XXXXXXXXXXXXXXXXXXX---------XXXXXXXXXXXXXXXXXXX---------XXXXXXXXXXXXXXXXXXXXXXXXXXXXXXXXXXXXXXXXXXXXXXXXXXXX---XXXXXXXXXXXXXXXXXXXXXX-------XXXXXXXXXXXXXXXXXXX----------XXXXXXXXXXXXXXXXXXXXX------XXXXXXXXXXXXXXXXXXXXXX-----XXXXXXXXXXXXXXXXXXXXX--------XXXXXXXXXXXXXXXXXXX----------XXXXXXXXXXXXXXXXXX----------XXXXXXXXXXXXXXXXXX----------XXXXXXXXXXXXXXXXXX-----------XX--XXXXXXXXXXXXX----------XXXXXXXXXXXXXXXXXX----------XXXXXXXXXXXXXXXXXX-----------XXX-XXXXXXXXXXXXX----------XXXXXXXXXXXXXXXXXX----------XXXXXXXXXXXXXXXXXX----------XXXXXXXXXXXXXXXXXX-----------XXX-XXXXXXXXXXXXX----------XXXXXXXXXXXXXXXXXX-----------XXXXXXXXXXXXXXXXX----------XXXXXXXXXXXXXXXXXX----------XXXXXXXXXXXXXXXXXX----------XXXXXXXXXXXXXXXXXX----------XXXXXXXXXXXXXXXXXX----------XXXXXXXXXXXXXXXXXX----------XXXXXXXXXXXXXXXXXX----------XXXXXXXXXXXXXXXXXXXX-------XXXXXXXXXXXXXXXXXXXXXXX----XXXXXXXXXXXXXXXXXXXX
