--------------------------------------------------------------------------------------------------------------------------------------------------------------------------------------------------------------------------------------------------------------------------------------------------------------------------------------------------------------------------------------------------------------------------------------------------------------------------------------------------------------------------------------------------------------------------------------------------------------------------------------------------------------------------------------------------------------------------------------------------------------------------------------------------------------------------------------------------------------------------------------------------------------------------------------------------------------------------------------------------------------------------------------------------------------------------------------------------------------------------------------------------------------------------------------------------------------------------------------------------------------------------------------------------------------------------------------------------------------------------------------------------------------------------------------------------------
--------------------------------------------------------------------------------------------------------------------------------------------------------------------------------------------------------------------------------------------------------------------------------------------------------------------------------------------------------------------------------------------------------------------------------------------------------------------------------------------------------------------------------------------------------------------------------------------------------------------------------------------------------------------------------------------------------------------------------------------------------------------------------------------------------------------------------------------------------------------------------------------------------------------------------------------------------------------------------------------------------------------------------------------------------------------------------------------------------------------------------------------------------------------------------------------------------------------------------------------------------------------------------------------------------------------------------------------------------------------------------------------------------------------------------------------------------
------------------------------------------------------------ooo-------------------------ooo-------------------------ooo-------------------------ooo-------------------------ooo-------------------------oo--------------------------ooo---------------------SSS-ooSSSSSSSSSS----------------oooS------------------------ooo-------------------------oo--------------------------ooo-------------------------oo--------------------------oo--------------------------ooo-------------------------oo--------------------------ooo-------------------------ooo-------------------------oo--------------------------oo--------------------------oooS------------------------ooo-------------------------------------------------------------------------------------------------------------ooo-------------------------ooo-------------------------oo--------------------------oo--------------------------oo--------------------------oo--------------------------oo--------------------------oo--------------------------oo--------------------------oo--------------------------ooSS------------------------ooo-------------------------oo------------------------------------------------------ooo-------------------------oo--------------------------oo--------------------------oo--------------------------oo--------------------------oo--------------------------oo--------------------------ooo-------------------------oo----------------------
---------------------------------XX------------------------XXXXX-----------------------XXXXX-----------------------XXXXX-----------------------XXXXX-----------------------XXXXX-----------------------XXXX-------------------------XXXX------------------------XXXX-----------------------XXXXX-----------------------XXXXX-----------------------XXXX------------------------XXXXX-----------------------XXXX-----------------------XXXXXX-----------------------XXXXX-----------------------XXXXX------------------------XXXX----------------------XXXXXX-----------------------XXXX------------------------XXXX------------------------XXXXX-----------------------XXXXX------------------------------------------------------------------------------------------------------------XXXX----------------------XXXXXX-----------------------XXXX------------------------XXXX------------------------XXXXX-----------------------XXXX-----------------------XXXXX------------------------XXXX------------------------XXXX------------------------XXXX------------------------XXXX------------------------XXXXX----------------------XXXXXX---------------------------------------------------XXXXX----------------------XXXXXX-----------------------XXXX-----------------------XXXXXX----------------------XXXXX-----------------------XXXXX------------------------XXXX------------------------XXXXX-----------------------XXXXX--------------------
--------------------------------------------------------------------------------------------------------------------------------------------------------------------------------------------------------------------------------------------------------------------------------------------------------------------------------------------------------------------------------------------------------------------------------------------------------------------------------------------------------------------------------------------------------------------------------------------------------------------------------------------------------------------------------------------------------------------------------------------------------------------------------------------------------------------------------------------------------------------------------------------------------------------------------------------------------------------------------------------------------------------------------------------------------------------------------------------------------------------------------------------------------------------------------------------------------------------------------------------------------------------------------------------------------------------------------------------------------------------------------------------------------------------------------------------------------
-------------------------SSS-----------------------SSSSS---------------------SSSSSSS------------o-----------SSSS------------o-----------SSSS------------------------SSSS----------oooo----------SSS-------------------------SSSS--------------E---------SSSS------------o------------SSS------------o-----------SSSQ------------o-----------SSSS------------------------SSSS--------------E---------SSSS---------o--o----E------SSSS------------o-----------SSSS------------o-----------SSSS------------o-----------SSSS------------------------SSSS---------------------SSSSSSS------------o-----------SSSS------------------------SSSS------------o-----------SSSS-----------ooo----------SSSS---------QQQ------------------------QQQQ---------------------------Q-------------SSS---------------------S-SSSSS----------------XX-----SSSSS---------oo------E------SSSS---------oo-o-----------SSSS-----------ooo----------SSS----------oooo----E------SSS----------oooo----E------SSSS---------oooo----E------SSS----------oo------E------SSSS------S--oooo-----------SSSS------------o------------SSS-----------ooo----------SSS-----------ooo----E------SSSS---------oooo----E------SSSS------------o-----------SSSS------------o-----------SSSS---------oooo----E------SSSS-----------------E-----SSSSS-----------------------SSSSS---------oooo----XX-----SSS----------oooo----E------SSSS----------------------SSSSSS-----------oo-----------SSSS
----------------------------------------------------------------------------------------------------------------------------------------------------------------------------------------------------------------------------------------------------------------------------------------------------------------------------------------------------------------------------------------------------------------------------------------------------------------------------------------------------------------------------------------------------------------------------------------------------------------------------------------------------------------------------------------------------------------------------------------------------------------------------------------------------------------------------------------------------------------o---------------------------------------------------------------------------------------------------------------o---------------------------o---------------------------o------------------------------------------------------------------------------------------------------------------------------------------ooo----------------------------------------------------------------------------------o---------------------------o---------------------------o---------------------------o---------------------------o---------------------------------------------------------------
--------------------------------------------------------------------------------------------------------------------------------------------------------------------------------SSS-------------------------S----------------------o---------------------------o----SS--------------------------SS------------------------------------------------------S----------------------E----SS--------------------------SS------------------------------------------------------SS--------------------------SS----------------------------------------------------------------------------------SS--------------------------S---------------------------SS------------------------------------------------------------------------------------------------------------------------------------------------------------------------------------------------S-S-------------------------S-SSS---------------------------------------------------S-SSS-------------------------SS--------------------------SS--------------------------S-------------------------S-SSS--------------------S--S-SS----------------------------------------------------------------------------------S---------------------------S---------------------------S---------------------------S---------------------------------------------------------------------------o-------S-------------------o-----S-S-------------------------------------------------------SS------------------
------------------E--S--------E---------------E---------------------------E---------------------------E--o--------------S---------E---------------------------E---------------SoS---------E---------------SoS---------E-----------------S---------E-----------------S---------E--o--------------S---------E---------------------------E---------------SoS---------E---------------SoS---------E--o------------SoS---------E---------------------------E---------------SoS---------E---------------SoS---------E---------------------------E---------------------------E---------------SoS---------E-----------------S---------E-----------------S---------E---------------------------E------------------------------------------------------------------------------------------X--------------------E---------------------------E---------------SoS---------E---------------SoS---------E---------------------------E---------------SoS---------E---------------SoS---------E---------------SoS---------E---------------SoS---------E---------------SoS---------E-----------SS--SoS---------E--o------------------------E-----------------S---------E---------------SoS---------E-----------------S---------E-----------------S---------E---------------SoS---------E---------------------------E---------------------------E---------------SoS-------------------------SoS---------E---------------------------E----------------oS---------E---------
-----------------<>-----E----<>--------------<>-----E--S-----------------<>-----E??S-----------------<>------E?S-----------------<>------E?S-----------------<>------E?S------SSS--------<>------S?S-SS----SS--------<>------E?S-----------------<>------E?S-------SS--------<>------E?S-----------------<>------E?S-----------------<>------E?S--S---SSS--------<>------E?S-SS----SS--------<>------E?SXSS---SSS--------<>------E?S-----------------<>------E?S-------SS--------<>------E?S-------SS--------<>------E?S-----------------<>------S?S-----------------<>------S?SXSS---SSS--------<>------E?S--S----S---------<>------E?S-------SS--------<>------E?S-----------------<>------E?S--o-----QQQQ------------------o----QQQQ--QQ--<>---------o---------QQQQ----------XXX------------------<>-XXX--E?------------------<>-----E---XXS---SSS----XX--<>------E?XXXS---SSS--------<>------E?S-----------------<>--XX--S?SXXS---SSS----XX--<>------XXX--S---SSS--------<>------E?XXXS---SSS----XX--<>------EXXXXS---SSS--------<>------E--SSS---SSS--------<>------E?S-SS---SSS--------<>------E?S-----------------<>--SX--E?SX----------------<>-XXX--E?-XXS---SSS--------<>----------------SS--------<>------E?S-------SS--------<>------E?S--S---SSS----XX--<>------E-------------------<>-----E--------------------<>---------XXX---SSS----XX--<>-XXX--XXXXXS---SSS----XX--<>------EXX-----------------<>-----E??S-------SS--------<>------E?S
-----------------[]----<>----[]--------------[]--------------------------[]----<>--------------------[]--------------------------[]--------------------------[]--------------------------[]--------------------------[]--------------------------[]--------------------------[]------------o-------------[]--------------------------[]------------o-------------[]-----E--------------------[]------------o-------------[]--------------------------[]--------------------------[]------------o-------------[]--------------------------[]--------------------------[]------------o-------------[]--------------------------[]-----E--------------------[]--------------------------[]------------------------------------------------------[]-----E--------------------------XXXX------XX----------[]--------------------------[]----<>------o-------------[]------------o-------------[]--------------------------[]------------o-------------[]------------o-------------[]------------o-------------[]------------o-------------[]------------o-------------[]--------------------------[]------------o-------------[]------------o-------------[]--------------------------[]-----E------o-------------[]------------o-------------[]------------o-------------[]--------------------------[]----<>------o-------------[]----<>-----Eo-------------[]------------o-------------[]--------------------------[]----<>--------------------[]---------
-----------------[]----[]----[]--------------[]---<>---------------------[]----[]--------------------[]-----------XXXX-----------[]--------------------------[]-----------XXXXX----------[]-----------XXXXX----------[]-------------XX-----------[]-----------XXXXX----------[]-----------XXXXX----------[]-----------XXXXX----------[]-----------XXXXX----------[]------------XXXX----------[]-----------XXXXX----------[]-----------XXXXX----------[]-----------XXXXX----------[]-----------XXXXX----------[]--------------------------[]-------------XXX----------[]-----------XXXXX----------[]-----------XXXX-----------[]------------XX------------[]-----------XXXX-----------[]------------------------------------------------------[]----<>------<>-----------------XXXXX-----XXX----------[]------------XXXX----------[]----[]-----XXXXX----------[]-----------XXXXX----------[]-----------XXXXX----------[]-----------XXXXX----------[]-----------XXXXX----------[]-----------XXXXX----------[]-----------XXXXX----------[]----<>-----XXXXX----------[]-----------XXXX-----------[]-----------XXXXXX---------[]-----------XXXXXX---------[]------------XXX-----------[]-----------XXXXX----------[]-----------XXXXX----------[]-----------XXXXX----------[]-----------XXXXX----------[]----[]-----XXXXX----------[]----[]-----XXXXX----------[]-----------XXXXX----------[]--------------------------[]----[]-----XXXXX----------[]---------
----------EE-----[]----[]----[]---------E-E--[]---[]---------------E--E--[]----[]--------------------[]--------------------------[]--------------------E-----[]--------------------------[]-----------------------E--[]--------------------E-----[]--------------------E-----[]------------------E-E-----[]------------------E-E-----[]------------------E-------[]--------------------E-----[]--------------------------[]--------------------------[]--------------------------[]--------------------------[]--------------------E-----[]--------------------E--E--[]--------------------------[]------------------E-------[]--------------------------[]--------------------------[]-----------------------E--E-----E-----------------EE--[]----[]------[]---------E-E----XXXXXX------------------[]-----------------------E--[]----[]--------------------[]--------------------------[]--------------------------[]--------------------------[]--------------------------[]--------------------------[]--------------------------[]----[]--------------------[]------------------E-------[]--------------------------[]--------------------------[]--------------------------[]--------------------------[]--------------------------[]--------------------------[]-----------------------E--[]----[]-----------------E--[]----[]--------------------[]--------------------------[]--------------------E--E--[]----[]--------------------[]---------
XXX--XXXXXXXXXXXXXXXXXXXXXXX-XXXXXXXXXXXXXXXXXXXXXXXXXXXXXX-----XXXXXXXXXXXXXXXXXXXXXX-------XXXXXXXXXXXXXXXXXXX----------XXXXXXXXXXXXXXXXXXXX------XXXXXXXXXXXXXXXXXXXX----------XXXXXXXXXXXXXXXXXX----------XXXXXXXXXXXXXXXXXXX--------XXXXXXXXXXXXXXXXXXXX--------XXXXXXXXXXXXXXXXXXX----------XXXXXXXXXXXXXXXXXXX--------XXXXXXXXXXXXXXXXXXX----------XXXXXXXXXXXXXXXXXXX--------XXXXXXXXXXXXXXXXXXX----------XXXXXXXXXXXXXXXXXX----------XXXXXXXXXXXXXXXXXX----------XXXXXXXXXXXXXXXXXX----------XXXXXXXXXXXXXXXXXXXX-------XXXXXXXXXXXXXXXXXXXXXX-------XXXXXXXXXXXXXXXXXX----------XXXXXXXXXXXXXXXXXX---------XXXXXXXXXXXXXXXXXXX---------XXXXXXXXXXXXXXXXXXX----------XXXXXXXXXXXXXXXXXXXXXXXXXXXXXXXXXXXXXXXXXXXXXXXXXXXXXXXXXXXXXXXXXXXXXXXXXXXXXXXXXXXXXXXXXXXXXXXXXXXX--X----------XXXXXXXXXXXXXXXXX---------XXXXXXXXXXXXXXXXXXX----------XXXXXXXXXXXXXXXXXX----------XXXXXXXXXXXXXXXXXX----------XXXXXXXXXXXXXXXXXX-----------XXX-XXXXXXXXXXXXX----------XXXXXXXXXXXXXXXXXX-----------XXXXXXXXXXXXXXXXX----------XXXXXXXXXXXXXXXXXX----------XXXXXXXXXXXXXXXXXX---------XXXXXXXXXXXXXXXXXXXX---------XXXXXXXXXXXXXXXXXX-----------XXXXXXXXXXXXXXXXX----------XXXXXXXXXXXXXXXXXX----------XXXXXXXXXXXXXXXXXX----------XXXXXXXXXXXXXXXXXX----------XXXXXXXXXXXXXXXXXX----------XXXXXXXXXXXXXXXXXX----------XXXXXXXXXXXXXXXXXX------------X--XXXXXXXXXXXXX----------XXXXXXXXXXXXXXXXXXXXX-----XXXXXXXXXXXXXXXXXXXX----------XXXXXXXXXXXXXXXXXX
