--------------------------------------------------------------------------------------------------------------------------------------------------------------------------------------------------------------------------------------------------------------------------------------------------------------------------------------------------------------------------------------------------------------------------------------------------------------------------------------------------------------------------------------------------------------------------------------------------------------------------------------------------------------------------------------------------------------------------------------------------------------------------------------------------------------------------------------------------------------------------------------------------------------------------------------------------------------------------------------------------------------------------------------------------------------------------------------------------------------------------------------------------------------------------------------------------------------------------------------------------------------------------------------------------------------------------------------------------------------------------------------------------------------------------------------------------------
--------------------------------------------------------------------------------------------------------------------------------------------------------------------------------------------------------------------------------------------------------------------------------------------------------------------------------------------------------------------------------------------------------------------------------------------------------------------------------------------------------------------------------------------------------------------------------------------------------------------------------------------------------------------------------------------------------------------------------------------------------------------------------------------------------------------------------------------------------------------------------------------------------------------------------------------------------------------------------------------------------------------------------------------------------------------------------------------------------------------------------------------------------------------------------------------------------------------------------------------------------------------------------------------------------------------------------------------------------------------------------------------------------------------------------------------------------
---------------------------------------------------------------------------------------E--X----------------------------------------------------------------------------------------------------------------------------------------------------------SSSSSSS---------------------------------------------------------------------------------------X----------------------------------------------------------------------------------------------------------------------------------------------X--------------------------------------------------------------------------------------------------------------------------------------------------------------------------------------------------------------------------------------------------------X--X---------------------------------------------------------------------------------------------------------------X-----------------------------------------------------------------------------------------------------------------------------------------------------------------------------------------------------------------------------------------------------------------------------------------------------------------------------------------------X-------------------------------------------------------------------------------------------------------------------------------------------------------------------------------------------------------------------------
X-------------------------------------------------------------------------------------------------------------o----------------------------------------------------------X--------------------------------------------------------------------------------------------------o--------------------------------------------------------------------X-------------------------------------------------------------------------------------------------------------------------------------------X------------------------------------------o----------------------------------------------------------------------------------------------------------------------------------------------------------------------------------------------------------------XX---Q---------o-------------------------------------------------------------------------Q--------oo-------------------------------------------------------------------------------------------------------------------------------------------------------------------------------------------------------------------------------o---------------------------o------------------------------------------------------oo---------------------------------------------------------------------------------------------------------------------------------------------------------------------------------------------------o-------------------------------------------------------------------
----------oo----------o----------------------------------------------------------------------ooo-XX-----------X-------------------------------------------------------------------o---------------------------------------------------------------------------------------o------------------------------------------------X---------------------XX--S------------------------------------------------------------o------------------------------------oo--oo------------------------------------oo-------------------------------oo-----------------------------------------------------------------------------------------------------------XX-----------------------------------------------------------------oo----------------oE-----------------------oo---o------------------o---oo------------------------------------------------------E---------------------------oo--ooooooo------------------------------------------------------------------------------oo--oo-----------------oo--oo----------------------ooo--o---------------------------------------------ooo---o---oooooo------------o-----o---oo--oo-----------------------------------------------------------------------------------------------------oo--ooo--------------------------------------------------------------------------------------------------------------------------------------o---oo--oo--------------------------------------------------------------------
----------------------XXX---Q-----------------QQQ-----------------------------XXX---XX-----------------------oo----SSS-SSS-----------------------------------------------------oo-------------XXXX---------------------Q-------Q-------------SSSS-------------------------------------o----------------------------------QQ---------------------------------------------oo--------------------------------------------------------------------------------------------SSS-------------------------------------------ooo----------------------------------------------------------------------------------------------------------------------------SSS----E------------------------------------------------------XXXX-------------XXXX-----------XX-oo--------------------------ooo------------------------------QQSSS-S-----SSSS--SSSSS------------o------------------------------------------XXoo---------------------------------SSSS--------------------------------------------------------------------------o------------------------XXoo------Q--------------QQQ------X---------------------------X---------------------XXoo----QQXX-------------XXo---------------------------------SQQS---------QSQQ----------------------------------XXoo---XX--------------------XXX-----------------------------------------------------------------------------------SS-X---------------------XXoo--QQQQQ--------------------------------------------------
---X---------------o--------------------------------------o---o---o--------o---------------------SS--XXX--------------------------------------------------E--------------XXX------------------------------------------------------------------------------------------X----o---E-----XXX---------------------------------------------X----------------o---X--------E------------------------------------------o------------o------XX-XX---------------------------------------------------------------o-------XX----XXXX--XX---E-----o------------------------------------------------------------------------o-------------------------------------------------------o---oE--X---Eo---o------XX-XXX-----------------------------------------XXX---------------------------E------X-------------------------------------------------------------------X--------E--o---XX------------------XX------------------o----------------------------------------------------------------E--E---XX-------------------E-----XXX-------------------E------XX---------------------------------------------------------------------S-----X--------------------------------------E---oE--X--------E--o----------------------------------------------------X-----------------E---o---------------------------------------------------------------------------------------------------------------S-S---E----------------------------------------------------------------
XXXXXXXXXXXX-XXXX-XXX-----o------------------------------XXX-XXX-XXX------XXX---------------XXXXXXo------------------------------------------------------<>-----------XX-------------------------------------------------------------------------------------XXXXXXX----XXXXXXXXXXXX--o-------------------------------------------EXXXS--------------XXX--X----XX-XXX-X---------------------------------XXXXXXXXXXXXXXXXXXXXXXXX--o---------------------------------------------------------------X--XXX-------XX------------XXX--o-XXX-------X---o----------------------------------------------------------XXX-XXX--o------------------------------------X---------XXX-XXX-Xo---XXXXXXXXXXX-o--XX--XXX-----------------------------------------------------XXX---X-XXXX-XXX-X-------------------------------o----------------------------------XXX----XXXXXXXXXXXX--oo-----XXXXXXXXX-----------------------oXX----------------------------------------------XXXXXXXXX-XXXXXXXXXXXXX-oo--------------XXXXXXXXXX--o----------X---X-XXXXXXXX---o--------------------------------------------------------------XXXXXXXXXX------------------------------------------XXX-XXX--o-------XXXXXX--o----------------------------------XXXXXXX-XXXX--XX-----------XXXXXXX-XXX------------------------------------------------------------------------------------------------------XXXXXXXXXX---XXX---------------------------------------------------------------
-------------------------XXX--------------------------------------------------------------------------XXX---XXXX-----------------------------------------[]-----------XX---------XXX---------------------------------------------------------------------E---------------------------XX--------------------------------------------XXX-----------------------------------XXX----------------------------------------------------------XXXXXXXX--------XX----XXXX-----------------------------------------------------XXX----------XX-------------XXX-X-----------------------------------------------SSS---------------------------------------------------XX--------------------------------------------XXX----------------------------------------XXX--------------------------XXX---------XXX--------------XX--------------------------E--------------------------XXX-------------------------XXX---------------------------------------XX--------------------------------------------------------------------XXX-------------------------XXX-----------------------------------XXXXX-----------------------------------------XXX-------------------------------------------------------------------------------------------------------------XX-------------------------------------------------------------------------------------------------------E----------------------------------XXX-----------------X--------------------------------------
-----------------------------Q--------X--S-o-----------------------------------XXXX---XXXX------------------------------------------------------------ESS[]----------XXX---------------------------------------------QQQ---------------------?SSSSSS-ESSSSSS-------------------------------QQQ-------------------------ES-S-------XXXX-----------------------EEE----------------------XX-----X-------------------------------E-------------------------------------E--Q--------X-X-X----------------------E-----------------E------------------------XX----------------------QQQ----o------------------------------------------------QQ---QQQ--------XXXXXXXX------------------------------------------------------------------------XXX---X--X--------X---------------------------------------------------------QQQ---------------------<>-----E---E-EE------------------------------------------------------------------------XX-SSSS----XX------------Q-Q-------------------------------XX------------------------------------------------------QQS-----X-------QS-------XXXX-----------------XXXX--XXXXX------------------------XX--SQS------------XX--SXX------------E------------------QQQ---------Q--SS--------------XX----------------------XX----------------------------------------------------E---------------------------X---Q-----S--------<>----------XXXX------------------------EQQQQ---------X-X---------------------------------XX---
------------------------------------XXX------------------X----------------XXXXXXX--------------------------------------------------------------------<>--[]--------EXXXX----------------------------------------------------------------------oSSSSS<>SSSSSS---------XXXX?-------------------------------------------------------XXXXX----------XXXX-----XXXXXXXX------------------------------------------------XXXXXX--XXXXXXX---------------------------------------------------XX-----------------XXXXXX------------XXXXXXXX--------------------XXX--S---------------------------------------EE-------------------------------------------------XXXXXXXXX-------XX-X--XXXXXXXXX---XXXX------------------------------------------------XX--X-------------------XXX-----------------------------------------------------------------E--[]-XXXXXXXXXXXXXX----XXXXX----------------X------------------------------------------------------XXX--X---------------------XXX------XXXXXX-------------XXXX-----XXXXX---------------XX--------------------------XXX--SS---------------------------------------------------------------------------------XXXX----------XXXXXXXXXXXXXXXXX------------------------------------E-------------XXXX---XXX------------XX----------------------------------------------<>---------------------------X------------------[]----------------------------------------------------XXX--------------------XXXX--------XXX---
XXX---XXXXX------------------------XXXX--------------------------------------------------------------------------------------------------------------[]--[]--------XXXXX-----XX----------------------<>-------------------<>-----------------?SSSS-S[]SSSSSS----XXXXX-----------------------------E-----------------------------XXXXXX------------------------------------------------------------------------XXXXX----------------------------------------------------------------XXX--------------------------------------------------------------XXX-----------------------------------E-----XXX------------------------------------------------XXXXXXXXXX-----------------------------------XXXXX-------------------XXX--------------XXX----o----------------------------------------------------------------------------------------[]----------------------------------------------------------------------------------------------XXXX--X------------------XXXXX----------------------------------------------------XXXXX-------------------------XXXX--S-----------------X-----------------------------XXXXXX-------------------------E---XXXXX----------XXXX------------------------------------------------------------------------------------XX----------XXXX-----X--------------------------[]-----------------------E---XX-----------------[]---------------XX-----------------------------------XXX-------------------------------XXXXX--
-------------------------XXX-E-----XXXX-------------EE-------------------------------------------------------XXX-------------------X-----------------[]--[]-------XXXXXX-----------------------------[]-------------EE----[]-----------------o-S-ooS[]SSSSSS----------------------------------------E-----------EE--------E-EE-XXXXXXX------EE---------------------------E-X-------------------------------------------------------------------------------------------------------XX----E--------------------------oooo--------------------------oo-XX---EE-----------------------------------XXXX-------------------------------------------E---XXXXXXXXXXX---------------------------------------------------------------------------XXXX---XXX------------------------------oooo-----------------------------------------------------[]----------------------------E-------------------------XXX-------------------------E---------XXXXXX--X---------E-----------------------------------------------------------------------------------Xoo--------XXXXX------------E-------------------------------------------------------XXX---------------XXXX------------------------------------EEE-------------------------X---------------------------o-------------------------------------------------E-XX[]---------------------------XX------------E-E--[]----------------------------------XXX------------E--XXXX-----EE----------------------XXXXX---
--------------------------XXXXXXXXXXXX-------XXXXXXXXXXXX-------XXXX------------------------------------------XXXXXXXX-XXX--XXXXXXXX-X-XXXXXXXXXXXXX-XXXXXXXXXXXXXXXXXX------------------------------XXXXXXX----XXXXXXXXXXXXXXXXXXXXXXXX--X-XXXXXXXXXXXXXXXXX------------------------XXXXXXXXXXXXXXXXXXX--XXXXXXXXXX-XXXXXXXXXXXXXXXXXXXXXXXXXXXX----XXXXXX-----------X-XXXX----XX---XX---X---------XXXXXX-----------------------------------------------------X-XXXXXXXXXXXXX-----X-XX-S?XX-----XXXXXX-------------XXXX-------------------------XXXXXXXXXXXXXXXXXX---X------XXXXXXXXXXXXXXXXXXXX-X----XXXXXX---------X-------XX-----XXXXXXXXXXXXXXXXXXXXXXXXXXXXXXX------------------------XXX---------------------------------XXXXQXXXXXX-------------------------------------XXXX--------------------------XXXXXXXXXXXXXXXXXX-XXXXXXXXXXX-------------------------XXX----------------------------XX-------XXX------XXXXXXXXXXXXXXXXXXXXXXX--X-XXXXXXXXXXX--------------------------------XXX------------------XXX-------------------------XXXXXXXXXXXXXXX------XXXXXXXXXX-------------------------------------------------------X-XXXXX--XXXXXXXXXXX-------------------------------XXXXXXXXXXXXXXXXXXXXX---XXXXXXX--X------------------------XXXXXX-------------------------XXXXXXX---XXXXXXQ-XXXXXXXXXXXXXXXXXX-----XX---XXXXXXXXXXXXXXXXXXXXXXXXXXXXXXXXXX-XXXX--------------------------XXXXXXXXXXXXXXXXXXXXX-XXXXXXXXXXXXXXXX---------XXXXXXX----
