--------------------------------------------------------------------------------------------------------------------------------------------------------------------------------------------------------------------------------------------------------------------------------------------------------------------------------------------------------------------------------------------------------------------------------------------------------------------------------------------------------------------------------------------------------------------------------------------------------------------------------------------------------------------------------------------------------------------------------------------------------------------------------------------------------------------------------------------------------------------------------------------------------------------------------------------------------------------------------------------------------------------------------------------------------------------------------------------------------------------------------------------------------------------------------------------------------------------------------------------------------------------------------------------------------------------------------------------------------------------------------------------------------------------------------------------------------
---------------------------------------------------------------------------------------------------------------------------------------------------------------------------------------------------------------------------------------------------------------------------------------------------------------------------------------------------------------------------------------------------------------------------------------------------------------------------------------------------------------------------------------------------------------------------------------------------------------------------------------Q----------------------------------------------------------------------------------------------------------------------------------------------------------------------------------------------------------------------------------------------------------------------------------------------------------------------------------------------------------------------------------------------------------------------------------------------------------------------------------------------------------------------------------------------------------------------------------------------------------------------------------------------------------------------------------------------------------------------------------------------------------------------------------------------------------------
---------------------------------------------------------------------------------------------------------------------oo--------------------------------------------------------------------------------------------------------------------------------------------------------------------------------------------------------------------------------------------------------------------------------------oo-------------------------------------------------------X------------------------------------------------------------------------------------------------------------------------------------------oo-------------------------------------------------------------------------------------------------------------------------------------------------------------------------------------------------------------------------------------------------------------------------------------------------------------------------------------------------------------------------------------------------------X-----------------------------------------------------------------------------------------------------------------------------------------------------------------------------------------------------------------------------------------------------------------------------------------------------------------------------------------------------------------------------------------------------------------------------
------------------------------------------------------------------------o-----------------------------------------X--XXX------------------------------------------------------------------------------------------------------------------------------------------------------------------------------------------------------------o------------------------------------------------------------------------XXX----------------------------------------------------------------o---------------------------------------------------------------------------------------------------------------o-------------XXXXXX--------------------------------------------------------------------------------------------------------------------------------------------------------------------------------o----------------------------------------------------------------------------------------------------------------------------------------------------------------------oo---------------------------------------------------------------------------------------------------------------o---------------------------------------------------------------------------------------------------------------o-------------------------------------------------------------------------------------------------------------------------------------------------------------------------------------------------------------------------------------------
-------------------------------------------------------------oo--ooo--oo----------------------------------------------------------------------o--------------Eo-------------oo---------------------------------------------------------------------------o-------------------Eooo-----------------------------------o----ooo-ooo--oo----------------------------------------------------------------------------------------------------------oo--oo--------oo-------oo---oo--oo------------------------------------------------------------------------------------------------------oo-----------------------------------------------------------------------------------------------------------------------------------------------------------------------------------------------------------------------------------------------------------------------------------------------------------------------------------------------XX--------------------o------------oo-----------------------------Eo---o----------oo--ooo-XX---------------------------------------------------------------------------------------------------------------------------------------------------------oo--------oo--oo-----------------------------------------------------------XX----------------------------------------------------------------------------------------------Eooo-----------------------------------------------------------------------------
--------------SSS--SQQQ--------------------------------------------------------XXoo----------?--E----------------------QQQQQQ----------------------------------------------XXXXX-----------------------------------------------------------------XXX-----XX------------------XXX----------------------------XXXX--------------------------XXXXX------------------------XX-------------------------------Q-----------------Q--SS---------------------------XXXXX-----------------------XXXXo------------------------------------S----------------------------------------------o------oo---------------XXXoo----------Q-Q-----------SSSQQ------oo---------------XXoo--------------SS--------------------Q-QQQE----------------QQQ-Q------SSSS---QQQQQQQ------------------------------------------------------oooo--------------------------SS---------------------------------E------------------------------o---------------Xo-------QQ----------X----------------------------------------------o--------XXXX--XX-----o-------------------XXXoo------X-----------------------------------------------oo-----------------------XXXXX-o------------------X---------------------------XXX---------------------------------------------Q-Q---------------------------------XXX---------------------------------------------------------------------------SSSS---SQQSSS-----XXXXX----------------XXX-----------------------------QQQQ----------SQSQ-QQS------
---------------------------------------------------------------------E-S-XXX-------------------XX-XXX-------------------------XXX-----------------o-----------------------------------------------------------o-------------------X----------------------------------------------------------------------------------------------SS--------------XXXX--------------------------------------------------------------------------------------------SS--------------------------S-----X-----------------------------------o-----------------------------------------------E------XX-----------------XXX----------------------------------------------------------------------------------------------------------XXX---------XX------------------------------------------------------------------X----o---o----XXXX--------------------------------------------------------------o---X---Eo---o--o---XX-XXX----------------------XX---------------XXXS------------------E---o-----E--E--XXX---XXX---------------------------------------XXX-------------------------------------------E-------o---o-----XXX-------------------------------------------------o-------------------------XX-----XX-------------------E-------------------------------------------o-----------XXX------------------------------------------------------------------------------------------------------------------------------------------------------------------------------
-----------------------------------------------------------------XXXXXX---------------E----------------------------------------------------------XXX------------XXXX--o-----------------------------------------------------------------------------------o----------------------------------------------------------------XXX------------------------------------------------------------------------------------------------------------XXXX--XX---------------------X----XXX---------------------------------------------------------------XXXX----------------XXXXXXXXXX--o------------------------------------------------------------------------------------------------------------------XX----------------------------------------------------------------------------------------------XXXX-XXX-----------------------------------------------------------------X--XXX------XXXXXXXXXXX-o-------------------XXX-----o---------------XXXX-----------XXXXXXXXXX-XXXXXXXXXXXX--oo-XXXXXX---E-----------------------XXXXXX-X-------------------------------------------XXX-XXX--o--XXXX-XXXXXX--o-XX--XXXX--oo------------------------------------XXXXXXXX----------------XXXXX-------XXXXXXXXXXX---XXXXXXXXXXXXX-----------------------------E--o--------------XXXX-------------------------------------XX---------------------------------------------------X--------------------------------------------------------Q--------------------------
-----------------------------------ooo-------------------------------------------XXX-<>------------------o------------------------E------------------------------------X---------------------------------------------------------------XXXXX-------------XXX-------------------------------------------------------------------------------------------XXXXX-------------------------------------------------------------------------------------------------------------XX--------------XXX-------o-------------X--------------oo---------------------------XX--------------XXX-------------------------XXX--E---------------E---------------XX-----------------XXX------E-------------------E--X------------------------------------------------------------------------------E-------------------------------------------------E-----E--------------------------------------------------------------------XXX-------------XXX-------------XXXXX-----------------------------------------------XXXX---------------------------------XXX---XXXX---------------------E-------------------------------XXX---------XXXX----------------------------------------------------------XXXXXXX----------------X---------------------------------------------XXXXX--------E---XXXXX-------------------------------------XX--oo-------------------------E----------------------------------------S----------------------------------------------------------------
-QQQQ---------S----QS-------------------------------------XXXX-XXX-------------------[]------S--------------------E----E?SQQ-----<>------QQ?-----------------------------------------------------E-------------------------------------------------------------------XXXXX-------------------------------XXX--XXS---XXXXX------------------------------------------------------Q------------------------Q------------Q--Q----Q------XXXXX------------------------XXXX-------------------------------------------------------------------XXX---------------------------------------------XX-------------------<>----Q-Q-------<>-------??---------XXXX--------------------<>----------SQS-----<>--X-----S-QQQQ----------------QQQQQ-------------QSQQQ------------------------E--<>------------------------------Q-----------------<>----<>---o-------------------------XX-------------------------------EE----------------EE--------E--Q-----XXXXXX-----------------------------------------------------------XX--------XXX-------------------------------------E----<>----------------------------------XXX-----------------------------X----------XX-------------------------XXXXXXXX----------------------------X----------------QQ------------------------------XXXXXXX------------------------------------XXX-------------------------E--<>----Q--------SSSSS---XXX------------------------o---------------------------E-QQQQQ-Q-----QQQS--QQQ------
-------------------------------------------------------------------------------------[]--------------------------<>--------------[]-------------------------------------------------------------<>--XXXXXX-------------XXXXXX----XXXX--------------------------------------------------------------------------------------------------------------------------------------------------------------E-----------------------------------------------------------------------------------------------------------XXX-X--------------------------------XXXXXXX-----------XXXXX----------------------------------[]--------------[]-----E------------------------------------[]------------------[]--X--------------------------------------------------------------------E-E--<>--[]--------------X---------------------------------[]----[]---------XXXXX--------------XXX--------XXXXXX----XXXXXXX---XXXXXXX----------XXXXXXXX--------------XXXXXXX-----------XXXXXXXXXXX--------------------------------------------------------------------------------------<>----[]-------XXXXX-------------------------------------------------------------------------------------------XXXXXXXXX---------------XXX---------------------------------------X------------------XXXXXXXX----------------XXXXX--------------XXXX--------------XX--------<>--[]----------------------------------------------------?----------------------------------------------------
-------------------------------------------------------------------------------------[]--------------------------[]--------------[]-<>-----------XX---------------------------------------------[]-----------------------------------------------------------------------------XXXXXXX--------------------------------------------------------o--------------------------------------XXX----------<>-----------X-------------------X-------X------------------o--------X---------------------------------------EXXXX-----------------------------------------------------------------X-----------------------[]--------------[]----<>------------------------------------[]------------------[]--X-------------------------------------------------------------------<><>--[]--[]------------------------------------------------[]----[]---------------------------XXXX------------------------------------------------------------------XXXXXXXX--------------XXXXX---------------------XXXXX---------------------------------------------------------------[]----[]-----------XX-------------------------XXX---------------------------------------XXXXX-----------------XXXXXXXXXX------------XXXXX--------------XXX-----------------------------------------XXXXXXXXX----------------------------------XXXXX------------------------[]--[]---------------------XXX----X----------------------------------------------------------------------------
---------------------------------------------------------------------------------XXX-[]--------------------------[]-----------E--[]-[]--------------------------------o----------E--E-----------[]------------------------------------------------------------------------------------------------------------------------------------------XXXX-------------------------------E--E--XXX----EE----[]-E-----------------------------X-------------------------XXX-------------------------XXX-------------------X-XXX-------------------------------------------------------------------------------------XXX-[]--------E--E--[]----[]---------oo-----------------ooo-----[]---------E-E------[]--XX----------------------------------------------------------E-------[][]--[]--[]-----------------------------Eo----------EE-EE--[]----[]--------------------------XXXXX-----------------------------------------------------------------XXXXXXXXX-------E-E--------------------------o-----------------------------------------------------XXXX---------E----[]----[]-------------------------------ooo---------------------------------------------------------X---------XXXXXX-XXXX--EE-E----------------------------------E-EE-E-----------X----------------XXXX-XXXXX--EE-E---------------------------E--X-X------------------------[]--[]-------------E-E---------------------------------------------------------E-------------------------------
XXXXXXXXXXXXXX---XXXXXXXXXXX---XXX---XXXXXXXXX------XXXX-------------------------XXX-XXXXXXXXXXXXXXXXXXX----XXXX-XXXXXXXXXXXXXXXXXXXXXXXXXXX-------------------------XXXXXXX-XXXXXXXXXXX-XX-XXXXXXXX--------XXXXX------------XXX---------------------------XXXXX--------------------------XXXXXXXX---XX---XX-XXXX-----------------------------------------------------------XXXXXXXXXXX--XXXXXXXXXXXXXXXXXX---------XXXXXXXXXXXX------------------------------------------------------------X-XXXX---XXXXXXXXXXX-XXXXXXXXXXXXXXX----XX---------XXX---------------------------XX------------------------------XXXXXXXXXXXXXXXXXXXXXXXXXXX-X----XXX----------------XXXXXXXXXX----XXXXXXXXXXXXX-XXXXXXXXXXXXXXXXXXXXX-XX--XXXXXXXXXXXXXXXX------XXXXXXXXXXXXXXXXX-XXXXXXXXXXXXXX--XXXXXXXX--XXX-----XXXXX-----XXXXXXXX-----XXXXXXXXXXXXXXXXXXXX--XXXX----XXXXX----XXXXXXXXXXXX-----------------------------------------------------XXXXXXXXXXXXXXXXXXXXXXXXXXXXX------------------------XXX----------------------------------------------------------XXXXXXXXXXXXXXXXXXXXXXXXXX-------------------------XXX-----------------------------XX-------------------------XX----XXXXXXXXXX--XXXXXXXXXX----------------------------XXXXXXXXXXXXXXXXXXXX-X-XXXXX------XXXXXXXXX--XXXXXXXXXXX----XXX---XX--------X-X-XXXXXXXXXXXXXXXXXXXXX--------XXXXXXXXXXXXXXXXXXXXXXXXXXXXXXX-------------XXXXXXXXX---XXXXXXXXXXXXXXXX-----X-XXXXXXXXXXXXXXXXXXXXXXXXXXXXXXXXXXXX
