--------------------------------------------------------------------------------------------------------------------------------------------------------------------------------------------------------------------------------------------------------------------------------------------------------------------------------------------------------------------------------------------------------------------------------------------------------------------------------------------------------------------------------------------------------------------------------------------------------------------------------------------------------------------------------------------------------------------------------------------------------------------------------------------------------------------------------------------------------------------------------------------------------------------------------------------------------------------------------------------------------------------------------------------------------------------------------------------------------------------------------------------------------------------------------------------------------------------------------------------------------------------------------------------------------------------------------------------------------------------------------------------------------------------------------------------------------
--------------------------------------------------------------------------------------------------------------------------------------------------------------------------------------------------------------------------------------------------------------------------------------------------------------------------------------------------------------------------------------------------------------------------------------------------------------------------------------------------------------------------------------------------------------------------------------------------------------------------------------------------------------------------------------------------------------------------------------------------------------------------------------------------------------------------------------------------------------------------------------------------------------------------------------------------------------------------------------------------------------------------------------------------------------------------------------------------------------------------------------------------------------------------------------------------------------------------------------------------------------------------------------------------------------------------------------------------------------------------------------------------------------------------------------------------------
---------------------------------------------------------------------------------------------------------------------------------------------------------------------------------------------------------------------------------------------------------------------------------------------------------------------------------------------------------------------------------------------------------------------------------------X--X-------------------------------------------------------X-------------------------------------------------------X------------------------------------------------------------------------------------------------------------X--------------------------------------------------------------------------------------------------------------------------------------------------------------------------------------------------------------------------------------------------------------------------------------------------------------------------------------------------------------------------------------------------------------------------------------------------------------------------------------------------------------------------------------------------------------------------------------------------------------------------------------------------------------------------------------------------------------------------------------------------------------------------------
---------------------------------------------------------------------------------------------------------------------------------------------------------------------------------------------------------------------------------------------------------------------------?--------------------------------------------------------o----------------------------------------------------------------------------------------------------------------------------------------------------------------------oo--------------------------------------------------------------------XX-------------o----------------------------------------------------------------------------X--------------------------------------------------------------o----------------------------------------------------------------------------------------------------------------------------------------------------------o------------------------------------------------------------------------------------------------------------------------------------------------------------------------------------------------------------------------------------------------------------------------o-----------------------------------------------------------------------------------------------------------------------------------------------------------------------------------------------------------------------------------------------------------------------
--------------------------------------------------o--o-----------------------------------------------------------------------------------------------------------------------------------------------------------------------------------------------------------o-------XX-------------------------------------------------------------------------------oo--oo------------------------------------------------------oo-----------------oo--oo--XX----------------------------------------------oo-------o------------------oo--oo----------------------oo--oo----------------------oo------------------------------------------------------------------------------XX--o---X---XXX---------------------------------------------------------------------------------------------ooo------------------------------------------------------------------oo---------------------------------------oo-----XXX----------------------------------------------------------------------------------------------------------------o----oo--------------------------------------------------------------------------------------------------------------------------------oo----o---oo--oo-----------------------------------------------------------------------------------------------------------------------------------------------------------------------------------------o-----------------------------X------------------------------------------------
--------------------------------------------------XXXXX--------------------------------QQQ-Q---Q-------------------QQQQ-------------------------------------------------------------------------------QQQQ-------------------------------------------------------------------------XXoo--QQQ-Q------------------------------------------------o------------------------XXXo---------------------o------------------X-------o----X--------------------------XXoo-----SSSS-----SSQS--QQQQQ-------------------------------------------------------XXooo------------------------oooo------------------------------------------------------o----------------------S--SSSQ------------------------oo--------QQQQQQ------------------------------------------------oo----XXX----XXX--------o----------------------------XXQX---------------------------------------------------------------------------Xo---------------------------------------Q-Q------------SS---------------------------------------------------------------------------------XXoo---------------SSSSS-----------------E-----------------------------X--------------------------------------------------------------------XXoo------------------------XXoo------------------------------------------SS--QQQQQ----------------------------------------o-------------------------------------------------------------------------------------------------------------------------------------
---------------------------------------------------------------------o-----------------------------------------------------------------S------------------------------------------------------------------------------------------o---o------------o------XX-XX--------------XXXX-----------------------------------------o------------o--o---XX-------------S---------------------------XS----------------XXX--------------------------------o--S----XX---------------------------------------------E---o-----E--E---XX-------------------E-----XXX---------------o---E----XXXX-------------------E--o---XX------------------------------------------------------------------o------XXX-----------------------XX---------------------XX--oo---o-----XXX-----X------------------------------------XXX--------------------------------------------------------------------XXXX-----------------------------------------------------------------------------------------------------------------o---o--------------------------------------------------------------------------------E--X---Eo---E--E----X---------------------------------------------------------------------------------------XXX------------------------o---o--------------------------------------------------------------------------------------------------------------------------------------------------------E--o---XX--------------------------------------------------------
---------------------------------------------------------------X----XXX-----------------------------------------------------E------XX---------X----------------------------------------------------------------------X----------XXXX-XXX-XX----XX-XXX-XX--o------------X-------------------------------------------------XXX----------XXXXXX--o------XXXXX-X-X----------------------XX----------------------------------------------------XXXXXX-X-------------------------------------------XXXXXXXXXX-XXXXXXXXXXXX--oo-------------X----XXX--------------------XXXXXXXX---------------------XXXXXXXXXX--oo--------------------------oo-------------------------------------XXX-X-----------------------------------------------XXX------XXX-XXXXXX-----------------------------------------------------------------------------------------XXXXXXXXXX-----X-XXXXXXXX---------------------------------------------------------------------------------------------------------XX--------XXX-XXX-XXX------XXX-------------XX-----------------------------------------------X-XXX-XXX--o---XXXXXXXXXXXXXoX-------------------------------------------------------------XX----------XXX------------------o----------------XXXX-XXX--oo------------------------XX--------------------------------------------------------------------------------------------------------------------XXXXXXXXXX--o---------------------------------------------------------
-----------------------------------------------------XXX-------------------------------------------------------------------XS------XX-------------------------------------------------------------------------------XXX------------------------------------------XX-----------------XXX--------------------XX--------------------------------XXX-------------------------XXX---------------------XX--------------XXXX----------------------------------------XXX---------------------------------------------------------------------------------XXX-------------------------XXX-------------------------XXX------XXX----------------XXX---------------------------------XX------------------XX-------------------------------------------------------XX---------------------X--------o---------------XXX------------------------------------------------------------------------XXX------XXX----XXX--------------------------o------------------------------------------------XX--------------------------------------------XXX-------------XXX--------------------------XX---------------------------------------------------------------------------------------------XX--------------------------XXXX--------------------------------------------------XXX-----------------------------------S----------------X----------------------------------------------------------------------------X------------X-----X-----------------------------o-------
--------------------------------X----XX-X----------------------------------------------QQQQ------------------------SSS----XXX------XX----------------------------------------------------------------X-QQQ---------XXXX----------------------E-------------------------------------------QQQ---------------XX---------------------E-------------XXXXX------------------------X--XX------ooo-------------XXXX---------XXX----XXXX--X----XXX-------------------------QQQQ------Q------QQQQQQ------------E--------------------XXX-XX--------------------------XXX-----------------------------E--------------------------------XX-----XX------------------------S----SS-------------------------------E--EQQQQQQ-------Q----------------------------------Q-XXX---XXX---XXX---------------XXXXXXXXX-----------------Q-Q----------------------------------------X----EEE-----------------------------------------------X---XX--------ooo---Q-QQQ--------------X--------------------XX---------------------E-------------XX---------------------------------Q--Q---QQ-Q-------XXX--------------------------------------------------------------------------XXXX------XXXX-------------------X-----X-----------------------------------------------------Q-------XXX-------QQQQQ----------------E--------------------------XXXXX---------E---X---QQQ--------------------------E----------------------------------XXX-X-XX--------------------------E----------
---------------------------------------------------------------XXX-------------------------------------------------------XXXX--XXXXXXX--S--------------------------------------------------------------------------XXXX------------------XXXXXXXXXXXXXX-----XXXXXX------------XXXXX----------------------XXX------------------XXXXXXX-----------------------------------------------------E------------------X-------------------------------------------------------------------------------------XXXXXX?----XXX--------------------------------------------XXX-?-----------------------XXXXXX---------------------------------------------------------------------XXXXXX------------XXXXX------------------------------------------XXX-?-----------------------------------------------------------------------------------------------------------XXXXX----XXXXXXXXXX-------------------------------------------X--XXXX------E-------------------------X--XXXX---------XX--XXX-----------------XXXXXX----------------------------------------------------------------XXXX---XXXXXXXXXX--------------------------------------------<>------------------------------------------------------XXXX--------------------------------------------------------XXXXX------------------XX-?--XXXXXXXX------------E-------------------XXXXXXXX------------------------------XXXXX--XXXXXX-----XXX-----------------XXXX-X-XX--------X----------------<>----------
--------------------------------XXX---------------------XXX-------------------------------------------------------------XXXXX--XXXXXXX----------------------------------------<>------------------------------EX---XXXX---------------------------------------------------------------------------------XXXX-----------------------------------------------------------------XX---XXXXXXXXXXX--XX------X----XXX------------------XXX--------------------------------------------------------------XXX---------------------------------------------------------------------------------------------------------------------------------------------------------------------------------------------------------------------------------------------------------------------o-------XXS-------------------------------------------------------------XXXXX-------------------XXX-----------------------------------X--XX-XXXX---------------------------------X---------------X---XX------------------------------------------------------------------------------------E-XXXXX------X---------------------XXXX-------------------------[]------------------------------XXXX-------------------X----------------------------Q------------------------------XXXXXX-------------------------------------------<>----------------------------------------------------------------------------------------------XXXXX-XXXXX------XX----------------[]----------
-----------------------------------------------------------------------------------------------------------------------XXXXXX--XXXXXXX---------------E-------------E-----E----[]------------------------------XX---XXXX-----EE-X---------------------------E-------------------------------------------XXXXX---------------------------------ooo-------------------------XXX---------------------------------------------------------------------------------ooo---------------------------------------------------------------------------------oXo------o-------------------oo------o-------------------oo-------------------------XXX-----------E-EE-------E-----------------XXX----------------X-----------------E--------------------------------ooXXXXXXX----------XXX--------S-------------------------oo-------------------------E--------------------------------------------------------XX-------E---XX--X--XXXX---E----------------E-----------XX-------------X-----XX--------------------------------o-o-------------------------XXXEE-E-----------E-------XXXXX---------------------------------------------------------[]--------------------------------------------------XXX---------------------------------------------------E--E----XXXXXXX------------EE-E---------------------------[]-------oo------------------------------------------------------------------------------------XXXXXX-XXXXX-----XXX----E-EE--------[]----EE----
-XXXXXX---XXXX--------XXXXX------------------------------------------------XXXXX--XXXXXXXX--XXXXXXXXX----XXXXXX-XXXXXXXXXXXX---XXXXXXXXXXXXX--XXXXXXXXXXXX-X-XXXXXXXXXXXXXXXXXXXXXXXXXX--XXXXXXXXXXX-XXXXX-XXXXXXXXXXXX--XXXXXXX-----X------------------XXXX----------------------------XXXXXXXXXXXXXXXXXXXX-X---XXXX-----XX-----------------XXX------------------------------------------------------------------------------------------------------------XXXXXXXXXXXXXXXXXXXX-XXXXXXXXXXX-----------------------------------------------------XXXX---XXXX-------X--------XXXXXX---XXX-----------------XXXX---------------------------XX-------XXXXXXXXXXXXXXXXXXX--------XXXXX-----------S?X-XXXXXXXXXXXXXXXX-X-XXXXXXXXXXXX--XXX-----XXX--------XXXX----------------------------XX---XXX-XX--XXX-----XXXXXXXXXXXXX-XXXX--------XXXXXXXXX---------------------------------------------------------XXXXXXXXXXXXXXX-XXXXXXXXXXXXXXXXXXXXXXXXXXXXX-XXXX--XXXX------XXXXXX-----XXXXXXXXX-------XXXX--------------XXXX----------------------------XXXXXXXXXXXXXXXXX-XXXXXXXXXXXX-----------XXX-XXXXX-------------------X-X-XXXXX-----XXXX---XXXXXXXXXXXXX------XXX-----------------------------------------------------------XXXX----XXXXX-XXXXXXXXXXXXXXXXXXXX----X-XXXXXXXXXXXXX-XXXX-----------XXXXXXXXXXXXXX----XXX--------------------XXXX----XXXXXXX-----XXXXXXX-----X-------X-----------XXX-XXXXXXXXXXXXX---XXXXXXXXXXX-XXXXXXXXXXXXXX-XXXXXXXXXXXX
