--------------------------------------------------------------------------------------------------------------------------------------------------------------------------------------------------------------------------------------------------------------------------------------------------------------------------------------------------------------------------------------------------------------------------------------------------------------------------------------------------------------------------------------------------------------------------------------------------------------------------------------------------------------------------------------------------------------------------------------------------------------------------------------------------------------------------------------------------------------------------------------------------------------------------------------------------------------------------------------------------------------------------------------------------------------------------------------------------------------------------------------------------------------------------------------------------------------------------------------------------------------------------------------------------------------------------------------------------------------------------------------------------------------------------------------------------------
--------------------------------------------------------------------------------------------------------------------------------------------------------------------------------------------------------------------------------------------------------------------------------------------------------------------------------------------------------------------------------------------------------------------------------------------------------------------------------------------------------------------------------------------------------------------------------------------------------------------------------------------------------------------------------------------------------------------------------------------------------------------------------------------------------------------------------------------------------------------------------------------------------------------------------------------------------------------------------------------------------------------------------------------------------------------------------------------------------------------------------------------------------------------------------------------------------------------------------------------------------------------------------------------------------------------------------------------------------------------------------------------------------------------------------------------------------
-------------------------------------------------------------------------------------------------------------------------------------------------------------------------------------------------------------------------------------------------------------------------------------------------------------------------------------------------------------------------------------------------------------------------------------------------------------------------------------------------------------------------------------------------------------------------------------------------------------------------------------------------------------------------------------------------------------------------------------------------------------------------------------------------------------------------------------------------------------------------------------------------------------------------------------------------------------------------------------------------------------------------------------------------------------------------------------------------------------------------------------------------------------------------------------------------------------------------------------------------------------------------------------------------------------------S---SSSSS-----------S----------------------------------------------------------------------------------------------------------------
----------------o-------------------------------------------------------------------------------------------------------------------------------------------------------------------------------------------------------------------------------------------XXX-------------------------------------------------------------------------------------------------------------------------------------------------------------------------------------------------------------------------------------------------------------------------------------------------------------------------------------------------------------------------------------------------------------------------------------------------o----------------------------------------X------------------------------------------o-------------------------------------------------------o----------------------------------------------------------------------------------------------------------------------------------------------------------------------------------------------------------------------------------------------------------------------------------------------------------------------------------------------------------------------------------------------------------------------------------oo-------------------------------------------------------------------------Q---------o---------------------------------X---------------------------------
-----oo---o---oo----------------------------------------------------------------------------------------------------------------------------------------------------------------------------------------------------------------------------------------ooo-------------------------------------------------------------------oo--oo------------------------------------------------oo---------------------------------------------------------------------------------------------------------------oo----------------------------------------------------------------------------------------------------------------------------------------------------------------------------------------------------------------------------------------------------------------------------------ooo--oo--oo---------------------------------------------oo---oo--------------------------------------------ooo--oo---oo--oo---------------------------------------------ooo--oo--oo-----------------oo---oo--oo-----------------o--------o---------------------------------------------------o------------------------------------------------------------------------------------------------------------------------------------------X---------------------------------------------------------------------------------------------------------------------------------------E------------------------------------------------------------------------------
------------------------ooo--E-----------------------o--XX------------------------------------------------------------------------------oooo-Q-Q-Q-----Q--QQQ--------QQ---------------------------------------------------------------------------------XXX---------o---------------ooo----------Q-Q-------Q-QQQ------------o--------------XXXX-XX-----------------SSS-------------XX----E-----XX----------------------------------------------------------------------------o----------------------------------------------------------------------------------------------------------------------------------oo-----X----------XXXX-----------------------SSSS-------ooo---------------XXX--------E--E-----------------o-------QQ--------------oQ--------------------------XXX--------------------------XXXo---------------------------------------------------------------SSS--QQQQQ---QQQ-Q---------------------------XXoo-XXX------------------------------------------------XXoo------------------------XXXX---------------------------X--------------SSSSS---------------------------------------------SS--?-SSS---QQSSSS---------------------------------QQQQQQ---------------------Q-Q-----------------------------------------------XXXo-QQQQ-----------SS-------------------------------------------QQQ--------------------------SQQ------QQ-----QQQ---------E----------------------------------------------------------o--------------XXo--
-------------------E-----XXXXXXXX----------------------------------------------------------------------------------------------XXX-o-----XXX-----------------------------------------------------------------------------------------------------------------XXX---E----------------XXXX-------------------------------XX----------------------------------------------------------------XXX---XX----------------------------------------------------------------------E---------------------XXX--------------------------------------------------------------------------------------o-------------------------------------------------------------------------------------------------------------------XXX-Eo---o-----XXX---------------------------------------------X-X---------------------S----------------------------------------------------X----o---o------XX-------------------------------------------S---E-------------------------------------------------SS--------------------------SS---------------------------------------------------------------------------o----------------------------------------------------------E---------E--E---XX----------------------------------------------------------XX--o---o-------XX-------------------------------------XXX--oE--X--------E--E---XX---------------------------------------------------------------E--X----o---E--o---XX--E---E--------o-----E----XX-XXX---------------E------XX
--------------XXXXXXXXXX--o---------------------------------------------------------------------------------------------------XXX-XXX-----o----------------------------------------------------------------------------------------X-XXXXXXX-----------------XXX-XXX--o--------XX-----------------------------------------XX-----------------------------------------------------------X-o----XX----------------------------------------------------------------XXXXXXXX--o---------------------------------------------------------------------X------------------------------------XXX-XXX---------XXX----------------------------------------------------------E----------------------------------XXX------XXXXXXXXXX--o----------------------------------------X----------------------XX----XX-----------------------------------------------XXX-XXX-XXXXXXXXXXX--o----------------------------------XXXXXXXXXXXXXXXX--------------------------------------------X--XX---------------------XX---XXX-XXX-XXX-----------XX---------XXXXXXX--o------X-oS-----------------XXXXXX-XXX-----------XXXX--------------------------------------XXXXXX-XXXXXXXXXXXXX-oo---------------------------------------------------------XXX-XXXXXXX-X-------------------------------------------XXX-XXX--o-XXXXXXXXXXXX--oo---------------------------------------------------------XXX-XXX----XXXXXXXXXXXX----XXXXXXXXXXo----XX-XXXXXXXX--------------------XXX-------
---------X---------------XXX-------XXXXX-------------XXX---------------------------------------------------------------------------------XXX------------------------------------------------------------------------------------------------------XXX----XXX---------XXX-------------XXX-------------------------------------XXX-------------XXX-----------------------------X----------------XXX-------------------------------------------------------------------------XXXXX--------------------XXXXX--------------X--------------E---------XX----------------------------ooo-------------------------XX----------XXXX----------------------------------------XXX-----------------------------------------------------XXX-----------------------------------------------------XX--------------------------XXX----------------------------------------------------------------------------------------------------------------------------------XQX--------------------------------X----------------------------------------XXX------------XXX----XX-------------------XXX-----------------------------------------------------------------------------------------------------X---------------------------------------------------------------XXX--------------------------XX---------------------------------------------S-------------------------------------------------------------------------------------------------------XXX-------------XXX
-XXX-------------------------------------------------------------------------------------------QQ----QQQ-----------------XX-----------------QQQQQ------Q---QQQ--QQ--QQQQ-QQ-------------------------o----------QQ---------------XX-------------------------------------------------------------Q--QQQQ---QQQ-SSQ-----X---------------------------------------------------------XXXXXXX-----X---X-------------------------------------------------------------------------------------XXXXX------------------------------------------<>---------XX--------------------X--X-----------------------------------XXXX-----------------XXX---Xo---------E-------------XXXXXX-----XXX-------------------------------------------------E--Q-------------XX-----------------------------------XXXX------------------------------------------------------------------------------------------QQQ---QQQQQQQQQ-----XX--------------------------QXX----------------------XXXXX-----------------------XXXXXX----------------------XXXXX--------------------------XXXX----------Q------XXXX--------------------EEEE------Q----Q--QQQQQQ-QQQQQ------------------------------------E?QQQQ--------XX----------QQQQ-------Q--------------------------------------------QQQ----Q-----<>----SS-----XX--------E-E---------------------S?S--------------------------Q-------------QQ?-Q--------E-EE--EE-------------------------------------EEE-----E--E-----------------------
----------------------------XXXXX---------------------------------XXXXX--------------------------------------------------------------------------------------------------------------------------------------------------------------------------------------XXXXX--------------------------------------------------XXXXXX----------------------------------------------------------------XXX--X-------------------------------------------------------------------o----------------------------------------------------------------[]-------E--X--------------XX--XXX--XX------------------XXX--------------------------------------------------<>------------XXXXX-------------------------------------XXXXX------------------------------------------XXXXX----------------------------------------------------------------E-----------------------XXXXX------------------------------------------------------------XXX---------------------XX--------------------------------------------------------------------------------------------------XXXXX----------------XXXXX-----------------XXXXXXXXXX--------------------------X-----------XXXXX----XXXXX--------------------XXXX---------------------------------E---XXXXX------------------------------------[]----------XXX-XXXXXXXXXXXXXX---XXXX?-------------------------------------------------------------XXXX--XXXXXXXXX---XXX----------------XXXXX----XXXXXXXXXXXXXXXXX------------XX-------
---------------------------------------------------------------------------------------------------------------------------------------------------------------------------------------------------X-------------------------------XXX-----XX--------------------X--------------------------------------------------------------------------------------------------------E--------------XXXX--XXX-------Xo-------------------------------------------------------XXXXXX------------------------------------------------------------[]--<>--<>--X-------------XXX--XXX--XXX----------------------------------------------------------------------[]-----------XXXXXX---XXXX---------------------------X---------------------------------------------------------------------------------------------------------------------<>----------------------------------------o---XXX-----------------------------XXX----------------------------------------------------------X----------------------XXX---------X-X------------XXXX--------------------XXXXXX---------------XXXXXX-----XX---------------------------------------------XX--------XXXXX--------------------------------XXXX--------------------------------<>--------------------------------------------[]---------XXXX---------------------------X-----------------------------------------------------------------------------------------XXXX-----------------------------------------------
--------------------------oo-------------------------XXX------------------------EE-E--------------E-EE-----------------------------------ooo-------------E-E--------------------------E-----------XX-----------------------------------------------------XXo-------------------------ooo--------------E--E----------------------------------------------------------------XX------------XXXX---X---------XX-------------EE-------------------------------------------------------------------------------------------------E--E-----[]--[]--[]--X------EE-E---XXX--XXX--XXXX-----------------------------ooo---------------------------X---------[]----------XXXXXXX-----------------------------------------------------ooo--------EE---------------E-----------------------------X-------------------------XXX------E-----[]---------------------------------------XXX-XXXX---EE-------------------------------------------XXX------------------------EE-E-------------------------XXX-------------------------------------------------------XXXXXXXXX-------------XXXXXXX---------------------------------------------------XXXX--------------------------------------------X-XX-----EE----------------E--E-E---[]----------------------------XXX-------------[]--------XXXXX----------------------------------------------------------------EE-E-------------------------------------------E--------------------------------------------------------
-------------------------XXX---------------------------XXX---XXX---------XX-XXX-XXXXXXXXXXXXXXXXXXXXXXXXXX---XXXXX---XXX-----XXX---------XXXXXXXXX--XXXXXXXXXXXXXXXQ-XXXXXXX---XXXXXXXXXXXXXXXXXXXXXXXXXXXXXXXXXXXXXXXXX-X----XX--------------------------XX-------------------------XXXXXX--XXXXXXXXXXXXXXXXQ-----X----------------------------XXXXXXXX---------XXXXXXXXXXX----------XXXXX-------------XXX--XXX-X---X--XXXXXXXX-XXX---XXX--XXXXX-X---------XXX-------------------XXX-----------------------------------XXXXXXXXXXXXXXXXXXXXXX--XXXXXXXXXXXXXXXXXXXXXXXXXXXXXXXXXX---X-------------------XXX----------------------------XXXXXXXXXXXXXXXXXXXXXXXXXXX----------------XXXXXX-------XXX----------------------XXXXXXXXXXXXXXXXXXX--------XXXX---------------------------------------------------------XXXXXXXXXXXXXXXXX-X---XXXXXXX--------------------------XXXXXXXXXXXXXX--XXXXXXXXXXXX-----------------------------XXX-X---XX----------XXXXXXX-----------------------------------------------------------------------------------XXXXXXX------XXXXXXXXXXXXXXX-----------------------------XXXXXXXXXXXXXXXX-XXXXXXXXXXXXXX-------------------------XXXXXXXXXXXXXXXXXX--XXXXXXXXXXXX-X---XXXXXXXXXXXXXXXXXXX-------------------------XXXXXXXXXXXXXXXXXXXXXXXXXXXXXXXX---------------------------XXXXXXX--XXXXXXXXXXXXXXX---XXXXXXXXXXXXXXXXX--XXXXXXXXXX----XX---------X------X-XXXX--------------------------------------------------------
