--------------------------------------------------------------------------------------------------------------------------------------------------------------------------------------------------------------------------------------------------------------------------------------------------------------------------------------------------------------------------------------------------------------------------------------------------------------------------------------------------------------------------------------------------------------------------------------------------------------------------------------------------------------------------------------------------------------------------------------------------------------------------------------------------------------------------------------------------------------------------------------------------------------------------------------------------------------------------------------------------------------------------------------------------------------------------------------------------------------------------------------------------------------------------------------------------------------------------------------------------------------------------------------------------------------------------------------------------------------------------------------------------------------------------------------------------------
--------------------------------------------------------------------------------------------------------------------------------------------------------------------------------------------------------------------------------------------------------------------------------------------------------------------------------------------------------------------------------------------------------------------------------------------------------------------------------------------------------------------------------------------------------------------------------------------------------------------------------------------------------------------------------------------------------------------------------------------------------------------------------------------------------------------------------------------------------------------------------------------------------------------------------------------------------------------------------------------------------------------------------------------------------------------------------------------------------------------------------------------------------------------------------------------------------------------------------------------------------------------------------------------------------------------------------------------------------------------------------------------------------------------------------------------------------
----oo---------------------------oo-------------------------ooo-------------------------oo--------------------------oo--------------------------oo--------------------------ooo-------------------------ooo-------------------------ooSS--------------------SSSSSSSSSSSSSSSSSS--------------oo--------------------------oo--------------------------oo--------------------------oo--------------------------oo--------------------------ooo-------------------------ooo---------------------S---oSSSSSSSSS------------------oooS----------------------------------------------------ooo-------------------------ooo-------------------------oo--------------------------o-SS------------------------oo--------------------------ooo-------------------------oo--------------------------oo--------------------------oo--------------------------oo--------------------------oo--------------------------oo--------------------------oo--------------------------oo--------------------------oo--------------------------oo--------------------------oo--------------------------oo--------------------------ooo-------------------------ooo-------------------------oo--------------------------oo--------------------------oo--------------------------oo--------------------------oo------------------------------------------------------oo--------------------------oo--------------------------oo--------------------------oo----------------------
----XXXX------------------------XXXX-----------------------XXXXX-----------------------XXXX------------------------XXXX------------------------XXXXX-----------------------XXXXX-----------------------XXXXX-----------------------XXXX-------------------------XXX------------------------XXXXX-----------------------XXXXX-----------------------XXXXX-----------------------XXXX------------------------XXXX------------------------XXXXX-----------------------XXXXX------------------------XXX-------------------------XXXX---------------------------------------------------XXXXX-----------------------XXXXX-----------------------XXXXX---------------------------------------------------XXXXX-----------------------XXXXX----------------------XXXXXX-------------------E---XXXX------------------------XXXX-----------------------XXXXX--------------------E--XXXXXX-----------------------XXXX------------------------XXXX------------------------XXXX------------------------XXXX------------------------XXXX-----------------------XXXXXX-----------------------XXXXX-----------------------XXXXX------------------------XXXX----------------------XXXXX-----------------------XXXXX-----------------------XXXXX------------------------XXXX-----------------------XXXXX----------------------------------------------------XXXX-----------------------XXXXX--------------------E---XXXX-----------------------XXXXXX-------------------E
---------------------------------------------------------------------------------------------------------------------------------------------------------------------------------------------------------------------------------------------------------------------------------------------------------------------------------------------------------------------------------------------------------------------------------------------------------------------------------------------------------------------------------------------------------------------------------------------------------------------------------------------------------------------------------------------------------------------------------------------------------------------------------------------------------------------------------------------------------------------------------------------------------------------------------------------------------------------------------------------------------------------------------------------------------------------------------------------------------------------------------------------------------------------------------?----------------------------------------------------------------------------------------------------------------------------------------------------------------------------------------------------------------------------------------------------------------------
------------------------SSSS---------------------SSSSSSS------------o----------SSSSS------------o-----------SSSS---------oooo----E------SSSS------------------------SSSS------------------------SSSS------------o-----------SSSS-------------------------SSS------------o------------SSS------------o-----------SSSS-----------oooo---------SSSS------------o-----------SSSS---------oooo----E------SSS----------o--------------SSSS------------------------SSSS------------o-----------SSSS---------oo-o------------SSS------------------------SSSS---Q---Q-QQQ-------------------------------------SSSSSSS-----------------------SSSSS-----------oo-----------SSSS---------o--------------SSSS------------o-----------SSSS------------o-----------SSSS---------ooo-----X-----SSSSS---------oooo----E------SSSS-----------------E------SSS----------oooo----XX-----SSS----------ooooo---E------SSSS---------oooo-----------SSSS---------oooo----E------SSS----------o-------E------SSSS---------oooo----E------SSSS---------oooo----E------SSSS------------------------SSSS------------o-----------SSSS------------------------SSSS------------------------SSSS-----------oo---XXX-----SS-------------oo----ESS----SSS-----------oooo---E------SSS------------ooo---ESS----SSS----------oooo----XX-----SSS------------ooo---XX-----?---------------oo---XSS----SSS----------oooo----XX----SSSS-------------oo---XXS----S---------------oo---ESS----SSS-
----------------------------------------------------------------------------------------------------------------------------------------------------------------------------------------------------------------------------------------------------------------------------------------------------------------------------------------------------------------------------------------------------------------------------------------------------------------------------------------------------------------------------------------------------------------------------------------------------------------------------------------------------------------------------------------------------------------------------------------------------------------------------o---------------------------o--------------------------oo---------------------------o-----------------------------------------------------------------------------------o-------------------------o-o---------------------------o---------------------------o-------------------------------------------------------------------------------------------------------------------------------------------o---------------------------o------------------------------------------------------oo---------------------------o--------------------------ooo--------------------------o------------------------------------------------------oo-----------------------------------
--------------------------------------------------------------------------------------------SS------------------------S-SSS-------------------------S------------------------------------------------------------------------------E----SS---------------------E----SS--------------------------SS-----------------------------SSS----------------------S-------------------o-----S-SSS-----------------------S-SS---------------------o--------------------------------SS--------------------SS--S-SSS--------------------o--------------------------------------------------------------------------------------------------------------------S---------------------SS--S-SS--------------------------SS------------------------------------------------------S---------------------------S-----------------------------------------------------------------------------------S---------------------------SS-S----------------o-----S-S-S-------------------------S-------------------o-------S-------------------o-----S-S-------------------------------------------------------SS---------------------o----S-----------------------------------------------------------------------------------------------------------------------------------------------------------------------S---------------------------------------------------------------------------------------------------------------------------------------------------------------
------------------E---------------------------E---------------------------E---------------SoS---------E---------------SoS---------E-----------------S---------E---------------------------E-----------------S---------E---------------SoS---------E--o------------SoS---------E--o------------SoS---------E-----------------S---Q-----E---------------------------E---------------SoS---------E---------------SoS---------E-----------------S---------E---------------SoS---------E----------oSS--SoS---------E--o------------------------E-------------------------------------------------------E---------------------------E---------------S-S---------E----------oSS--SoS---------E--o--------------S---------E--o--------------S---------E---------------------------E---------------SoS---------E---------------------------E---------------------------E---------------SoS---------E---------------SoS---------E---------------SoS---------E---------------SoS---------E---------------SoS---------E---------------SoS---------E---------------------------E---------------SoS---------E----------------oS---------E---------------------------E-----------------------------------------------------------------------------------E---------------------------------------------S---------------------------------------------------------------------------------------------E-----------------------------------------------------------------
-----------------<>-----E-----E--------------<>-------SS-----------------<>------E?SXXS---SSS--------<>------E?S--S---SSS--------<>------E?S--S--------------<>------E?S-----------------<>------E?S-----------------<>------E?SSSSS--SSS--------<>------E?S-SS---SSS--------<>------E?S-------SS--------<>------E?S-----------------<>--SX--E?S-----------------<>------E?SXXS---SSS----XX--<>------EXXXXS---SSS----XX--<>------E?S-----------------<>------E?S--S----SS--------<>------E?SSSSS--SSS--------<>------E?S-----------------<>------E?So-o--EQQQQQQ---------------------------------<>-----E--------------------<>-------?S-------SS--------<>------E?SSSSS--SSS--------<>------E?S-------SS--------<>------E?S-----------------<>------E?S-X-----S-----XX--<>-X----E?XXXS---SSS----XX--<>------E?XXX-----------XX--<>------EXXX------------XX--<>-XXX--E?--------SS--------<>-XX---E?X------SSS--------<>------E?SXXS---SSS----XX--<>-XX---EXXXXS---SSS----XX--<>------E--XXX---SSS----XX--<>-XX---EXXXXS---SSS----XX--<>------EXX-----------------<>------E?S--S----SS--------<>------E?SSSS----SS--------<>------E?S-----------------<>------S?S-------------XXX----XXX-----XX-----------XX-----XXX------------------XX--<>-XXX--XXXXX-----------XXX----XXX-----XX-----SS----XX--<>-XXX--XXXXX-----------XXX----XXX------------------XXX----XXX-----XX-----------XX--<>-XXX--XXX-------------XXX----XXX------------------XX--<>-XXX-----
-----------------[]----<>----<>--------------[]--------------------------[]------------o-------------[]------------o-------------[]--------------------------[]--------------------------[]--------------------------[]--------------------------[]--------------------------[]------------o-------------[]------------o-------------[]------------o-------------[]------------o-------------[]------------o-------------[]--------------------------[]--------------------------[]--------------------------[]--------------------------[]------------------------------------------------------[]----<>-------XXX----------[]------------o-------------[]--------------------------[]------------o-------------[]--------------------------[]------------o-------------[]------------o-------------[]------------o-------------[]-----------Eo-------------[]------------o-------------[]------------o-------------[]------------o-------------[]------------o-------------[]--------------------------[]------------o-------------[]------------o-------------[]------------o-------------[]--------------------------[]--------------------------[]-----------Eo--------------E------------o-------------<>------------o-------------[]------------o--------------E------------o-------------[]------------o--------------E-----E------o--------------E------------o-------------[]------------o--------------E--------------------------[]---------
-----------------[]----[]----[]--------------[]------------XXXX----------[]-----------XXXXX----------[]-----------XXXXX----------[]-----------XXXXX----------[]-----------XXXXXX---------[]-----------XXXXX----------[]------------XXX-----------[]------------XX------------[]-----------XXXXX----------[]-----------XXXXXX---------[]-----------XXXXX----------[]-----------XXXXX----------[]-----------XXXXX----------[]------------XXXX----------[]-----------XXXXX----------[]-----------XXXX-----------[]-------------XXX----------[]-----------------------------------------XXX----------[]----[]--------------------[]----X------XXXXX----------[]-----------XXXX-----------[]-----------XXXXX----------[]-----------XXXXX----------[]-----------XXXXX----------[]-----------XXXXX----------[]-----------XXXXX----------[]-----------XXXXXX---------[]-----------XXXXX----------[]-----------XXXXX----------[]-----------XXXXX----------[]-----------XXXXX----------[]-----------XXXXX----------[]-----------XXXXX----------[]-----------XXXXX----------[]-----------XXXXX----------[]-----------XXXXX----------[]--------------------------[]-----------XXXXXX---------<>-----------XXXXXX---------[]-----------XXXXX----------[]-----------XXXXXX---------<>-----------XXXXX----------[]-----------XXXXX----------<>----<>-----XXXXXX---------<>-----------XXXXX----------[]-----------XXXXXX---------<>-----E------XXXXX---------[]---------
-----------E--E--[]----[]----[]--------E--E--[]-------E------------------[]--------------------------[]--------------------------[]-----------------------E--[]------------------E-------[]--------------------------[]--------------------------[]--------------------------[]--------------------------[]--------------------------[]--------------------------[]--------------------------[]--------------------------[]--------------------------[]--------------------------[]--------------------------[]--------------------E-----[]-----------------------E-EE-----E-EE------------E-EE--[]----[]--------------E--E--[]----X---------------------[]------------------E-------[]--------------------------[]-----------------------E--[]--------------------------[]--------------------------[]--------------------------[]--------------------------[]--------------------------[]--------------------------[]--------------------------[]--------------------------[]--------------------------[]--------------------------[]--------------------------[]--------------------------[]--------------------------[]--------------------E-----[]--------------------------[]--------------------------[]--------------------------[]--------------------------[]--------------------------[]--------------------------[]----[]--------------------[]--------------------------[]--------------------------[]--------------------------[]---------
XXX-----XXXXXXXXXXXXXXXXXXXX-XXX---XXXXXXXXXXXXXXXXXXXXXX---------XXXXXXXXXXXXXXXXXX----------XXXXXXXXXXXXXXXXXX----------XXXXXXXXXXXXXXXXXX----------XXXXXXXXXXXXXXXXXXX---------XXXXXXXXXXXXXXXXXX----------XXXXXXXXXXXXXXXXXX---------XXXXXXXXXXXXXXXXXXX---------XXXXXXXXXXXXXXXXXXX----------XXXXXXXXXXXXXXXXXX----------XXXXXXXXXXXXXXXXXX----------XXXXXXXXXXXXXXXXXX-----------XXXXXXXXXXXXXXXXX----------XXXXXXXXXXXXXXXXXXX---------XXXXXXXXXXXXXXXXXX----------XXXXXXXXXXXXXXXXXX----------XXXXXXXXXXXXXXXXXXXX-------XXXXXXXXXXXXXXXXXXXXXXXXXXXXXXXXXXXXXXXXXXXXXXXXX-------XXXXXXXXXXXXXXXXXXXXX-------XXXXXXXXXXXXXXXXXXX----------XXXXXXXXXXXXXXXXXX--------XXXXXXXXXXXXXXXXXXXX----------XXXXXXXXXXXXXXXXXX----------XXXXXXXXXXXXXXXXXX----------XXXXXXXXXXXXXXXXXX-----------XXXXXXXXXXXXXXXXX----------XXXXXXXXXXXXXXXXXX-----------XX--XXXXXXXXXXXXX-----------XXXXXXXXXXXXXXXXX----------XXXXXXXXXXXXXXXXXX-----------XXX-XXXXXXXXXXXXX----------XXXXXXXXXXXXXXXXXX-----------XXXXXXXXXXXXXXXXX----------XXXXXXXXXXXXXXXXXX----------XXXXXXXXXXXXXXXXXX----------XXXXXXXXXXXXXXXXXXX--------XXXXXXXXXXXXXXXXXXXXXX------XXXXXXXXXXXXXXXXXXX-----------X---XXXXXXXXXXXXX---------------XXXXXXXXXXXXX---------------XXXXXXXXXXXXX---------------XXXXXXXX-XXXX---------------XXXXXXXXXXXXX---------------XXXXXXXXXXXXXX----------X---XXXXXXX-XXXXX---------------XXXXXXXXXXXXX-----------X---XXXXXXXXXXXXXX--------------XXXXXXXXXXXXX
