--------------------------------------------------------------------------------------------------------------------------------------------------------------------------------------------------------------------------------------------------------------------------------------------------------------------------------------------------------------------------------------------------------------------------------------------------------------------------------------------------------------------------------------------------------------------------------------------------------------------------------------------------------------------------------------------------------------------------------------------------------------------------------------------------------------------------------------------------------------------------------------------------------------------------------------------------------------------------------------------------------------------------------------------------------------------------------------------------------------------------------------------------------------------------------------------------------------------------------------------------------------------------------------------------------------------------------------------------------------------------------------------------------------------------------------------------------
--------------------------------------------------------------------------------------------------------------------------------------------------------------------------------------------------------------------------------------------------------------------------------------------------------------------------------------------------------------------------------------------------------------------------------------------------------------------------------------------------------------------------------------------------------------------------------------------------------------------------------------------------------------------------------------------------------------------------------------------------------------------------------------------------------------------------------------------------------------------------------------------------------------------------------------------------------------------------------------------------------------------------------------------------------------------------------------------------------------------------------------------------------------------------------------------------------------------------------------------------------------------------------------------------------------------------------------------------------------------------------------------------------------------------------------------------------
----ooo-----------------------------------------------------ooo-------------------------ooo---------------------SSSSSSSSSSSSSSSS----------------ooo-------------------------ooo---------------------S---ooSSSSSSS-------------------oo--------------------------oo--------------------------oo--------------------------oo--------------------------oooS------------------------ooo-------------------------oo--------------------------oSSSSSSSSSS-----------------ooo---------------------------------------------------------------------------------ooo-------------------------oo--------------------------oo--------------------------oo--------------------------oo--------------------------oo--------------------------oo--------------------------oo--------------------------oo--------------------------oo--------------------------oo--------------------------oo--------------------------oo--------------------------oo--------------------------oo--------------------------ooo-------------------------oooo--------------------SSSSSSSSSSSSSSSSS---------------oo------------------------------------------------------oo--------------------------oo--------------------------oo--------------------------oo--------------------------oo--------------------------o---------------------------oo--------------------------oo--------------------------oo--------------------------oo--------------------------oo----------------------
---XXXXX----------------------------------------------------XXXX-----------------------XXXXX------------------------XX-------------------------XXXXX-----------------------XXXXX-----------------------XXXX------------------------XXXX------------------------XXXX------------------------XXXXX-----------------------XXXXX-----------------------XXXXX-----------------------XXXXX-----------------------XXXX-------------------------XXX-------------------------XXXX--------------------------------------------------------------------------------XXXX-------------------E--XXXXX------------------------XXXX------------------------XXXXX-----------------------XXXXX-----------------------XXXX------------------------XXXXX----------------------XXXXXX-----------------------XXXXX-----------------------XXXXX----------------------XXXXXX----------------------XXXXX-----------------------XXXXX------------------------XXXX------------------------XXXXX-----------------------XXXXX------------------------XXXX-------------------------X-------------------------XXXXX------------------------XXX-----------------------XXXXX--------------------E--XXXXX------------------------XXXX-----------------------XXXXXX----------------------XXXXX---------------------------------------------------XXXXX--------------------E---XXXX------------------------XXXX-----------------------XXXXX------------------------XXXX---------------------
-------------------------------------------------------------------------------------------------------------------------------------------------------------------------------------------------------------------------------------------------------------------------------------------------------------------------------------------------------------------------------------------------------------------------------------------------------------------------------------------------------------------------------------------------------------------------------------------------------------------------------------------------------------------------------------------------------------------------------------------------------------------------------------------------------------------------------------------------------------------------------------------------------------------------------------------------------------------------------------------------------------------------------------------------------------------------------------------------------------------------?-----------------------------------------------------------------------------------------------------------------------------------------------------------------------------------------------------------------------------------------------------------E------------------------------------------------------------------
-----------------------SSSSS------------------------SSSS---------------------SSSSSSS-----------------------SSSSS-----------ooo-----------SSS------------------------SSSS------------o-----------SSSS----------ooooo----------SSS---------oo------E------SSSS---------oooo----E------SSSS------------o-----------SSSS------------o-----------SSSS-----------oo-----------SSSS------------o-----------SSSS------------o-----------SSSS------------o------------SSS------------------------SQQQ---Q-------------------------------------------------SSS-----------------SSSS--SSSS-------------------------SSSS------------o-----------SSSS------------o-----------SSSS-----------ooo----------SSSS---------oo------E------SSSS-----------oo-----------SSSS------------------------SSS------------oo-----------SSSS----------ooo-----------SSSS-----------------E------SSSS---------oooo----E------SSSS---------oooo----E------SSS----------oooo-----------SSSS-----------oo-----------SSSS--------------E----------SSS------------------------SSSS-------------------------SSS------------o------------SSS-----------ooo--XXXS----?------------oooo----XX-----SSS------------ooo---ESS----SSS------------ooo---EXS----SSS-----------oooo---E-----SSSSS-----------ooo---XXS----SSS------------ooo---EXS----SSS----------oooo----XX-----SSS------------ooo---XXS----?--------------ooo---EXS----SSS----------ooooo---XX-----SSS-----------oooo---XX-----SSSS
----------------------------------------------------------------------------------------------------------------------------------------------------------------------------------------------------------------------------------------------------o---------------------------o-----------------------------------------------------------------------------------------------------------------------------------------------------------------------------------------------------------------------------------------------------------------------------------------------------------------------------------------------o-----------------------------------------------------------------------------------o-------------------------------------------------------o-----------------------------------------------------------------------------------o---------------------------o---------------------------o----------------------------------------------------------------------------<>---------------------------------------------------------------------------------------------------------------------o---------------------------o---------------------------o---------------------------o-------------------------------------------------------o--------------------------oo---------------------------o--------------------------ooo-------------------------oo---------------------------o--------------------------ooo------
-------------------------------------------------------------------------------------------------------------------S----SS---------------------o--------------------------------SS--------------------------SSSSSSS-------------------S-S-------------------------S-SSS-------------------------SS------------------------S-SS---------------------E----SS--------------------------SS--------------------------S----------------------S----SS----------------------------------------------------------------------------------------------------------------------------------------------------------------------SS----------------------------------------------------------------------------------S---------------------------S-------------------------------------------------------S---------------------------SS------------------------------------------------------S---------------------------S-------------------------S-SSS--------------------E----SS---------------------o-----S---[]---------------------S---------------------------------------------------------------------------------------------------------------S-----------------------------------------------------------------------------------------------------------------------------------------------------------------------S-----------------------------------------------------------------------------------------------------------------------------------
------------------E--S-----------o------------E---------------------------E---------------------------E-----------SS--SoS---------E--o--------------S---------E---------------SoS---------E--o------------SoS---Q-----E---------------SoS---------E---------------SoS---------E---------------SoS---------E---------------SoS---------E--o------------SoS---------E--o------------SoS---------E--o------------S-S---------E-----------SS--SoS---------E--o------------------------E-------------------------------------------------------E-----E--o----------------------------------------------E---------------SoS---------E---------------------------E---------------------------E---------------SoS---------E---------------S-S---------E---------------------------E-----------------S---------E---------------SoS---------E---------------------------E----------------oS---------E---------------S-S---------E---------------SoS---------E---------------SoS---------E--o--------------S----[]---E-----------------S---------E--o------------------------E--o------------------------E---------------------------------------------S---------E-----------------------------------------------------------------------------------E-------------------------------------------------------------------------S-----------------------------------------------------------------------------------------------------------------------------------
-----------------<>-----E--------------------<>-------SS-----------------<>--S---E?S-----------------<>-----ES?S-SSS--SSS--------<>------E?S-----------------<>------E?S-------SS--------<>------E?S--S---SSS--------<>------S?SXXS---SSS--------<>------E?X-SS---SSS--------<>------E?S-SS---SSS--------<>------E?SXXS---SSS--------<>------E?S-SS---SSS--------<>------E?S-------SS--------<>------E?S--S----SS--------<>------E?SSSSS--SSS--------<>------E?S-----------------<>------E?S-QQ------------------------------------------<>----<>------------------------XXXXXXX-----------------<>----------SS---SSS--------<>------E?S-----------------<>------E?S-----------------<>------E?SXXS---SSS--------<>------E?S-----------------<>------E?S-----------------<>-----E----------S---------<>------E?S--S---SSS--------<>------E?S-----------------<>------E??-------SS----XX--<>-X----E?--------SS----XX--<>-XX---E?XXSS---SSS--------<>------E-X-SS---SSS--------<>------E?S-SS--------------<>------ESS-------SS--------<>------E?S-----------------<>------E?S-----------------<>------E?S-------------XXX----XXX-----XX-----SS----XX--<>-XXX--XXXXX-----------XXX----XXX-----XX-----------XXX----XXX------------------XX--<>-XXX--X?-X------------XXX----XXX------------------XXX----XXX-----XX-----------XX-----XXX--XXX-------------XXX----XXX------------------XXX----XXX-----XX-----------XX-----XXX--XXX-------------XX-----XX------
-----------------[]----<>--------------------[]--------------------------[]--------------------------[]----<>--------------------[]--------------------------[]--------------------------[]------------o-------------[]------------o-------------[]------------o-------------[]--------------------------[]------------o-------------[]--------------------------[]--------------------------[]------------o-------------[]--------------------------[]--------------------------[]------------------------------------------------------[]----[]--------XX------------------------o-------------[]-----E------o-------------[]--------------------------[]------------o-------------[]------------o-------------[]-----E------o-------------[]--------------------------[]----<>------o-------------[]------------o-------------[]------------o-------------[]------------o-------------[]-----------Eo-------------[]--------------------------[]--------------------------[]--------------------------[]--------------------------[]-----E--------------------[]--------------------------[]-----E-----Eo--------------E------------o-------------[]------------o--------------E------------o--------------E------------o-------------[]------------o--------------E------------o--------------E------------o-------------XX-----------Eo--------------E-----------Eo--------------E------------o-------------<>--------------------------<>-----E---
-----------------[]----[]--------------------[]-------------XXX----------[]--------------------------[]----[]------XX------------[]------------XXX-----------[]-----------XXXX-----------[]-----------XXXX-----------[]-----------XXXXX----------[]-----------XXXXX----------[]-----------XXXX-----------[]-----------XXXXX----------[]-----------XXXX-----------[]-----------XXXX-----------[]-----------XXXXX----------[]------------XX------------[]--------------X-----------[]-------------------------<>----<>---------------------[]----[]-------XXX-----------------------XXXXX----------[]----<>-----XXXXX----------[]-----------XXXX-----------[]-----------XXXXX----------[]-----------XXXXX----------[]-----------XXXXX----------[]-----------XXXXX----------[]----[]-----XXXXX----------[]-----------XXXXX----------[]-----------XXXXXX---------[]-----------XXXXX----------[]-----------XXXXX----------[]-----------XXXX-----------[]----<>-----XXXX-----------[]-----------XXXXX----------[]------------XXX-----------[]--------------------------[]--------------------------[]-----------XXXXX----------<>-----------XXXXX----------[]-----------XXXXXX---------<>-----------XXXXXX---------<>-----------XXXXXX---------[]-----------XXXXXX---------<>-----------XXXXX----------<>-----E-----XXXXX----------[]-----------XXXXXX---------<>-----------XXXXXX---------<>-----------XXXXX----------[]-----------XXXXX----------[]----<>---
----------EE--E--[]----[]--------------E--E--[]--------------------E-E---[]--------------------E--E--[]----[]--------------------[]--------------------E-----[]--------------------------[]--------------------------[]--------------------------[]--------------------------[]--------------------------[]--------------------------[]--------------------------[]--------------------------[]--------------------------[]--------------------------[]--------------------E-----[]--------------EE-----E-E-[]----[]-E-------------E--E--[]-E--[]-----------------E-------E-------------------E--[]----[]------------E-------[]--------------------------[]--------------------------[]--------------------------[]--------------------------[]-----------------------E--[]----[]--------------------[]--------------------------[]-----------------------E--[]--------------------------[]--------------------------[]--------------------------[]----[]--------------------[]----------------------E---[]------------------E-E-----[]--------------------E-----[]--------------------------[]--------------------------[]--------------------------[]--------------------------[]--------------------------[]--------------------------[]--------------------------[]--------------------------[]--------------------------[]--------------------------[]--------------------------[]--------------------------[]--------------------------[]----[]---
XXXX--XXXXXXXXXXXXXXXXXXXXXXXXXX----XXXXXXXXXXXXXXXXXXXXXXX------XXXXXXXXXXXXXXXXXXXXX-------XXXXXXXXXXXXXXXXXXX---------XXXXXXXXXXXXXXXXXXXX--------XXXXXXXXXXXXXXXXXXX----------XXXXXXXXXXXXXXXXXX----------XXXXXXXXXXXXXXXXXX----------XXXXXXXXXXXXXXXXXX----------XXXXXXXXXXXXXXXXXX----------XXXXXXXXXXXXXXXXXX----------XXXXXXXXXXXXXXXXXX----------XXXXXXXXXXXXXXXXXX----------XXXXXXXXXXXXXXXXXX----------XXXXXXXXXXXXXXXXXX---------XXXXXXXXXXXXXXXXXXXXXX------XXXXXXXXXXXXXXXXXXXXXXXXXXXXXXXXXXXXXXXXXXXXXXXXXXXXXXXXXXXXXXXXXXXXXXXXXXXXX----------XXXXXXXXXXX---XX----------XXXXXXXXXXXXXXXXXX----------XXXXXXXXXXXXXXXXXX----------XXXXXXXXXXXXXXXXXX----------XXXXXXXXXXXXXXXXXX----------XXXXXXXXXXXXXXXXXX----------XXXXXXXXXXXXXXXXXX----------XXXXXXXXXXXXXXXXXX----------XXXXXXXXXXXXXXXXXX----------XXXXXXXXXXXXXXXXXX----------XXXXXXXXXXXXXXXXXX----------XXXXXXXXXXXXXXXXXX-----------XXXXXXXXXXXXXXXXX----------XXXXXXXXXXXXXXXXXX----------XXXXXXXXXXXXXXXXXX----------XXXXXXXXXXXXXXXXXXX--------XXXXXXXXXXXXXXXXXXXXX------XXXXXXXXXXXXXXXXXXXXXX-------XXXXXXXXXXXXXXXXXXX-----------X---XXXX----XXXXX-----------XX--XXXXXXXXXXXXX---------------XXXXXXXXXXXXX---------------XXXXXXXXXXXXX---------------XXXXXXXXXXXXX---------------XXXXXXXX-XXXX---------------XXXXXXXXXXXXX---------------XXXXXXXX-XXXX---------------XXXXXXXXXXXXX-----------X---XXXXXXXXXXXXX---------------XXXXXXXXXXXXX-----------XX--XXXXXXXXXXXXX
