--------------------------------------------------------------------------------------------------------------------------------------------------------------------------------------------------------------------------------------------------------------------------------------------------------------------------------------------------------------------------------------------------------------------------------------------------------------------------------------------------------------------------------------------------------------------------------------------------------------------------------------------------------------------------------------------------------------------------------------------------------------------------------------------------------------------------------------------------------------------------------------------------------------------------------------------------------------------------------------------------------------------------------------------------------------------------------------------------------------------------------------------------------------------------------------------------------------------------------------------------------------------------------------------------------------------------------------------------------------------------------------------------------------------------------------------------------
-------------------------------------------------------------------------------------------------------------------------------------------------------------------------------------------------------------------------------------------------------------------------------------------------------------------------------------------------------------------------------------------------------------------------------------------------------------------------------------------------------------------------------------------------------------------------------------------------------------------------------------------------------------------------------------------------------------------------------------------------------------------------------------------------------------------------------------------------------------------------------------------------------------------------------------------------------------------------------------------------------------------------------------------------------------------------------------------------------------------------------------------------------------------------------------------Q---------------------------------------------------------------------------------------------------------------Q--------------------------------------------------------------------------------------------------------------------------------------------
---------------------------------------------------------------------------------------------------------------------------------------------------------------------------------------------------------------------------------------------------------------------------------------------------------------------------------------------------------------------------------------------------------------------------------------------------------------------------------------------------------------------------------------------------------------------------------------------------------------------------------------------------------------------------------------------------------------------------------------------------------------------------------------------------------------------oo---------------------------------------------------------------------------------------------------------------------------------------------------------------------------------------------------------------------------------------------------------------------------------------------------------------------------------------------------------------------------------------------------------------------------------------------------------------------------------------------------------------------------------------------------------------------------------------------------------------------------------
---------------------------------------------------------------------------------------------------------------------------------------------------------------------------------------------------------------------------------------------------------------------------------------------------------------------------------------------------------------------------------------------------------------------------------------------------------------------------------------------------------------------------------------------------------------------------------------------------------------------------------------------------------------------------------------------------------------------------------------------------------------------------------------------------------------------XXX--------------------------------------------------------------------------------------------------------------------------------------------------------------------------------------------------------------------------------------------------------------------------------------------------------------------------------------------------------------------------------------------------------------------------------------------------------------------------------------------------------------------------------------------------------------------------------------------------------------------------------
--------------------------------------------------------------------------------------------------------------------------------------------------------------------------------------------------------------------------------------------------------------------------------------------------------------------------------------------------------------------------------------------------------------------------------------------------------------------------------------------------------------------------------------------------------------------------------------------------------------------------------------------------------------------------------------------------------------------------------------------------------------------------------------------------------------------------------------------------------------------------------------------------------------------------------------------------------------------------------------------------------------------------------------------------------------------------------------------------------------------------------------------------------------------------------------------------------------------------------------------------------------------------------------------------------------------------------------------------------------------------------------------------------------------------------------------------------
-------------------X--------------------------------------------------------------SS---------QQQQ---------------------------SSSSS-----------------------------------------------SSS--------------SSS------------------------SSSS---------Q-Q-------------------------SS?SSSS---------SSS---------Q--E-----------SSSS---------QQQ------------SSQ-----------SSSS-----------------------Q-Q----------------------------------------SSSS-----------------------SSSSS---------------------------S---------------------------S---------QQ------------------------?-Q--E----------SSSSS---------Q-QQ-------------------------------------------------------------------SSSS---------Q--E--------------S---------QQ?SSSS---------S--------------SSSSS----------Q------------SS----------SSQQ-----------------------SSSSS---------QQ-------------SSSS---------Q-Q---------------------------?SSSS---------------------------S--------SSS-------------E------------SSS---------?-?E----------SSSSS---------Q-Q-------------------------?-?Q---------SSSSSS-------------------------SSS-------S-QSQ-----------------------------------------------------------------------Q---------?---------------SSS--------SQQQ-------------SQS-------------------------------------?--E------------------------?--E----------------------------------------SSQ-------------------------------------SS?SSSS---------------------------------------Qo--------Q------S-------SSS-
----------------------------------------------------------------------------------------------------------------------------------------------------------------------------------------------------------------------------------------------------------------------------------------------------X-X-----------------------------------------------------------------------------------------------------------------------------------------------------------------------------------------------------------------------------------------------------------X---------------------------XX-----------X----------------------------------------------------------------------X------------------------------------------------------------------------------------------------------------------------------------------------------------------------------------------------------------------------------------------------------------------------------------XXXXXX-------------------------------------XX-------------XXX---------------------------------------------------------------------------------------------------------------------------------------------------------------------------------------------------------------------------XXXXX--------------------------XXX------------------------------------------------------------------X------------------------------------------------------------------------------------
----------------------------------------------------------------------------------------------------------------------------------------------------------------------------------------------------------------------------------------------------------------------------------------------------------------------E-------------------------------------------------------------------------------------------------------------------------------------------------------------------------------------------------------------------------------------------Q-------------------------------------------------------------------------------------------------------------------------------------------------------------------------------------------------------------------------------------------------------------------------------------------------------------------------------------------------------------------------------------------------------Q---------------------------------X---------------------Q-------------------------------------------------------------------------------------------------------------------------------E-----------------------------------------------------------------------------------E----------------------------------------------------------------------------------XXX-XXX----------XXX---------------------------ooo-------------------------------------------------------------
---------------------------------E--oo----------------------E-------------------E--------------------------------------------------------------------------------E------------------------E--E----------E-------------E---------------E--------------E------------------------------E---------------------------E----<>------------------E-------------------------------------------------------E------------------------E---------------------------E-----------E------------------E------------------------------E--o--E------------------E--?-----E-E-------------E---------------E--------------E------------E--------------E----------E-------------E-----------E---------------E------------------------------E--------E------------------E--------E---------------E--E----------E-------------E--S--------E------------------E----------E-------------------------E----------------------------------------------E--------E-E-------------E-----E-----E-------------------------------E--------------E------------E-----------E-------------E-------------------E--o---------------------E----------------------------------------------------E----------<>---------------E--S---------------------------E--------E--------------E---E-------<>-------------------------------------------E--o------------------------E-----------------------------------------------------------------------------------------E---------E--------------E------
--------------------------------<>-----------------E-------<>------------------<>-----E----E--QQQQ---------------QQ----Q--Q-QQQQ---Q-----QQQ--------------------<>---QQQ---------S-------<>-<>--------E<>------------<>-----E-----E--<>---QQQQ------<>----E------------------------<>-----E-E--E?SQQQ----<>----<>----[]----E--Q---------<>---QQQ-----------------E-------QQQ--E---E---QQQQ------<>----QQ-----------------<>-----E--S----E---QQQ------<>------E?S-<>----Q--Q-QQ------<>--------E---------------E----<>----<>----E?--------E--<>-------<><>--E?SQQQ----<>-----E-----E--<>--SQQQ-------<>---QQQ--E--<>----Q--------<>---QQQ--E<>---QQQ------<>-----E----<>----E?SQQ-----<>-----E-----E----E?-QQQ-------<>----QQ-<>----E------------<>----QQ-<>----E-Q-------<>-<>---QQ?--E<>----Q-------<>-----E----<>----Q--Q---------<>--------E<>-----QQQ----E--<>-------<>----E--QQQ------------QQQ--E--<>---QQQ-------<>---QQQ-<><>--E--QQQ----<>----<>----<>----E?SQQQ-----E-----E-----E--<>---QQQQ---Q--<>---QQQ--E--<>--SQQQ----<>-------??---<>----Q--------E----<>-----E-------QQ--------<>---QQQ--E-----------------------------E------------<>-----E----[]----E--Q------<>-----E----------Q------------<>-------<>-------------<>--<>-------[]----?-QQQQ------------QQ-------E--S-------<>------Q??-----------------<>-----E------------------------------Q-------------------Q------------E------------<>----<>-----E--<>---QQQQ------<>------
--------------------------------[]----------------<>------E[]------E-----------[]----<>---------------------------------------------------------XXXX------------[]-----------------------[]-[]-------<>[]------------[]----<>----<>--[]-------------[]----E---E--------------------[]----<><>------------[]----[]----[]-----------------[]----------------------<>-----------<>--<>-------------[]-----------------------[]----<>-----E<>------------[]----------[]-----------------[]-------<>--------------<>----[]----[]-------------<>--[]-------[][]------------[]----<>----<>--[]-------------[]-------<>--[]-------------[]-------<>[]------------[]----<>----[]<>------------[]----<>----<>-----------------[]-------[]-----------------[]-------[]--------------[]-[]-------<>[]------------[]----<>----[]-----------------[]-------<>[]-----------<>--[]-------[]--------------------------<>--[]-------------[]-------[][]------------[]----[]----[]<>------------<>----<>----<>--[]-------------[]-------<>--[]----------[]------------[]------------<>----[]----<>-----------------[]-------<>-------E-------------------E<>------------[]----<>----[]--------------[]----<>-----------------------[]-------[]-------------[]--[]-E-----[]------------------E-----------<>----------[]--------------------------[]----<>-------------------------------------------------------------E<>------------[]----[]----<>--[]-------------[]------
--------------------------------[]----------------[]-----<>[]------------X-----[]----[]-------------------------------------------------------------------------[]-----------------------[]-[]-------[][]------------[]----[]----[]--[]-------------[]---<>------------------------[]----[][]------------[]----[]----[]-----------------[]----------------------[]-----------[]--[]-------------[]-----------------------[]----[]----<>[]------------[]-<>-------[]-----------------[]-------[]--------------[]----[]----[]-------------[]--[]-------[][]------------[]-<>-[]----[]--[]-------------[]-------[]--[]-------------[]-------[][]------------[]----[]----[][]------------[]----[]----[]-----------------[]-------[]-----------------[]-------[]--------------[]-[]-------[][]------------[]----[]----[]-----------------[]-------[][]-----------[]--[]<>-----[]-----------------<>-------[]-E[]-------------[]-------[][]------------[]----[]----[][]------------[]----[]----[]--[]-------------[]-------[]--[]----------[]------------[]------------[]----[]----[]-----------<>----[]-------[]------<>------------------<>[]------------[]----[]----[]--------------[]-<>-[]-----------------------[]-------[]-------------[]--[]<>-----[]--<>-------------<>-----------[]----------[]--------------------------[]----[]------------------------------------------<>----------------<>[]------------[]----[]----[]--[]-------------[]------
--------------E-EE----EE-E------[]------E---------[]-----[][]-E-------E-EX-E---[]----[]-----------E-EE----------------------------------------------------EE----[]----E------------E--E--XX-[]-E-----[][]---------E--[]----[]----[]--[]-------EE----[]-E-[]--X---E-----------E-E---[]----[][]---------E-EXX----[]----[]--------EE-EE----[]---------EE-E---------[]-----E-EE--[]--[]-------E-EE--[]-E--E-----EE---E-EE-E--[]----[]----[][]---------E--[]-[]-------[]--------E--E--E--[]-E-----[]--E-E------E--[]----[]----[]---E-----E-E-[]--[]-------[][]------E--E--[]-[]-[]----[]--[]-------E-E---[]----E--[]--[]-------EE-E--[]-E--E--[][]---------E--[]----[]----[][]---------E-E[]----[]----[]-----------E-EE--[]-E--E--[]--------E--E--E--[]---E---[]-----------E--[]-[]-------[][]------E-EE--[]----[]----[]--------E--E-----[]-E-E---[][]---------E-[]--[][]-E---[]-----------E-EE--[]-------[][][]-------E-EE--[]-E--E--[][]------E-EE--[]----[]----[][]--------EE-EXXE---[]----[]--[]-------E-EE--[]-EE-E--[]-E[]------EE--[]-E----------[]-E-------E--[]----[]----[]---E-EE-E--[]----[]-E-EE--[]------[]-----EE----EE--E--[][]-E------EE-E[]----[]----[]-------EE--E--[]-[]-[]--------E-----E--E-EE--[]-E-----[]--EE-----E---[]--[][]-----[]--[]-------E-E---[]-----------[]------EE--[]----------X---EE-E--E--E--[]----[]--------------------E-----EE-E------------[]----------------[][]--------EE--[]----[]----[]-E[]----E-E---E--[]-E--E-
XXXXXXXXXXXXXXXXXXXXXXXXXXXXXXXXXXXXXXXXXX---XXXXXXXXXXXXXXXXXXXXXXXXXXXXXXXXXXXXXXX-XXXXXXXXXXXXXXXXXXXXXXXXXXXXXX---XXXXXXXXXXXXXXXX-XXXXXXXXXX----XXXXXXXXXXXXXXXXXXXXXXXXXXXXXXXXXXXXXXXXXXXXXXX-XXXXXXXXXXXXXXXXXXXXXXXXXXXXXXXXXXXXXXXXXXXXXXXXXXXXXXX-XXXXXXX-XXXXXXXXXXXXXXXXXXX-XXXXXXXXXXXXXXXXXXXXXXXXXXX-XXXXXXXXXXXXXXXXXXXXXXXXXXXXXXXXXXXXXXXXXXXXXXXXXXXXXXX-XXXXXXXXXXXXXXXXXXXXXXXXXXXXXXXXXXXXXXXXXXXXXXXXXXXXXXX-XXXXXXXXXXXXXXXXXXXXXXXXXXX-XXXXXXXXXXXXXXXXXXXXXXXXXXXXXXXXXXXXXXXXXXXXXXXXXXXXXXX-XXXXXXXXXXXXXXXXXXXXXXXXXXX-XXXXXXXXXXXXXXXXXXXXXXXXXXXXXXXXXXXXXXXXXXXXXXXXXXXXXXX-XXXXXXXXXXXXXXXXXXXXXXXXXXX-XXXXXXXXXXXXXXXXXXXXXXXXXXXXXXXXXXXXXXXXXXXXXXXXXXXXXXX-XXXXXXXXXXXXXXXXXXXXXXXXXXX-XXXXXXXXXXXXXXXXXXXXXXXXXXX-XXXXXXXXXXXXXXXXXXXXXXXXXXX-XXXXXXXXXXXXXXXXXXXXXXXXXXX-XXXXXXXXXXXXXXXXXXXXXXXXXXX-XXXXXXXXXXXXXXXXXXXXXXXXXXX-XXXXXXXXXXXXXXXXXXXXXXXXXXX-XXXXXXXXXXXXXXXXXXXXXXXXXXX-XXXXXXXXXXXXXXXXXXXXXXXXXXXXXXXXXXXXXXXXXXXXXXXXXXXXXXXXXXXXXXXXXXXXXXXXXXXXXXXXXXX-XXXXXXXXXXXXXXXXXXXXXXXXXXXXXXXXXXXXXXXXXXXXXXXXXXXXXXX-XXXXXXXXXXXXXXXXXXXXXXXXXXX-XXXXXXXXXXXXXXXXXXXXXXXXXXX-XXXXXXXXXXXXXXXXXXXXXXXXXXX-XXXXXXXXXXXXXXXXXXXXXXXXXXXXXXXXXXXXXXXXXXXXXXXXXXXXXXX-XXXXXXXXXXXXXXXXXXXXXXXXXXX-XXXXXXXXXXXXXXXXXXXXXXXXXXXXXXXXXXXXXXXXXXXXXXXXXX-XXXX-XXXXXXXXXXXXXXXXXXXXXXXXXXXXXX---------XXXXXXXXXXXXXXXXXXXXXX--XXXXXXXXXXXXXX-XXXXXXXXXXX--XXXXXXXXXXXXXXXXXXXX-XXXXXXXXXXXXXXXXXXXXXXXXXXX
