--------------------------------------------------------------------------------------------------------------------------------------------------------------------------------------------------------------------------------------------------------------------------------------------------------------------------------------------------------------------------------------------------------------------------------------------------------------------------------------------------------------------------------------------------------------------------------------------------------------------------------------------------------------------------------------------------------------------------------------------------------------------------------------------------------------------------------------------------------------------------------------------------------------------------------------------------------------------------------------------------------------------------------------------------------------------------------------------------------------------------------------------------------------------------------------------------------------------------------------------------------------------------------------------------------------------------------------------------------------------------------------------------------------------------------------------------------
-----------------------------------------------------------------------------------------------------------------------------------------------------------------------------------------------------------------------------------------------------------------------------------------------------------------------------------------------------------------------------------------------------------------------------------Q---------------------------------------------------------------------------------------------------------------------------------------------------------------------------------------------------------------------------------------------------------------------------------------------------------------------------------------------Q----------------------------------------------------------------------------------------------------------------------------------------------------------------------------------------------------------------------------------------------------------------------------------------------------------------------------------------------------------------------------------------------------------------------------------------------------------------------------------------------------------------------------------------------------------------------------------------------------------------------------------------------------------------------
-------------------------------------------------------------------------------------------------------------------------------------------------oo------------------------------------------------------------------------------------------------------------------------------------------------------------------------------------------------------------------------------oo---------------------------------------------------------------------------------------------------------------------------------------------------------------------------------------------------------------------------------------------------------------------------------------------------------------------------------------------------------------------------------------------------------------------------------------------------------------------------------------------------------------------------------------------------------------------------------------------------------------------------------------------------------------------------------------------------------------------------------------------------------------------------------------------------------------------------------------------------------------------------------------------------------------------------------------------------------------------------------------------------------------------------------------------------------------------
-------------------------------------------------------------------------------------------------------------------------------------------------XXX----------------------------------------------------------------------------------------------------------------------------------------------------------------------------------------------------------------------------XXXX--------------------------------------------------------------------------------------------------------------------------------------------------------------------------------------------------------------------------------------------------------------------------------------------------------------------------------------------------------------------------------------------------------------------------------------------------------------------------------------------------------------------------------------------------------------------------------------------------------------------------------------------------------------------------------------------------------------------------------------------------------------------------------------------------------------------------------------------------------------------------------------------------------------------------------------------------------------------------------------------------------------------------------------------------------------------
--------------------------------------------------------------------------------------------------------------------------------------------------------------------------------------------------------------------------------------------------------------------------------------------------------------------------------------------------------------------------------------------------------------------------------------------------------------------------------------------------------------------------------------------------------------------------------------------------------------------------------------------------------------------------------------------------------------------------------------------------------------------------------------------------------------------------------------------------------------------------------------------------------------------------------------------------------------------------------------------------------------------------------------------------------------------------------------------------------------------------------------------------------------------------------------------------------------------------------------------------------------------------------------------------------------------------------------------------------------------------------------------------------------------------------------------------------
-------Q-Q-Q------------------------------------------------------------------------o------QQQQQQ-----------SS-----------?--E------------------------QQQ--------------------------------------------o--------Q-QQ------------------------?--E--------SSSSSS--------Q-QQQ-QQS----------Q----------Q-Q----------------------------------------SSSS--------------SSS----SQSSSS--------------------------------------?--E------------SSS-----------------------------------?-QQQ----------------------------E--------SSSSSSS-------Q-QQQ-------------------------?---------------SSS-------------------------SSS-----------Q------------SSS----------------------SSSSSSS---------?--E-----------SSSS---------?-----------SSSSSS----------------------------------------?-S-S------SSSSSS------------------------SSSS-------------------------SQQ---------?--E------------------------QQQQ-----------QQQ----------?-?----------SSSSSS-----------------------SSSSSo------?QQQQQ-----------SSSS---------?S?--------------Q----------Q-Q-------------------------?--------------SSSS---------------------------S-----------?---------------------------------------------------------------------------------Q----SS---------------------------------SSSSSSS---------------------------S-------------------------QQ---------SSS?SS-------SSSSSS----------------------------S------------SSSSS---------------------------------------------------E-----------SSSS
------------------------------------------------------------------------------------------------------------------------------------------------------------------------------------------------------------------XX-----------------------XXXXXX-----------------------------------------------------------------------------------------------------------------------------------------------------------------------------------------------------------------------------------------------------------------------------------------------------E---------------------------------------------------------------------------------------------------------------------------X--------------------------------------------------------------------------------------------------------------------------------------------------------------------XXXXXX-----------------------------------------E-------------------------------------------------------------------XX----------------------------------------------------------------------------------------------------------------------------------------------------------------------------------------------------------------------------------------------------------------------------------------------------------------------------------------------------------------------------------------------------------------------------------------------------------------------------
----------------------------------------------------------------------------------------------------------------------------------------------------------------------------------------------------------------------------------------------Q-------------------------------------------------------------X-------------------------------------------------------------------------------------------------------------------------------------------------------X--S-----------------------------------------------------------------------------<>---------------------------------------------------------------------------------------------------------------------------------------------------------------------------------------------------------------------------------------------------------------------------------------------------Q------------------------------------------<>-------------------------------------------------------------------Q---------------E-------------------------------------------------------------------------------------------------------------------------------------------------------------------------------------------------------------------------------------------------------------------------------------------------------------------------------------------------------------------------------------------------------------------------------------------------------------
--E-----------------------------------------------------------------------------E--o---------------------E------------------------------E--o--------------------------------E-------------------E-------E----------------E--?---------E--------------E---------------------------E---------------------------E------------------------E-----E--o------E--------------E--------------------------------------E-------------------E-------E-------------E--E--------E---------------------------E---------------E------------------------------E-------[]---------------E--S------------------------------E------------------------E------------------------E---------------------------E-----E--o------------------------------------------------------------E---------------------------E-------------E---------------------------E---------------------------E--E--------E------------------E-------[]---------------E--E------------------------E--E---------------------------E-------<>---------------E-----------E------------------E--------E---------------E-------------------------------------------------------------------------ooo---------o---------------E---------------------E---------------------------------------------------------------------------------------------------------------E---------------------------E----------------------------------------------E----------E----------------E--------E---------------------E---
-<>----S?-QQQ--------------Q----------------------------------------------E----<>----------QQQQQQQ------<>-------------E-SQQQ-----S----<>----------QQQQQQ-------<>--------E<>-------------E----<>-----E<>--E?-QQQ-------<>--------E--<>--SQQQ-------<>---QQ?------QQQQQ---------<>---QQQ--E----Q--QQQQ---Q--<>-----Q-----------------<>----<>--S-----<>---QQQ-------<>---QQQ------------------------------E<>---?S--------E----<>-----E<>----Q-------<>-<>-------<>----E?SQQQ----------------<>------Q-------<>-----E-----E---E---QQQQ------<>---QQQ-[]----E-S-------<>-----E---------------------E----<>-----E---E-------------<>--------E--<>---Q-Q----<>-----E----<>-----?S-------<>----<>------------S---------------QQQ-------E--QQQ--------E---QQQ--E<>-----QQQ------------------<>------------<>-----------E----E--Q------<>-----------E------SQQQ----<>-<>-------<>----E--QQQ-------<>---QQQ-[]---E----------<>-<>---S?S----E----QQ------<>-<>---E??--E----E?SQQQ-------<>-------[]----E?S-------<>----------<>----E?-QQQ-------<>---QQQ-<>-----?S-------<>-------------E------------<>-----E-----E--XX----------Q-Q------------X------------E-----------------<>--------------------<>---E---QQQ------------QQ-----------------------------------------------E-----E-----E----Q--QQQ----------------<>-----------------<>-------<>---------------E-----E-----E----E--QQQQ------<>---QQQ--E<>---------------<>-------<>------S--------E----<>---
-[]----------------------------------------E-----------------------E-----<>----[]-----------------------[]--------E--------------------[]-----------------------[]-------<>[]------------<>----[]----<>[]---------------[]-------<>--[]-------------[]--------------------------[]-------<>-----------------[]-----------------------[]----[]--------[]-------------[]--------------------------<>-------<>[]------------<>----[]----<>[]------------[]-[]-------[]------------------E-------[]--------------[]----<>----<>--<>-------------[]-------[]--------------[]----<>--------------E-----<>----[]----<>--<>-------------[]---E---<>--[]----------[]----<>-XX-[]--------------[]----[]-----E---E-----------------------------------------<>-------<>[]--------------------------[]------------[]----------<>--------------[]-----E----<><>-E----------[]-[]-------[]-----------------[]-------[]--<>----------[]-[]--------E<>------------[]-[]-------<>-----------------[]-------[]--------------[]-----E----[]-----------------[]-------[]--------------[]-----------E<>------------[]----<>----<>-XXX-----------------------XXX-----------<>-----------E-----[]--------------------[]--<>-------------<>-------------------------------E-------------------<>----<>----<>--------------------------[]-----------------[]-------[]--------------------<>----<>-----------------[]-------<>[]---------------[]--E----[]-------------E<>----[]---
-[]---------------------------------------<>----------------------<>-----[]----[]-----------------------[]-------<>--------------------[]-----------------------[]-------[][]------------[]----[]----[][]---------------[]-------[]--[]-------------[]--------------------------[]-------[]-----------------[]-----------------------[]----[]----<>--[]-------------[]--------------------------[]-------[][]------------[]----[]----[][]------------<--[]-------[]-----------------<>-------[]-E------------[]----[]----[]--[]-------------[]-------[]--------------[]----[]-------------<>-----[]----[]----[]--[]-------------[]--<>---[]--[]----------[]----[]--X-[]--------------[]----[]----<>--<>----------------------<>-----------------[]-------[][]------------------------<>[]------------[]-<>-------[]--------------[]----<>----[][][]----------[]-[]-------[]-----------------[]-------[]--[]----------[]-[]-------<>[]------------[]-<>-------[]-----------------[]-------[]--------------[]----<>----[]-----------------[]-------[]--------------[]-<>-------<>[]------------[]----[]----[]-XXX----------------------XXXX-----------[]-----------------[]--------------------[]--[]-------------[]------------------------------<>----------E--------[]----[]----[]--------------------------[]-----------------[]-------[]---------------?----[]----[]-----------------[]-------[][]---------------[]-<>----[]------------<>[]----[]---
-[]-------------EE--------E------EE-E-E-E-[]----------------------[]--E--[]----[]---------------E-EE----[]-------[]----------EE-EE-E---[]-----------------EE-E--[]-E--E--[][]--------EE-E[]----[]----[][]--------EE-----[]-E-----[]-E[]------EE-E---[]------------E----EE-EE----[]-------[]----------EE-EE--[]----------------EE--E--[]-E--[]----[]--[]-------EE-E--[]----E----------E-E--EE----[]-E-EE--[][]---------E-EXXE---[]----[][]--------E------[]-------[]-----------E-EE--[]-E-----[][]--------EE--[]----[]----[]--[]-------EE----[]-------[]-------EE-----[]----[]--------E----[]--E--[]-E--[]----[]--[]-------EE----[]--[]---[]--[]----E-EE--[]----[]-XX-[]-----E-----E--[]-E--[]----[]--[]----------------------[]-----------EE-E--[]--E-E--[][]--------EE-EE-E---E-----[][]-E-----E-E--[]-[]-------[]-----------E--[]----[]----[][][]------EE-EXX-[]-------[]-----------EE----[]-------[]--[]----E--E--[]-[]-------[][]---------E--[]-[]-------[]-----------E-----[]-E-----[]--E--E-----E--[]----[]----[]-----------E-EE--[]----E--[]----E------E--[]-[]-------[][]--------EE--[]----[]----[]-XXX-------------EE-------XXXX-E---------[]-----------------[]------------EE---X--[]--[]-------EE----[]-E-------------E-EE-EE--E-E---[]---------------EE--[]----[]----[]-----------E--E-----E-----[]--------E--E-EE--[]-E-E---[]--EE-------E-EE-----[]----[]-----------EE----[]-------[][]-E------E--E---[]-[]----[]-----E-E---E[][]-E--[]---
-XXXXXXXXXXXXXXXXXXXXXXXXXXXXXXXXXXXXXXXXXXXXXXXXXXXXXXXXXXXXX--XXXXXXXXXXXXXXXXXXXXXXXXXXXXXXXXXXXXXXXXXXXXXXXXXXXXXXXXXXXXXXXXXXXXXXXXXXXXXXXXXXXXXXXXXXXXXXXXXXXXXXXXXXXXXXXXXXXXXXXXXXXXXXXXXXXX-XXXXXXXXXXXXXXXXXXXXXXXXXXX-XXXXXXXXXXXXXXXXXXXXXXXXXXXXXXXXXXXXXXXXXXXXXXXXXXXXXXX-XXXXXXXXXXXXXXXXXXXXXXXXXXXXXXXXXXXXXXXXXXXXXXXXXXXXXXXXXXXXXXXXXXXXXXXXXXXXXXXXXXXXXX--XXXXXXXXXXXXXXXXXXXXXXXXXXXXXXXXXXXXXXXXXXXXXXXXXXX-XXXXXXXXXXXXXXXXXXXXXXXXXXX-XXXXXXXXXXXXXXXXXXXXXXXXXXX-XXXXXXXXXXXXXXXXXXXXXXXXXXX-XXXXXXXXXXXXXXXXXXXXXXXXXXX-XXXXXXXXXXXXXXXXXXXXXXXXXXXXXXXXXXXXXXXXXXXXXXXXXXXXXXX-XXXXXXXXXXXXXXXXXXXXX--XXXXXXXXXXXXXXXXXXXXXXXXXXXXXXXX-XXXXXXXXXXXXXXXXXXXXXXXXXXX-XXXXXXXXXXXXXXXXXXXX---XXXX-XXXXXXXXXXXXXXXXXXXXXXXXXXX-XXXXXXXXXXXXXXXXXXXXXXXXXXXXXXXXXXXXXXXXXXXXXXXXXXXXXXX-XXXXXXXXXXXXXXXXXXXXXXXXXXX-XXXXXXXXXXXXXXXXXXXXXXXXXXXXXXXXXXXXXXXXXXXXXXXXXXXXXXX-XXXXXXXXXXXXXXXXXXXXXXXXXXX-XXXXXXXXXXXXXXXXXXXXXXXXXXX-XXXXXXXXXXXXXXXXXXXXXXXXXXX-XXXXXXXXXXXXXXXXXXXXXXXXXXX-XXXXXXXXXXXXXXXXXXXXXXXXXXX-XXXXXXXXXXXXXXXXXXXXXXXXXXX-XXXXXXXXXXXXXXXXXXXXXXXXXXX-XX--XX--XXXXXXXXXXXXXXX-XXXXXXXXXXXX-XXXXXXXXXXX--XXXX-XXXXXXXXXXXXXXXXXXXXXXXXXXXX-XXXXXXXXXXXXXXXXXXXXXXXXXXXXXXXXXXXXXXXXXXXXXXXXXXXXXXXXXXXXX---XXXXXXXXXXXXXXXXXX--XXXXXXXXXXXXXXXXXXXXXXXXXXX-XXXXXXXXXXXXXXXXXXXXXXXXXXX-XXXXXXXXXXXXXXXXXXXXXXXXXXX-XXXXXXXXXXXXXXXXXXXXXXXXXXX-XXXXXXXXXXXXXXXXXXXXXXXXXXX-XXXXXXXXXXXXXXXXXXXXXXXXXXX
