--------------------------------------------------------------------------------------------------------------------------------------------------------------------------------------------------------------------------------------------------------------------------------------------------------------------------------------------------------------------------------------------------------------------------------------------------------------------------------------------------------------------------------------------------------------------------------------------------------------------------------------------------------------------------------------------------------------------------------------------------------------------------------------------------------------------------------------------------------------------------------------------------------------------------------------------------------------------------------------------------------------------------------------------------------------------------------------------------------------------------------------------------------------------------------------------------------------------------------------------------------------------------------------------------------------------------------------------------------------------------------------------------------------------------------------------------------
-------------------------------------------------------Q-------------------------------------------------------------------------------------------------------------------------------------------------------------------------------------------------------------------------------------------------------------------------------------------------------------------------------------------------------------------------------------------------------------------------------------------------------------------------------------------------------------------------------------------------------------------------------Q-------------------------------------------------------------------------------------------------------------------------------------------------------------------------------------------------------------------------------------------------------------------------------------------------------------------------------------------------------------------------------------------------------Q---------------------------------------------------------------------------------Q-Q--------------------------------------------------------------------------------------------------------------------------------------------------------------------------------------------------------------------------------------------------------------------------------------------------------------------
---------------------------------------------------------------------------------------------------------------------o-------------------------------------------------------------------------------------------------------------------------------------------------------------------------------------------------------------------------------oo-----------------------------------------------------------------------------------------------------------------------------------------------------------------------------------------------------------------------------------------------------------------------------------------------------------------------------------------------------------------------------------------------------------------------------------------------------------------------------------------------------------------------------------------------------------------------------------------------------------------------------------------------------------------------------------------------------------------------------------------------------------------------------------o-------------------------------------------------------------------------------------------------------------------------------------------------------------------------------------------------------------------------------o-----------------------------------------------------------------------------
--------------------------------------------------------------------------------------------------------------------XXXX----------------------------------------------------------------------------------------------------------------------------------------------------------------------------------------------------------------------------XXXX-------------------E-----------------------------------------------------------------------------------------------------------------------------------------------------------------------------------------------------------------------------------------------------------------XXX-----------------------------------------------------------------------------------------------------------------------------------------------------------------------------------------------------------------------------------------------------------------------------------------------------------------------------------------------------------------------------------------------------------------------------------------------------------------------------------------XXX-----------------------------------------------------------------------------------------------------------------------------------------------------------------------------------------------------------------------------XXX--------------------------------------------------------o-------------------
---------------------------------------------Eoo-------------------------------------------------------------------------------------------------------------------------------------------------------------------------------------------------------------------------------------------------------------------------------------------------------------------------E------------------------------------------------------------------------------------------------------------------------------------------------------------------------------------------------------------------------------------------------------------------------------------------------------------------------------------------------------------------------------------------------------------------------------------------------------------------------------------------------------------------------------------------------------------------------------------------------------------------------------------------------------------------------------------------------------------------------------------------------------------------------------------------------------------------------------------------------------------------------------------------------------------------------------------------------------------------------------------------------------------------------------------------------------------------------------
---------------------------------------------XXXX----------------------------------------------------XXX-------------------------------------------------------------------------QQQ-------------------------------------------S---------------------------------------------SQ------------------Q-QQ------------SQQ---------Q--------------SSS----------Q-------------SSSS----------?--------------SSSS---------?-QQ---------SSSSS----------Q-?-SSS-----SQSSSS-------------------------SSQS---------QQQ--------------Q----------QQQQSSS---------QQQ---------QQQQ------------SQ----------?--E-----------SSSS---------?--E-----------SSSS---------?--E---------SSSSSS-------QQQQQ-----------------------------------------------------??-E-------------S------------------------------------------------------------------------------------------------SSSSS---------------------SSSSSSS-SSS---------------------------------SSS--------------------------Q-----------SSS----------------------------------------SSS---------Q---------------SSS-----------------------SSSSS-----------------------SSSSS---------?--E--------SSSSSSS---------?-----------SQSSSSS-----------Q--------------Q----------?S-E-----------SSSS---------QQQ-------------QQQ---------QQQ--------------Q----------?Q-E------------------------?--E---------------o--------?--E------------------------Q-Q------------------------------------------QQ---------?-Q----------------
-------------------------------------------------------------------------------------------------------------------------------------------------------------------------------------------------------------------------------------------------------------------XX-------------------------------------------------------------------------------------------------------------------------------------------------XX--------------------------X-------------------------------------------------------------------------------------------------------------------------------------------XX---------------------------------------------------XXXXX--------------------------------------------------------------------------------XXXX------------------------------------------------------------------------------------------------------------------------------------------------------------------------------------------------------------------------------------------------------------------------------------------------------------------------------------------------------------------------------------------------------------------------------------------------------------XXXX--------------------------------------------------------------------------------XXXX--------------------------XXX----------------------XXXXXX---------------------------------------------------------------------E-------------------------
--------------------------------------------------------------------------------------XXXX--------------------XX----------------------------------------------------------E--------------------------------------------------------------------------------------XXoS---------------------------------------------------------------------------------------------------------------------------------------------------------------------E----------------------------------------------------------------------------------------------------------------------------------------------------------------------------------------------------------------------------------------------------------------------------------------------------------------E------------------------------------------------------------------------------------------------------------------------------------------------------------------------------------------------------------E---------------------------------------------------------------------------------------------------------------------------------E-----------------------------------------------------------------------------------------------Q-----------------------------------------------------------------------------------------------------------------------------------------------XXX-------------------------------------E---------------------------E-------------------------
----------E-----------------------------------------------------------------------------------------------oo-------------------------------------------------------------<>------------------E------------------------------E-----------------------------------XXX-----------------------E------------------E--------E---E--------------E--------E---------------E--E--------E---------------E---------------E--------------------------<>-------------------------E-------------E-----------E------------------E--------E------------------E--------E---E--------------E--?-----E---------------E-----------E-E-------------E-----------E---E-----------E---------------------------------------E------------------E------------E-----------------------E---------------E--o--------------E-----------------E-------------------E-----------------------------------------S------------------------------------------------------------------------E-----------------------------E----------------------E--S--------E---------------E-----------E---------------E--S------------------------E----------<>---------------E-----------E---------------E------------------------------E----------E----------------------------------------------------<>------------------E--------E-E-------------E--E------------------------E---------------E------------------------------------------E-------<>---------------E----------<>-------------------------
--E------<>------------E--------------------------------o-------------------------------------------------------------------------E--S-----S-----------------------------[]----E?QQ---------<>-----------------------------<>--------------------<>-----------EXXXX----------Q-----------<>---E--SQQQ-------<>---QQQ-<>--<>---QQQ-------<>---QQS-<>----E?SQ------<>-<>----E?-<>----E--QQQ----<>-----E-----E--<>---QQQ-------<>--------E--[]-----Q-Q-----<>---QQQ---<>---QQ-------<>-----E----<>----E?-Q---------<>---QQQ-<>----E?-QQQ-------<>---QQQ-<>--<>--SQQQ-------<>---QQQ-<>-----?S-------<>----------<><>--E?QQ------<>-----E--S-<>--<>--SQQQ----<>-------?S---Q--QSQQ-----------E----E?-<>-------Q---------<>----QQ--E--<>---QQQ----------<>----<>--------------<>----------------<>-----E-----E----<>------------------<>-----------------E---------------------E--X--------------------------<>------------E-----E-----------------------<>---QQQ----------------------<>------------QQ-------<>-----E----<>----E-QQ------<>----------<><>----QQ------<>-----E-----E<>-----QQQ----<>-----E----[]---E--S-------<>------E??-<>----E---------<>------S?S--E----E--QQQ-------<>---QQQ--E<>---?SQQQ-----------E-----E-----?Q-------E--<>-------[]----E?-Q---------<>---QQQ-<><>--E?SQ------<>-<>--------------?S-------<>--------X----E<>--SQQQQ----------E----------Q--Q---------<>---QQQ-[]--------------<>----------[]----E?S-Q--------<>----QQ
-<>------[]-----------<>---------E------------------------------------------------X------------------<>--------------------------<>--------------------------------------[]------------E----[]----------------------E------[]--------------------[]-----E-----XXXXX----------------------[]--<>-------------[]-------[]--[]-------------[]-------[]--------------[]-[]-------[]--------------[]----<>----<>--[]-------------[]-------<>--[]-------------[]---------[]------------[]----<>----[]-----------------[]-------[]-----------------[]-------[]--[]-------------[]-------[]--------------[]--E-<>----[][]------------[]----<>----[]--[]----------[]----<>------------------E---E<>---<>S-[]-----------------[]-------<>--[]----------------[]----[]-------------E[]----------------[]----<>----<>----[]------------------[]----------------<>--------------------<>--XX------------E-E----EX----[]-----------<>----<>-----------------------[]--------E------XX--------E--[]---------------E-----[]----<>----[]--------------[]-----E----[][]------------[]----<>----<>[]------------[]----<>-X--[]--<>----------[]----------[]--------------[]--E-------<>-----------------[]-------<>[]------------------<>----<>--------------E--[]-------[]-----------------[]-------[][]------------[]-[]--E-----E--------------[]-----E-----E<>[]----------------<>-----E-----------------[]-------[]--------------[]----------[]-----------------[]------
-[]------[]-----------[]--------<>--------------------------------------------E---X------XXX---------[]--------------------------[]--------------------------------------[]-----------<>----[]---------------------<>------[]--------------------[]-<>-<>----XXXXXX----------------------[]--[]-------------[]-------[]--[]-------------[]-------[]--------------[]-[]-------[]--------------[]----[]----[]-E[]-------------[]-------[]--[]-------------[]-------<>[]------------[]-<>-[]----[]-----------------[]-------[]-----------------[]-------[]--[]-------------[]-------[]--------------[]-<>-[]----[][]------------[]-<>-[]----[]--[]----------[]----[]-----------------<>--<>[]---[]S-[]-----------------[]-------[]--[]----------------[]----[]------------<>[]----<>----------[]----[]----[]----[]------------------[]----------------[]--------------------[]--XX-----------<><>---<>X----[]-----------[]----[]-----------------------[]-------<>----XXX--------<>--[]-----<>-------<>-----[]-<>-[]----[]--------------[]-<>-<>----[][]------------[]----[]----[][]------------[]----[]----[]--[]----------[]-<>-------[]--------------[]-<>-------[]--oo-------------[]-------[][]------------------[]----[]-------------<>--[]-------[]-----------------[]-------[][]------------[]-[]-<>----<>--------------[]----<>----<>[][]----------------[]----<>-----------------[]-------[]--------------[]----------[]-----------------[]------
-[]------[]-----------[]------E-[]--------E---------------------------------------X------------E-E---[]---------------------E-E--[]------------EE-E-----E----------------[]---------E-[]----[]----------------E--E-[]---E--[]---------------E-EE-[]-[]-[]---XXXXXXX---------EE--E--E-----[]--[]-------E--E--[]-------[]--[]----E-E------[]-------[]-----------E--[]-[]-------[]--------E--E--[]----[]----[][][]------EE-EE--[]-------[]--[]-------------[]-------[][]---------E--[]-[]-[]----[]---E----E--EE----[]-------[]-----------E--E--[]----E--[]--[]-------E-----[]-------[]-----E-----E--[]-[]-[]----[][]---------E--[]-[]-[]----[]--[]-------E--[]----[]--------EE-------[]--[][]-E-[]S-[]-----------E-EE--[]-E--E--[]--[]------EE-EE-E---[]----[]-----E------[][]----[]----------[]----[]----[]-E--[]-----X---------E--[]-----------E-E--[]--------------------[]---------------[][]-E-[]X----[]-----E-EE--[]-E--[]---------------E-EE----[]-------[]----XXX--------[]--[]-----[]-------[]-----[]-[]-[]----[]--------E--E--[]-[]-[]----[][]-----EE--E--[]----[]----[][]-E----E-EE--[]----[]-X--[]--[]-------E--[]-[]-------[]--------EE-E--[]-[]-------[]--[]-------EE----[]--E-E--[][]---------E-EE-E---[]----[]--EE-----E-E-[]--[]-------[]--EE-------E-----[]-------[][]---E-----E--[]-[]-[]----[]----------EE--[]----[]----[][][]-E----EE-E--E-E-[]----[]-----------EE-E--[]-EE-E--[]--E--EE-E--E-EXX----E-----[]-----------E-EE--[]-E--E-
-XXXXXXXXXXXXXXXXXXXXXXXXXXXXXXXXXXXXXXXXXXXXXXXXXXXXXXXXXXXXX---XXXXXXXXXXXXXXXXXXXXXX------XXXXXXXXXXXXXXXXXXXXXXXXX-XXXXXXXXXXXXXXXX--XXXXXXXXXXXXXXXXXXXXXXXXXXXXXXX-XXXXXXXXXXXXXXXXXXXXXXXXXXXXXXXXXXXXXXXXXXXXXXXXXXXXXXXXXXXXX-XXXXXXXXXXXXXXXXXXXXXXXXXXX-----XXXXXXXXXXXXXXXXX-XXXXXXXXXXXXXXXXXXXXXXXXXXX-XXXXXXXXXXXXXXXXXXXXXXXXXXX-XXXXXXXXXXXXXXXXXXXXXXXXXXX-XXXXXXXXXXXXXXXXXXXXXXXXXXX-XXXXXXXXXXXXXXXXXXXXXXXXXXXXXXXXXXXXXXXXXXXXXXXXXXXXXXX-XXXXXXXXXXXXXXXXXXXXXXXXXXX-XXXXXXXXXXXXXXXXXXXXXXXXXXX-XXXXXXXXXXXXXXXXXXXXXXXXXXX-XXXXXXXXXXXXXXXXXXXXXXXXXXXXXXXXXXXXXXXXXXXXXXXXXXXXXXX-XXXXXXXXXXXXXXXXXXXXXXXXXXX-XXXXXXXXXXXXXXXXXXXXXXXXXXXXXXXXXXXXXXXXXXXXXXXXXXXXXXX-XXXXXXXXXXXXXXXXXXXXXXXXXXXXXXXXXXXXXXXXXXXXXXXXXXXXXXXXXXXXXXXXXXXXXXXXXXXXXXXXXXXXXXXXXXXXXXXXXXXXXXXXXXXXXXXXXXXXXXXXXXXXXXXXXXXXXX-XXXXXXXXXXXXXXXXXXXXXXXXXXXXX--X-XX--XX----E-X-XXXXXXXXXXXXXXX--XXXXXXXXXXXXXXXXXXXXXXXXXXXXXX--XXXXXXXXXXXXXXXXXXXX-XXXXXXXXX---XXXXXXXXXXXXXXX-XXXXXXXXXXXXXXXXXXXXXXXXXXX-XXXXXXXXXXXXXXXXXXXXXXXXXXX-XXXXXXXXXXXXXXXXXXXXXXXXXXXXXXXXXXXXXXXXXXXXXXXXXXXXXXX-XXXXXXXXXXXXXXXXXXXXXXXXXXX-XXXXXXXXXXXXXXXXXXXXXXXXXXXXXXXXXXXXXXXXXXXXXXXXXXXXXXXXXXXXXXXXXXXXXXXXXXXXXXXXXXX-XXXXXXXXXXXXXXXXXXXXXXXXXXX-XXXXXXXXXXXXXXXXXXXXXXXXXXXXXXXXXXXXXXXXXXXXXXXXXXXXXXXXXXXXXXXXXXXXXXXXXXXXXXXXXXX-XXXXXXXXXXXXXXXXXXXXXXXXXXX-XXXXXXXXXXXXXXXXXXXXXXXXXXX-XXXXXXXXXXXXXXXXXXXXXXXXXXXXXXXXXXXXXXXXXXXXXXXXXXXXXXX
