--------------------------------------------------------------------------------------------------------------------------------------------------------------------------------------------------------------------------------------------------------------------------------------------------------------------------------------------------------------------------------------------------------------------------------------------------------------------------------------------------------------------------------------------------------------------------------------------------------------------------------------------------------------------------------------------------------------------------------------------------------------------------------------------------------------------------------------------------------------------------------------------------------------------------------------------------------------------------------------------------------------------------------------------------------------------------------------------------------------------------------------------------------------------------------------------------------------------------------------------------------------------------------------------------------------------------------------------------------------------------------------------------------------------------------------------------------
--------------------------------------------------------------------------------------------------------------------------------------------------------------------------------------------------------------------------------------------------------------------------------------------------------------------------------------------------------------------------------------------------------------------------------------------------------------------------------------------------------------------------------------------------------------------------------------------------------------------------------------------------------------------------------------------------------------------------------------------------------------------------------------------------------------------------------------------------------------------------------------------------------------------------------------------------------------------------------------------------------------------------------------------------------------------------------------------------------------------------------------------------------------------------------------------------------------------------------------------------------------------------------------------------------------------------------------------------------------------------------------------------------------------------------------------------------
----o---------------------------ooo-------------------------ooo-------------------------ooo-------------------------ooo-------------------------ooo---------------------SSS-oSSSSSSSSSSS----------------ooo-------------------------oo--------------------------oo--------------------------oo--------------------------ooo---------------------SSS-SoSSSSSSSSSS----------------oo--------------------------oo--------------------------oo--------------------------ooo-------------------------oo--------------------------oo--------------------------oo--------------------------oo--------------------------ooo-------------------------ooo-----------------------S-ooSSSSSSSSSS----------------oo--------------------------oo--------------------------oo--------------------------oo--------------------------oo--------------------------oo--------------------------ooo-------------------------oo--------------------------oo--------------------------oo--------------------------o---------------------------oo--------------------------oo----------------------SSSSSSSSSSSSSSSSSSSSSSS---------ooo-------------------------ooo-------------------------oo--------------------------oo----------------------SSS-SSSSSSSSSSS-----------------ooo-------------------------ooo-------------------------ooo----------------------SS-oSSS-SSSSSS-------------------------------------------------------------------------------------------------
----XXX------------------------XXXXX------------------------XXXX------------------------XXXX-----------------------XXXXX-----------------------XXXXX------------------------XXX------------------------XXXXX-----------------------XXXXX-----------------------XXXX------------------------XXXXX-----------------------XXXXX------------------------XXXX----------------------XXXXXX-----------------------XXXX------------------------XXXX------------------------XXXXX-----------------------XXXX------------------------XXXX------------------------XXXX------------------------XXXXX-----------------------XXXXX-----------------------XXXXX------------------------XXXX----------------------XXXXXX-----------------------XXXX------------------------XXXX------------------------XXXX------------------------XXXX------------------------XXXXX------------------------XXXX-----------------------XXXX------------------------XXXX------------------------XXXXX------------------------X--------------------------XXXX------------------------XXXXX----------------------------------------------------XXXX-----------------------XXXXX-----------------------XXXXX-----------------------XXXX-------------------------XXX------------------------XXXXX-----------------------XXXXX------------------------XXXX------------------------XXXX--------------------------------------------------------------------------------------------------------
--------------------------------------------------------------------------------------------------------------------------------------------------------------------------------------------------------------------------------------------------------------------------------------------------------------------------------------------------------------------------------------------------------------------------------------------------------------------------------------------------------------------------------------------------------------------------------------------------------------------------------------------------------------------------------------------------------------------------------------------------------------------------------------------------------------------------------------------------------------------------------------------------------------------------------------------------------------------------------------------------------------------------------------------------------------------------------------------------------------------------------------------------------------------------------------------------------------------------------------------------------------------------------------------------------------------------------------------------------------------------------------------------------------------------------------------------------
------------------------SSSS------------------------SSSQ---------------------SS-SSSS---------------------S--SSSS------------o-----------SSSS------------o-----------SSSS------------S-------------QQ-----------oooo---------SSS---------------E---------SSS----------E--o-----------SSSS------------o-----------SSSS------------o-----------SSQQ------------o------------SSS------------o-----------SSSS------------o-----------SSSS------------------------SSSS------------o-----------SSSS---------oooo----E------SSSS---------oo-o----E------SSSS---------oooo----E------SSSS---------oooo-----------SSSS-----------------------SSSSS------------o-----------SSSS------------o--------S---SSS------------o----E------SSSS------------------------SSSS---------oo-o----E------SSSS---------oooo----E------SSS?------------------------SSSS------------o-----------SSSS------------o-----------SSSQ---------oooo----E------SSS-------------------------SSSS---------oooo-----------SSSS---------oooo----E-------SSS------------------------SSSS------------o-----------SSSS---o--------o-------------QQ--------------E---------SSSS------------o-----------SSSS-----------oo-----------SSSS------------------------SSSS-------------------------SSS------------o--------S--SSSS------------------------SSSS------------o------------SQS------------------------SSSS--------------------------QS-------QQQQQ-----------------------QQQQQ----------------
---------------------------------------------------------------------------------------------------------------------------------------------------------------------------------------------------------------------------------------------<>-----------------------------------------------------------------------------------------------------------------------------------------------------------------------------o---------------------------o-------------------------------------------------------o-------------------------------------------------------o-------------------------------------------------------------------------------------------------------------------------------------------o---------------------------------------------------------------------------------------------------------------o-----------------------------------------------------------------------------------------------------------------------------------------------------------------------o--------------------------------------------------------------------------------------------------------<>---------------------------------------------------------------------------------------------------------------------------------------------------------------------------------------------------------------------------------------------------------------------------------------------------------------------------------
----------------------------------------------------------------------------------------------------------------------------------------------------SS---------------------o-----S-----------------------------SSS----------------------S----[]----------------S--S-SS---------------------E----SS--------------------------S---------------------------SS------------------------------------------------------SS--------------------------S---------------------------S---------------------------SS------------------o-----S-SS------------------------S-SS--------------------------SS-----------------------------------------------------------------------------o----------------------------------------------------o-------S-------------------------S-SSS-----------------------S-SSS-------------------------S---------------------------SS---------------------o------------------------------S-SSS--------------------E----S---------------------------SS------------------------S-SSS-------------------------S---------------------------S----------------------S----SS--------------------------SS---[]---------------------S---------------------------S---------------------SS--S-SS---------------------o----------------------------------------------------------------------------------------------------------------------------------------------------------------------------------------------------------------------------
------------------E--S------------------------E---------------------------E---------------------------E---------------------------E-----------------S---------E-----------------S---------E--o------------------------E---------------SoS----[]---E-----------S---SoS---------E---------------SoS---------E---------------SoS---------E--o------------SoS---------E--o------------------------E---------------SoS---------E---------------SoS---------E---------------SoS---------E---------------SoS---------E---------------SoS---------E---------------SoS---------E---------------SoS---------E---------------------------E---------------------------E---------------------------E---------------------------E---------------SoS---------E---------------SoS---------E---------------SoS---------E---------------SoS---------E---------------SoS---------E--o------------------------E---------------SoS---------E---------------SoS---------E--o------------SoS---------E---------------SoS---------E---------------SoS---------E---------------SoS---------E----------------oS---------E--o------------SoS----[----E-----------------S---------E---------------SoS---------E----------oS?--SoS---------E--o------------------------E--o------------------------E---------------------------E---------------------------E--o------------------------E---------------------------------------------------------------------------------------------
--S--------------<>-----E--------------------<>------E?X-----------------<>------ESS-----------------<>--S---ESS-----------------<>------S?S-----------------<>------E?S-----------------<>------S?S-----------------<>--XX--E?S-------SS----XXX-<>------S?SSSS---SSS--------<>------E?SSSS---SSS--------<>------E?S-------SS--------<>------S?S-------SS--------<>------E?S-----------------<>------E?SSSS---SSS--------<>---------XXS---SSS--------<>------E-S-------SS--------<>------E?SXXS---SSS----XX--<>------E--XXS---SSS----X---<>------E?XXXS---SSS----XX--<>------E?X------SSS--------<>------E?S-----------------<>-----E??S-----------------<>------S?SSSS--------------<>------E?S-----------------<>------E?-XXS---SSS--------<>------E-SXXS---SSS--------<>------E?XXXS---SSS----XX--<>------E?SXSS----SS--------<>------E--XSS---SSS--------<>------E?S-----------------<>------E?S-SS---SSS--------<>------E?S-SS---SSS--------<>------E?SXXS---SSS--------<>------E?XXXS---SSS----XX--<>------E?-XXS----SS--------<>------E-S--S----SS--------<>------E?SSSSS--SSS---S----<>------S?S-------SS--------<>------E?S-------SS--------<>------E?S-------SS--------<>------E?SSSS---SSS--------<>------E?S--S--------------<>------E?S-----------------<>------E?S-----------------<>-----ES?S-----------------<>------S?S-----------------<>------E?S-----------------E------------o--EQQQQQQ-Q----------------o--E?QQQQQ-Q-------------Q
-----------------[]----<>--------------------[]--------------------------[]--------------------------[]--------------------------[]--------------------------[]--------------------------[]------------o-------------[]------------o-------------[]--------------------------[]-----E--------------------[]--------------------------[]--------------------------[]------------o-------------[]------------o-------------[]-----E------o-------------[]--------------------------[]------------o-------------[]------------o-------------[]------------o-------------[]------------o-------------[]--------------------------[]----<>--------------------[]--------------------------[]------------o-------------[]------------o-------------[]------------o-------------[]-----------oo-------------[]------------o-------------[]--------------------------[]--------------------------[]-----------oo-------------[]--------------------------[]------------o-------------[]------------o-------------[]------------o-------------[]------------o-------------[]--------------------------[]--------------------------[]--------------------------[]--------------------------[]------------o-------------[]--------------------------[]--------------------------[]--------------------------[]----<>--------------------[]--------------------------[]-------------------------<>-----E------------------------------------------------------------
---X-------------[]----[]--------------------[]--------------------------[]-------------XX-----------[]------------XXXX----------[]------------XXX-----------[]------------XXX-----------[]-----------XXXXX----------[]-----------XXXXXX---------[]-----------XXXXX----------[]-----------XXXXX----------[]-----------XXXX-----------[]-----------XXXXX----------[]-----------XXXXX----------[]-----------XXXXX----------[]----<>-----XXXXX----------[]----<>-----XXXXX----------[]-----------XXXXX----------[]-----------XXXXX----------[]-----------XXXXX----------[]-----------XXXXX----------[]-------------XXX----------[]----[]-----XXXX-----------[]------------XXX-----------[]-----------XXXXX----------[]-----------XXXXX----------[]-----------XXXXX----------[]-----------XXXXX----------[]-----------XXXXX----------[]----<>-----XXXXX----------[]--------------------------[]-----------XXXXX----------[]------------XXX-----------[]-----------XXXXX----------[]-----------XXXXX----------[]-----------XXXXX----------[]----<>-----XXXXX----------[]------------X-------------[]-----------XXXXX----------[]-----------XXXXX----------[]-----------XXXXX----------[]-----------XXXXX----------[]--------------------------[]------------XXXX----------[]--------------------------[]----[]------XXX-----------[]--------------------------[]-------------------------[]----<>------------------------------------------------------------
---------E----E--[]----[]--------------E--EE-[]-------------------EE-E---[]--------------------E-EE--[]--------------------------[]--------------------------[]--------------------------[]--------------------------[]------------------E-------[]------------------E-------[]--------------------------[]------------------E-------[]------------------E-E-----[]--------------------------[]--------------------------[]----[]------------EE------[]----[]--------------------[]--------------------------[]--------------------------[]--------------------------[]--------------------------[]--------------------E-----[]----[]-----------------E--[]--------------------E-E---[]--------------------------[]--------------------------[]--------------------------[]--------------------------[]------------------E-------[]----[]--------------------[]----------------------E---[]--------------------------[]------------------E-------[]--------------------------[]--------------------------[]--------------------------[]----[]--------------------[]--------------------------[]--------------------E-----[]------------------E----E--[]--------------------------[]------------------E-------[]--------------------E-----[]--------------------------[]--------------------E-----[]----[]--------------------[]--------------------E-----[]------------EE-E-----E-E-[]----[]------------------E--------E--E---------------E--------EE-E-
XXX----XXXXXXXXXXXXXXXXXXXXXXXX------XXXXXXXXXXXXXXXXXXXXXX-----XXXXXXXXXXXXXXXXXXXXXX--------XXXXXXXXXXXXXXXXXXX---------XXXXXXXXXXXXXXXXXX---------XXXXXXXXXXXXXXXXXXXX--------XXXXXXXXXXXXXXXXXXX----------XXXXXXXXXXXXXXXXXX----------XXXXXXXXXXXXXXXXXX----------XXXXXXXXXXXXXXXXXX----------XXXXXXXXXXXXXXXXXX---------XXXXXXXXXXXXXXXXXXXX--------XXXXXXXXXXXXXXXXXXX----------XXXXXXXXXXXXXXXXXX----------XXXXXXXXXXXXXXXXXX---------XXXXXXXXXXXXXXXXXXX----------XXXXXXXXXXXXXXXXXX----------XXXXXXXXXXXXXXXXXX----------XXXXXXXXXXXXXXXXXX----------XXXXXXXXXXXXXXXXXX----------XXXXXXXXXXXXXXXXXXXX-------XXXXXXXXXXXXXXXXXXX----------XXXXXXXXXXXXXXXXXXXX-------XXXXXXXXXXXXXXXXXXX----------XXXXXXXXXXXXXXXXXX----------XXXXXXXXXXXXXXXXXX----------XXXXXXXXXXXXXXXXXX-----------XXXXXXXXXXXXXXXXX----------XXXXXXXXXXXXXXXXXX----------XXXXXXXXXXXXXXXXXXXX-------XXXXXXXXXXXXXXXXXXX----------XXXXXXXXXXXXXXXXXX---------XXXXXXXXXXXXXXXXXXX----------XXXXXXXXXXXXXXXXXX-----------XXXXXXXXXXXXXXXXX----------XXXXXXXXXXXXXXXXXX----------XXXXXXXXXXXXXXXXXX---------XXXXXXXXXXXXXXXXXXX----------XXXXXXXXXXXXXXXXXX---------XXXXXXXXXXXXXXXXXXX----------XXXXXXXXXXXXXXXXXX----------XXXXXXXXXXXXXXXXXXXX------XXXXXXXXXXXXXXXXXXXXX---------XXXXXXXXXXXXXXXXXXXX-------XXXXXXXXXXXXXXXXXXXX--------XXXXXXXXXXXXXXXXXXXXX-------XXXXXXXXXXXXXXXXXXXXXXXXXXXXXXXXXXXXXXXXXXXXXXXXXXXXXXXXXXXXXXXXXXXXXXXXXXXXXXXXXXXXXXXXXXXXXXXXXXXXXXX
