--------------------------------------------------------------------------------------------------------------------------------------------------------------------------------------------------------------------------------------------------------------------------------------------------------------------------------------------------------------------------------------------------------------------------------------------------------------------------------------------------------------------------------------------------------------------------------------------------------------------------------------------------------------------------------------------------------------------------------------------------------------------------------------------------------------------------------------------------------------------------------------------------------------------------------------------------------------------------------------------------------------------------------------------------------------------------------------------------------------------------------------------------------------------------------------------------------------------------------------------------------------------------------------------------------------------------------------------------------------------------------------------------------------------------------------------------------
--------------------------------------------------------------------------------------------------------------------------------------------------------------------------------------------------------------------------------------------------------------------------------------------------------------------------------------------------------------------------------------------------------------------------------------------------------------------------------------------------------------------------------------------------------------------------------------------------------------------------------------------------------------------------------------------------------------------------------------------------------------------------------------------------------------------------------------------------------------------------------------------------------------------------------------------------------------------------------------------------------------------------------------------------------------------------------------------------------------------------------------------------------------------------------------------------------------------------------------------------------------------------------------------------------------------------------------------------------------------------------------------------------------------------------------------------------
------------------------------------------------------------ooo-------------------------ooo-------------------------ooo-------------------------ooo-------------------------ooo-------------------------oo--------------------------oo--------------------------oo--------------------------ooo-------------------------oo--------------------------ooo-------------------------ooo-------------------------oo--------------------------ooo-------------------------oo--------------------------oo--------------------------oo--------------------------oo--------------------------oooS------------------------oo--------------------------ooo-------------------------ooo-------------------------oo--------------------------oo--------------------------oo--------------------------oo--------------------------oo--------------------------oo--------------------------oo--------------------------oo--------------------------o---------------------------ooo-------------------------oo--------------------------oo--------------------------oo--------------------------oooS------------------------ooo---------------------S---ooSS--SSSSS-----------------oo--------------------------oo--------------------------oo--------------------------oooS--------------------SSSSSSSSSSSSSSSSSSSSS-----------ooo---------------------SSSSSSSSSSSSSSSSSSSSS-----------oooo------------------------ooo-------------------------------------------------
-------------------------------XXXX-----------------------XXXXXX------------------------XXXX-----------------------XXXXX-----------------------XXXXX------------------------XXXX-----------------------XXXXX-----------------------XXXXX-----------------------XXXXX-----------------------XXXXX-----------------------XXXX------------------------XXXXX-----------------------XXXXX-----------------------XXXX-----------------------XXXXXX-----------------------XXXX--------------------E---XXXX------------------------XXXX------------------------XXXXX------------------------XXXX-----------------------XXXXX-----------------------XXXXX-----------------------XXXXX-----------------------XXXX------------------------XXXXX----------------------XXXXX------------------------XXXX------------------------XXXXX----------------------XXXXXX-----------------------XXXX------------------------XXXX----------------------------------------------------XXXXX-----------------------XXXXX-----------------------XXXXX-----------------------XXXX-------------------------XXXX-----------------------XXXXX-----------------------XXXXX-----------------------XXXX------------------------XXXX------------------------XXXXX-----------------------XXXX--------------------------XX------------------------XXXXX-------------------------XX-------------------------XXXX-----------------------XXXXX------------------------------------------------
--------------------------------------------------------------------------------------------------------------------------------------------------------------------------------------------------------------------------------------------------------------------------------------------------------------------------------------------------------------------------------------------------------------------------------------------------------------------------------------------------------------------------------------------------------------------------------------------------------------------------------------------------------------------------------------------------------------------------------------------------------------------------------------------------------------------------------------------------------------------------------------------------------------------------------------------------------------------------------------------------------------------------------------------------------------------------------------------------------------------------------------------------------------------------------------------------------------------------------------------------------------------------------------------------------------------------------------------------------------------------------------------------------------------------------------------------------
------------------------SSSS-------------------------SQS---------------------SSSSSSS------------------------SSSS------------o-----------SSSS------------------------SSSS------------o-----------SSSS------------o-----------SSSS-----------oo-----------SSSS------------o-----------SSSS----------ooo-----------SSSS---------oo-------------SSSS--------------E---------SSSS------------o-----------SSSS---------oo-o----E------SSSS------------------------SSSS------------------------SSSS---------oooo----E------SSS-------------------------SSSS---------oooo-S---------SSSS------------o-E---------SSSS------------o-----------SSSS------------o-----------SSSS------------oo----------SSSS---------oo-o----E------SSSS------------o-----------SSSS---------ooo-----XX-----SSS----------o--------------SSSS---------o-------E------SSSS------------------------SSSS------------o------------SSS---------oooo----E------SSSS---o-----o---------------SSS------------o-----------SSSS------------o-----------SSSS---------oooo----E------SSSS------------------------SSSS------------------------SSSQ---------------------SSSSSSS----------ooooo----------SS-------------o-----------SSSS------------------------SSSS----------ooo-----------SSSS------------o-----------SSSS--------------E-----------QQ------------------------SSSS-------------------------SQS------------------------SSSS-------------------------SQQ---------QQQ----------------
--------------------------------------------------------------------------------------------------------------------------------------------------------------------------------------------------------------------------------------------------------------------------------------------------------------------------------------------------------------------------------------------------------------------------------------------------------------------------------------------------------------------------------------------------------------------------------------------------------------------------------------------------------------------------------------------------------------------o-------------------------------------------------------o---------------------------o---------------------------------------------------------------------------------------------------------------o-----------------------------------------------------------------------------------------------------------------------------------------------------------------------------------------------------------------------?<>-----------------------------------------------------------------------------------------------------------------------------------------------------------------------------------------------------------------------------------------------------------------------------------------------------
------------------------------------------------------------------------------------------------------------------------S---------------------------------------------------------------------------------------------------------------S---------------------------S---------------------------SS---QS-------------------S-SS---------------------o----S----------------------E----SS------------------------S-SS--------------------------S-----------------------------------------------------S-SSS-------------------------S----------------------E--S-SSS--S----------------------SS---------------------E----SS----------------------------------------------------------------------------------S-------------------------------------------------------S---------------------------S-------------------o-------S--------------------------------------------------E--S-SS--------------------------SS---------------------S--S-SS--------------------------S---------------------------SS--------------------------SS---------------------E--S-SS-----------------------------------------------------------------------------E--S-SSSSS[]---------------------SS---------------------E----SS--------------------------SS---------------------S--S-SS---------------------o-------------------------------------------------------o-----S------------------------------------------------------------------------------------------------------
------------------E--S--------E---------------E---------------------------E---------------------------E--o--------------S---------E---------------------------E---------------------------E---------------------------E---------------SoS---------E---------------SoS---------E---------------SoS---------E---------------SoS---------E--o--------------S---------E---------------SoS---------E--o------------SoS---------E----------------oS---------E---------------------------E---------------SoS---------E---------------SoS---------E---------------SoS---------E--o------------SoS---------E--o------------SoS---------E--o------------------------E---------------------------E---------------SoS---------E---------------------------E---------------------------E---------------SoS---------E---------------SoS---------E---------------------------E---------------SoS---------E--o------------SoS---------E----------oSS--SoS---------E--o--------------S---------E---------------SoS---------E---------------SoS---------E----------oS---SoS---------E--o------------------------E---------------------------E---------------SoS----[----E---------------SoS---------E--o------------SoS---------E--o------------SoS---------E----------oSS--SoS---------E--o------------------------E--o------------------------E--o------------------------E--o------------------------E---------------------------E-------------------------------------
-----------------<>-----E----<>--------------<>--------------------------<>-----E--S-----------------<>------E?S-----------------<>------E?S-----------------<>------E?S-----------------<>------S?S-----------------<>------E?S-------SS--------<>------E?SXXS----SS--------<>------E?SXXS----SS--------<>------E?SXXS---SSS--------<>------E?S-SS--------------<>------E?S-SS---SSS--------<>------E?SXXS---SSS----X---<>------E?S--S----SS--------<>------E?S-----------------<>------E?SXSS---SSS--------<>------S?XXXS---SSS--------<>-----E--S-SS---SSS--------<>------E?S-------SS--------<>------E?S-SS---SSS--------<>------E?S-----------------<>------E?S-----------------<>------E?S-SS---SSS--------<>------E-------------------<>------E?SXXS----SS----XX--<>-XX---E--XXS---SSS--------<>-----E--SXXS---SSS----XX--<>------E--XXS--------------<>------E?SSSS---SSS--------<>------E?SXXS---SSS----XX--<>------E?-SSS---SSS--------<>------E?S-----------------<>------S?S-------SS--------<>------E?SXX----SSS--------<>------E?XSSS---SSS--------<>------E?S-----------------<>------E?S-----------------<>-----E??S-SS---SSS--------<>------S?S-SS---SSS--------<>------E?SSSS---SSS--------<>------E?S-SS---SSS--------<>------E?SSSSS--SSS--------<>------E?S------------S----<>------S?S-----------------<>------E?S-SS--------------<>------S?S-----------------<>------E?S-----------------<>------E?S--o--E-QQQQQ----------------
-----------------[]----<>----[]--------------[]--E-E---------------------[]----<>--------------------[]--------------------------[]--------------------------[]--------------------------[]------------o-------------[]------------o-------------[]--------------------------[]--------------------------[]------------o-------------[]--------------------------[]--------------------------[]------------o-------------[]--------------------------[]--------------------------[]------------o-------------[]--------------------------[]----<>--------------------[]--------------------------[]--------------------------[]--------------------------[]--------------------------[]------------o-------------[]--------------------------[]------------o-------------[]------------o-------------[]----<>------o-------------[]------------o-------------[]------------o-------------[]------------o-------------[]--------------------------[]--------------------------[]------------o-------------[]------------o-------------[]--------------------------[]--------------------------[]--------------------------[]----<>--------------------[]------------o-------------[]--------------------------[]--------------------------[]--------------------------[]--------------------------[]--------------------------[]--------------------------[]--------------------------[]--------------------------[]-------------------------------------
-----------------[]----[]----[]--------------[]-<><>---------------------[]----[]--------------------[]------------XXXX----------[]--------------------------[]------------XXX-----------[]-----------XXXXX----------[]-----------XXXXX----------[]-----------XXXXXX---------[]-----------XXXXX----------[]-----------XXXXX----------[]------------XXX-----------[]-----------XXXX-----------[]-----------XXXXX----------[]-----------XXXXX----------[]------------XXXX----------[]-----------XXXXX----------[]-----------XXXXX----------[]----[]-----XXXXX----------[]------------XXX-----------[]-----------XXXX-----------[]------------XXX-----------[]------------XXXX----------[]-----------XXXXX----------[]-----------XXXX-----------[]-----------XXXXX----------[]-----------XXXXX----------[]----[]-----XXXXX----------[]-----------XXXXXX---------[]-----------XXXXX----------[]-----------XXXXX----------[]-----------XXXX-----------[]-----------XXXXXX---------[]-----------XXXXX----------[]-----------XXXXX----------[]-----------XXXX-----------[]--------------------------[]--------------------------[]----[]-----XXXX-----------[]-----------XXXXX----------[]-----------XXXX-----------[]-----------XXXX-----------[]-----------XXXX-----------[]--------------------------[]--------------------------[]--------------------------[]------------XXX-----------[]--------------------------[]-------------------------------------
---------EEE--E--[]----[]----[]--------EE-EE-[]-[][]---------------E--E--[]----[]--------------E-----[]--------------------E-----[]--------------------E-----[]--------------------------[]--------------------------[]--------------------------[]--------------------------[]--------------------------[]--------------------------[]--------------------------[]--------------------------[]--------------------------[]------------------E----E--[]------------------E-------[]--------------------------[]------------------E----E--[]----[]--------------------[]--------------------------[]--------------------------[]--------------------E-----[]--------------------------[]------------------E-------[]-----------------------E--[]--------------------------[]------------------E----E--[]----[]--------------------[]-----------------------E--[]------------------E-------[]--------------------------[]--------------------------[]--------------------------[]--------------------------[]--------------------------[]------------------E-------[]--------------------E-----[]--------------------E--E--[]----[]--------------------[]------------------E-------[]------------------E-E-----[]--------------------------[]--------------------------[]-------------------EE-----[]------------------E-E-----[]--------------------------[]-------------------EE-----[]--------------------E-----[]-----------------------E-EE----------
XXXX-XXXXXXXXXXXXXXXXXXXXXXX-XXXXXXXXXXXXXXXXXXXXXXXXXXXXXX-----XXXXXXXXXXXXXXXXXXXXXX-------XXXXXXXXXXXXXXXXXXXX--------XXXXXXXXXXXXXXXXXXXXX-------XXXXXXXXXXXXXXXXXXXX---------XXXXXXXXXXXXXXXXXX----------XXXXXXXXXXXXXXXXXX----------XXXXXXXXXXXXXXXXXX----------XXXXXXXXXXXXXXXXXX-----------XXXXXXXXXXXXXXXXX----------XXXXXXXXXXXXXXXXXX----------XXXXXXXXXXXXXXXXXX----------XXXXXXXXXXXXXXXXXX----------XXXXXXXXXXXXXXXXXX----------XXXXXXXXXXXXXXXXXXXX-------XXXXXXXXXXXXXXXXXXX----------XXXXXXXXXXXXXXXXXX---------XXXXXXXXXXXXXXXXXXX----------XXXXXXXXXXXXXXXXXX---------XXXXXXXXXXXXXXXXXXX----------XXXXXXXXXXXXXXXXXXX--------XXXXXXXXXXXXXXXXXXXX---------XXXXXXXXXXXXXXXXXX----------XXXXXXXXXXXXXXXXXX----------XXXXXXXXXXXXXXXXXX-----------XXX-XXXXXXXXXXXXX---------XXXXXXXXXXXXXXXXXXX-----------XXXXXXXXXXXXXXXXX----------XXXXXXXXXXXXXXXXXX----------XXXXXXXXXXXXXXXXXX----------XXXXXXXXXXXXXXXXXX----------XXXXXXXXXXXXXXXXXX----------XXXXXXXXXXXXXXXXXX----------XXXXXXXXXXXXXXXXXX----------XXXXXXXXXXXXXXXXXX---------XXXXXXXXXXXXXXXXXXXXX-------XXXXXXXXXXXXXXXXXXXXXX-----XXXXXXXXXXXXXXXXXXXX----------XXXXXXXXXXXXXXXXXX----------XXXXXXXXXXXXXXXXXX---------XXXXXXXXXXXXXXXXXXX----------XXXXXXXXXXXXXXXXXX---------XXXXXXXXXXXXXXXXXXXXX-----XXXXXXXXXXXXXXXXXXXXXXX-----XXXXXXXXXXXXXXXXXXXXXXX-------XXXXXXXXXXXXXXXXXXXXX-------XXXXXXXXXXXXXXXXXXXXXX-----XXXXXXXXXXXXXXXXXXXXXXXXXXXXXXXXXXXXXXXXXXXX-XXX
