------------------S---S-----------------------S-----------------------------------------------------------------------------------------------------------------------------------------------------------------------------------------------------------------------------------------------------------------------------------------------------------------------------------------------------------------------------------------------------------------------------------SSSSS-----------------------S---S---------------------------------------------------S---S-------------------------------------------------------------------------------------------------------------------------------------------------------------------S---------------------------------------------------------------------------------------------------------------------------------------------------------------------------------------------------------------------------------------------------------------------------------------------------------------------------------------------------------------------------------------------------------------------------------------------------------------------------------------------------------------------------------------------------------------------------------------------------------------------------------------------------------------------------------------------------------
------------S-S---S------S--------------S-S---SXXX---S----------------------------------------------------------------------------------------------------------------------------------------------------------------------------------------------------------------------------------------------------------------------------------------------------------------------------------------------------------------------------------------------------------------------S-SS--XXXX---S----------------S---XXXX------------------S-SSS-XXXX---S--------------S-S----------S----------------------------------------------------------------------------------------------------------------------------------------------------------S-SS-XXXXX------------------------------------------------------------------------------------------------------------------------------------------------------------------------------------------------------------------------------------------------------------------------------------------------------------------------------------------------------------------------------------------------------------------------------------------------------------------------------------------------------------------------------------------------------------------------------------------------------------------------------------------------------------------------------------------------------
---X-----------------X---------------------------X-----------------------------------------------------------------------------------------------------------------------------------------------------------------------------------------------------------------------------------------------------------------------------------------------------------------------------------------------------------------------------------------------------------------------------------X---------------------------X---------------------------X---------------------------X---------------------------X-------------------------------------------------------------------------------------------------------------------------------------------X------------------------------------------------------------------------------------------------------------------------------------------------------------------------------------------------------------------------------------------------------------------------------------------------------------------------------------------------------------------------------------------------------------------------------------------------------------------------------------------------------------------------------------------------------------------------------------------------------------------------------------------------------------------------------------------------------
Eo---------XX--------X--E---Eo---------XX--------X--E-----------------------------------------------------------------------------------------------------------------------------------------------------------------------------------------------------------------------------------------------------------------------------------------------------------------------------------------------------------------------------------------------------------Eo---------XX-----X---------Eo---------XX-----X---------Eo---------XX---------------Eo---------XX--------X--E---------------------EXXX----------------------------------------------------------------------------------------------------------------------Eo---------XX-----X---------------------------------------------------------------------------------------------------------------------------------------------------------------------------------------------------------------------------------------------------------------------------------------------------------------------------------------------------------------------------------------------------------------------------------------------------------------------------------------------------------------------------------------------------------------------------------------------------------------------------------------------------------------------------------------------------------
XXX--o--ooo-oo-----XX--XXXX-XXX--o--ooo-oo-----XX--XXXX----------o-------------oooo-----------------------------oo----------------------------------------------------------------------------------o---------------------------o---------------------------o---------------------------o-------------------------------------------------------o---------------------------o-----------------------------------------------------------------------------------XXX-----oo--oo-----XX-------XXXX----oo--oo-----XX-------XXX-----oo--oo-----XX-------XXX-----ooE-oo-----XX---------------ooE--------XX--oooo-----------------------------oo----------------------------------------------------------------------------------XXX-----oo--oo-----XX------------------------------ooooo--------------------------------------------------------------------------------------------------------------------------------------------------------------------------------------------------------------------------------------------------------------------------------------------------------------------------------------------------------------------------------------------------------------------------------------------------------------------------------------------------------------------------------------------------------------------------------------------------------------------------------------------------------------------
-oo----------------XXX-------oo----------------XXX------XX-----XXXX-----------------------XXXXX-----------------XXX--o---XXXX-------S-------XXX------XX---------S--------------XXXX---------So------XX-----XXXXX----------------XX----XXXXX---------So------X------XXXXX----------------XX-----XXXX------------------------XXXX-----------------XX-----XXXX-----------------XX-----XXXX-----------------------XXXXX-----------------------XXXXX------------------oo----------------XXX-------oo----------------XXX-------oo----------------XXX-------oo----------------XXX-------oo----------E-----XXX-------------XXXX----XXX----------XX---ooXXXXX-----XX---------XX-----XXXX-----------------------XXXXX---------S--------oo----------------XXX------------XXXXX------------------------XXXX--------SSS------X--------XXX-------oSo-------------------------SSS------X-------XXXX--------oo------S-----XXXXX---------S-----------------XX-------SS--------------XXXX---------So----------------XX-------ooo-----------o----XXX------oS-------------XXXXX---------So-----------o----XX------SSSo-------------XXXXX--------SS------X------X-XX---------o--------------XXXX---------S-------X------XXXXX--------So-------------------------SSo----------------X---------So-------------XXXX---------SS------------XXXXX---------S--------------XX----------SSS-----------o-XXXXXX------oo-------X---------XX--------So------------XXXX---------SSo------
------oo-----------XX-------------oo-----------XX---------------------------------------------------------------------------------------------------------------------------------------------------------------------------------------------------------------------------------------------------------------------------------------------------------------------------------------------------------------------------------------------------------------------ooo----------XX-------------ooo----------XX-------------oo-----------XXX------------oo-----------XX---------------------XX---XX-----------------------------------------------------------------------------------------------------------------------------oo-----------XXX------------------------------------------------------------------------------------------------------------------------------------------------------------------------------------------------------------------------------------------------------------------------------------------------------------------------------------------------------------------------------------------------------------------------------------------------------------------------------------------------------------------------------------------------------------------------------------------------------------------------------------------------------------------------------------------------------
E-----------------XXX-------E-----------------XXX---------------------------------------------------------------------------------------------------------------------------------------------------------------------------------------------------------------------------------------------------------------------------------------------------------------------------------------------------------------------------------------------------------------E-----------------XXX-------E-----------------XXX-------E-----------------XXX-------E-----------------XXX-------E------------o---XXXX-----------------------------------------------------------------------------------------------------------------------E-----------------XXX-------------------------------------------------------------------------------------------------------------------------------------------------------------------------------------------------------------------------------------------------------------------------------------------------------------------------------------------------------------------------------------------------------------------------------------------------------------------------------------------------------------------------------------------------------------------------------------------------------------------------------------------------------XX----------------------------------------------
XXXXXX------------XXX-------XXXXXX------------XXX----------o--------------------------oo-----------------------------------------------------------------------------------o------------------------------------------------------------------------XXX----------------------------------------------------------------------------------------------------------------------------------------------------o----------------------------------------------------XXXXXX------------XXXX------XXXXXX------------XXXX------XXXXXX------------XXXX------XXXXXX-------------XX-------XXXX-------------XXXX-----------------------------------------------------------------------------------------------------------------------XXXXXX------------XXXX---------o---------------------------------------------XX-------------------------XXXX------------------------XXX--------------------------XX------------------------------------------------------XX-------------------------XXX-------------------------XXX-------------------------XXX--------------------------XX-------------------------XXX--------------------------XX--------------------------XX--------------------------XX-----------------------------------------------------XXXX-------------------------XXX---------------------------------------------------------------------------------XXX-------------------------XX-------------------------XXXX------------------------XXXX----
---------------XX-XXX----------------------XX-XXX---------------XXXXXX----------------------XXXXXX--XXXX----------------XXXXXXXXXX---XX--------------XXoo----XX-----------------XXXX----XXXX---XXX----------XXXXX---------------------XXXXXXXX---------------------XXXXXo-----------------------XXXX-----XX----------------XXXXX------------------------XXXX-----XX-----------------XXXXXXXX-XX-----------------XXXXX---XXXX---------------XXXXXXX-X-XXXX---------------------XXX-XXXX---------------------XX-XXXX---------------------XX-XXXX---------------------XX-XXX----------------XX----XX-XXX---------------XXXXXXXXXXXXX--------------XXXXXXXXX--------------------XXXX-----------------------XXXXXX------------------------------XX-XXXX--------------XXXXXXX--------------------XXX-oo----------------------XXXXoo--------------------XXXXX--o---------------------XXXX-oo----------------------XXXXoo----------------------XXX-oo--------------------XXXXXX-o----------------------XXXXoo---------------------XXXX--oXXX------------------XXXXXoo---------------------XXXX--o---------------------XXXXXoo-----------------------XXXoo---------------------XXXX-oo----------------------XXXXoo---------------------XXXX--o-o--------------------XXX-oo---------------------XXXXXXo----------------------XXXXX---------------------XXXXX-oo--------------------XXXXX---XXX-------------------XX--oo---------------------XXXXXoo---------------
--------------XX--XXX---------------------XXX-XXX----------------------------------------------------------------------------------------------------------------------------------------------------------------------------------------------------------------------------------------------------------------------------------------------------------------------------------------------------------------------------------------------------------------------------XXX--XXX---------------------XX--XXXX--------------------XXX-XXXX--------------------XX--XXX---------------------XXX-XXXX------------------------------------------------------------------------------------------------------------------------------------XXX-XXXX----------------------------------------------------------------------------E-------------------------------------------------------E-----------------------------------------------------------------------------------------------------------------------------------------------------------------------------------------------------------------------------------------------------------------------------------------------------------------------------------------------E-------------------------E-------------------------------------------------------------------------------------E-------------------------------------------------------E-----------------------------------------
-------------XXX--XXX--------------------XXXX-XXX---------------------o----XXXXX------------------------XXXXX---------------------------------------XXXXXXX------XXX---------------XXX-------------------------XXX-------XXX---------------XXX------------------------XXXX--------XXXX------------XXXX-------XXXX-------------XXXX--------XXX-------------XXXX------XXXXX------------------------XXXX--------------XXX-------XXXX------------------------XXXX---------------XXXX--XXX-------------------XXXX--XXX-------------------XXXX--XXXX-------------------XXX--XXX--------------------XXXX-XXXX-----o---------------------XXXX-------------------------XXX-------------XXXX--------XXX--------------XXX--------XXX----------------XXXX-XXXX--------------------o----XXXXXX------------XXXXXX----------------------XXXXXX----------------------XXXXXX-----X---------------XXXXXXXX------XX--------------XXXXX------XXX-------------XXXXXX---------X-XX----------XXXXX------X-X-------------XXXXXX---XXX-----------------XXXX----------X-XX---------XXXXXX------XXX--------------XXXXX-----------------------XXXXX----------------------XXXXXX-----XXXX-------------XXXXXX----------------------XXXXXX---------------------XXXXXXX---------------------XXXXXXX-----X-----------------XXXX-------XXXX-------------XXXX---------X------------XXXXXXXX-----------------------XXX-----XX--XX-----------XXXXXXX-----------------------XXXXX-------------
------------XXXX--XXX---EE-E------------XXXX--XXX---EE-EXXXXXXXXX----XX-------------XXXXXXXX--------------------XXXXXXXXXXX-------X---------XXXXXXXX--------------------XXXXXXXXX-------------------XXXXXXXXX-------------------XXXXXXXX--------------------XXXXXXXX--------------------XXXXXXXXX-------------------XXXXXXXX--------------------XXXXXXXX--------------------XXXXXXXXX-------------------XXXXXXXXX-------------------XXXXXXXXX------------------------------XXXXX--XXX---EE-E-----------XXXXX--XXXX--EE-E-----------XXXXX--XXXX--EE-E------------XXXX--XXX---EE-EXX----------XXXX---XXX----S?XXXXXXXXX-------------------XXXXXXXXX-------------------XXXXXXXX--------------------XXXXXXXX--------------------------------XXXX--XXXX--EE-EXXXXXXXXX----X--------------XXXXXXX---------------------XXXXXXX---------------------XXXXXXX---------------------XXXXXXX---------------------XXXXXXX---------------------XXXXXXX---------------------XXXXXXX---------------------XXXXXXX---------------------XXXXXXX---------------------XXXXXXX---------------------XXXXXXX---------------------XXXXXXX---------------------XXXXXXX---------------------XXXXXXX---------------------XXXXXXX---------------------XXXXXXX---------------------XXXXXXX---------------------XXXXXXX---------------------XXXXXXX---------------------XXXXXXX---------------------XXXXXXX---------------------XXXXXXX---------------------XXXXXXX---------------------
---------XXXXXX---XXXXXXXXXX---------XXXXXX---XXXXXXXXXXX---------------------------X-------------------------------------------------------X-------------------------------------------------------------------------------------------------------------------------------------------------------------------------------------------------------------------------------X-------------------------------------------------------------------------------------------XXXXXXX---XXXXXXXXXX---------XXXXXX---XXXXXXXXXX--------XXXXXXX---XXXXXXXXXX---------XXXXXX---XXXXXXXXXX----------XXXXX----XXS------X------------------------------------------------------------------------------------------------------------------------XXXXXX---XXXXXXXXXXX-----------------------------------------------------------------------------------------------------------------------------------------------------------------------------------------------------------------------------------------------------------------------------------------------------------------------------------------------------------------------------------------------------------------------------------------------------------------------------------------------------------------------------------------------------------------------------------------------------------------------------------------------------------------------------------------------
