------------------S---S-----------------------S-[SS-------------------------------------------------------------------------------------------------------------------------------------------------------------------------------------------------------------------------------------------------------------------------------------------------------------------------------------------------------------------------------------------------------------------------------S---------------------------------------------------------[]------------------------S-[]------------------------------------------------------------------------------------------------------------------------------------------------------------------------------------------------------------------------------------------------------------------------------------------------------------------------------------------------------------------------------------------------------------------------------------------------------------------------------------------------------------------------------------------------------------------------------------------------------------------------------------------------------------------------------------------------------------------------------------------------------------------------------------------------------------------------------------------------------------------------------
------------S-S---S------S--------------S-S---S-XX---S----------------------------------------------------------------------------------------------------------------------------------------------------------------------------------------------------------------------------------------------------------------------------------------------------------------------------------------------------------------------------------------------------------------------S-SS-XSXXX---S--------------S-SS-XXXXX---S--------------S-SS----XX---S--------------S-S---S-XX---S---------------------XX-----------------------------------------------------------------------------------------------------------------------------------SSSS-----X------------------------------------------------------------------------------------------------------------------------------------------------------------------------------------------------------------------------------------------------------------------------------------------------------------------------------------------------------------------------------------------------------------------------------------------------------------------------------------------------------------------------------------------------------------------------------------------------------------------------------------------------------------------------------------------------------
---------------------X---------------------------X-----------------------------------------------------------------------------------------------------------------------------------------------------------------------------------------------------------------------------------------------------------------------------------------------------------------------------------------------------------------------------------------------------------------------------------X---------------------------X---------------------------X---------------------------X---------------------------X----------------------------------------------------------------------------------------------------------------------------------S--------X------------------------------------------------------------------------------------------------------------------------------------------------------------------------------------------------------------------------------------------------------------------------------------------------------------------------------------------------------------------------------------------------------------------------------------------------------------------------------------------------------------------------------------------------------------------------------------------------------------------------------------------------------------------------------------------------------
Eo---------XX--------X--E---Eo---------XX--------X--------------------------------------------------------------------------------------------------------------------------------------------------------------------------------------------------------------------------------------------------------------------------------------------------------------------------------------------------------------------------------------------------------------Eo---------XX---------------Eo---------XX-----X---------Eo---------XX--------X--E---Eo---------XX--------X--E----------------------XX-----------------------------------------------------------------------------------------------------------------------Eo---------X-X--X-X---------------------------------------------------------------------------------------------------------------------------------------------------------------------------------------------------------------------------------------------------------------------------------------------------------------------------------------------------------------------------------------------------------------------------------------------------------------------------------------------------------------------------------------------------------------------------------------------------------------------------------------------------------------------------------------------------------
XXX--o--ooo-oo-----XX-----X-XXX-----ooo-oo-----XX---------------oo-------------ooooo--------------------------------------------------------o-------------------------------------------------------oo--------------------------o-----------------------------------------------------------------------------------------------------------------------------------------------------------------------oo--------------------------o---------------------------XXX-----ooo-oo-----XX-------XXX-----oo--oo-----XX-------XXX-----ooo-oo-----XX-------XXX--o--ooo-oo-----XX--X-XX---------oo---------XX---ooo-oo--------------------------------------------------------------------------------------------------------------XXXX----oo--SS--X--XX--------------------------------oo-------------------------------------------------------------------------------------------------------------------------------------------o---------------------------------------------------------------------------------------------------------------------------------------------o-----------------------------------------------------------------------------------o-------------------------------------------------------------------------------------------------------------------------------------------------------------------------------------------------------------------------------o---------o---------------------------------------------
-oo----------------XXX-------oo----------------XXX-------o-----XXXX--------XX-------X------XXXX-----------------X------XXXX-----------------XX----XXXXX-----------------------XXXXX-----------------XX-----XXXX---------S-------XX-----XXXX-----------------XX-----XXXX---------S-------------XXXXX---------S-------X------XXXX---------S-------XX----XXXXX-----------------X-----XXXXX-----------------XXX------XX-----------------X-----XXXXX------------------oo----------------XXX-------oo----------------XXX-------oo----------------XXX-------oo----------------XXX-------oo----XXXX--E-----XXX------X------XXXX-----------------X-----XXXXX-----------------------XXXXX---------S-------X------XXXX---------S--------oo----------------XXX---?--------XXXXX------------------------XXXXX--------So-------------------------SSS------S-----XXXXX---------So-------------XXXX---------S-------X-----XXXXX--------oo-------------XXXXX---------So-------------XX-----------SS----------------XX--------So-------------------------SSS------------XXXXX---------So------X----o----XX-------SSo------X------XXXX--------SSS------------XXXXX--------ooo------X----o----XXX------oo-------S------XXXX---------S-----------------X---------So------------XXXXX--------SSS-------------XXXXX--------S-------X------XXXXX-------oS--------------X-----------SSS------X-----XXXXXX--------So------XX---o----XX-------ooo------X---------XX-------ooo------
------oo-----------XX-------------ooo----------XX--------------------------XX-----------------------------------------------------------------------------------------------------------------------------------------------------------------------------------------------------------------------------------------------------------------------------------------------------------------------------------------------------------------------------------------oo-----------XX-------------ooo----------XX-------------oo-----------XX-------------oo-----------XX---------------------X?---XX-----------------------------------------------------------------------------------------------------------------------------ooo----------XXX------------------------------------------------------------------------------------------------------------------------------------------------------------------------------------------------------------------------------------------------------------------------------------------------------------------------------------------------------------------------------------------------------------------------------------------------------------------------------------------------------------------------------------------------------------------------------------------------------------------------------------------------------------------------------------------------------
E-----------------XXX-------E-----------------XXX---------------------------------------------------------------------------------------------------------------------------------------------------------------------------------------------------------------------------------------------------------------------------------------------------------------------------------------------------------------------------------------------------------------E-----------------XXX-------E-----------------XXX-------E------------------XX-------E-----------------XXX------------------------XXXX-----------------------------------------------------------------------------------------------------------------------E-----------------XXX-------------------------------------------------------------------------------------------------------------------------------------------------------------------------------------------------------------------------------------------------------------------------------------------------------------------------------------------------------------------------------------------------------------------------------------------------------------------------------------------------------------------------------------------------------------------------------------------------------------------------------------------------------------------------------------------------------
XXXXXX------------XXX-------XXXXXX------------XXX--------------------------------------------------------------------------------------------------------------------------o-----------------------------------------------------------------------------------------------------------------------------------------------------------------------o---------------------------o--------------------------------------------------------------------------------XXXXXX-------------XX-------XXXXXX------------XXX-------XXXXXX-------------XXX------XXXXXX-------------XX--------XX-------------XXXXX-----------------------------------------------------------------------------------------------------------------------XXXXXX------------XXXX----------------------------------------------------------------------------------XXX--------------------------XX-----------------------------------------------------XXX--------------------------XX--------------------------XX--------------------------XX-------------------------XXX-----------------------------------------------------XXXX------------------------XXXX------------------------XXX-------------------------XXX--------------------------XX--------------------------XX-------------------------XXX-----------------------------------------------------XXX--------------------------XX--------------------------XX-------------------------XXXX------------------------XXXX----
---------------XX-XXX----------------------XX-XXX-------------XXXXXXX-----------------------XXXXX----XX-----------------XXXXX--XXXXX----------------XXXXX----XX-----------------XXXX-----XXX----------------XXXXX----------------------XXXXXXXX-----X---------------XXXXX----XX----------------XXXXXo-----------------------XXXXo-----------------------XXXXX-----------------------XXXX-----XX------------------XXXo----X-----------------XXXXXX----XXX-----------------------XX-XXX---------------------XXX-XXXX---------------------XX-XXXX---------------------XX-XXX-------------X-XXXX---XXX-XX------X--------XXXXX--XXXXXXX-------------XXXXXXX----------------------XXXXX----XXX----------------XXXXX----XX-----------------------XXX-XXXX--------------XXXXXXX--------------------XXXXoo---------------------XXXX--o----------------------XXXXoo----------------------XXXooo----------------------XXXXXo---------------------XXXXXX---------------------XXXXX-oo----------------------XXX-oo--------------------XXXXX--o---------------------XXXXXX-----------------------XXX--o---------------------XXXXXoo--------------------XXXXXX-o----------------------XXXX-o----------------------XXXooo---------------------XXXX-oo---------------------XXXXXoo----------------------XXXXoo---------------------XXXXXXo---------------------XXXX-oo---------------------XXXXXXX----------------------XXXX-o----------------------XXXXoo---------------
--------------XX--XXX---------------------XX--XXX---------------------------o-------------------------------------------------------------------------------------------------------------------------------------------------------------------------------------------------------------------------------------------------------------------------------------------------------------------------------------------------------------------------------------------------XX--XXX--------------------XXX--XXX---------------------XX--XXX---------------------XX--XXX---------------------XXXX-XX------------------------------------------------------------------------------------------------------------------------------------XXXX-XXXX------------------------------------------------------------------------------------------------------E---------------------------------------------------------E-------------------------------------------------------------------------------------------------------------------------------------------------------------------------------------------------------------------------------------------------------------------------------------E-----------------------------------------------------------------------------------------------------------------------------------------------------------------------------------------------------------------------------------------------
-------------XXX--XXX-------------------XXXX--XXX---------------------o----XXXXX---------------XXX-------XXX----------------XX-------XXX--------------------------XXX-------------XXXX-------XXXX--------------XXX---------X--------------------------XXX--------------XXX-------XXX--------------XXXX--------XXX------------XXXXXX------XXXX--------------XXX-------XXX--------------XXXXX-----XXXXX-------------XXXX--------XXX--------------XXX--------XX----------------XXXX--XXX-------------------XXXX--XXX-------------------XXXX--XXX--------------------XXX--XXX--------------------XXXXX-XXXXX---o---------------------------------------XXX-------XXX---------------XXX---------X--------------XXXX-------XXXX---------------XXXX--XXXX--------------------------XXXXX------------XXXXXX-------XXX------------XXXXXX-----------------------XXXXXX--------------------XXXXXXX--------X--------------XXXXX-----------------------XXXX------XXXX-------------XXXXXX---------------------XXXXXXX----XX-----XX----------XXXXX------------------------XXX-------XXX-------------XXXXXX-----------------------XXXXX-----------------------XXXXX-----------------------XXXX-----------------------XXXXXX------XXX------------XXXXXXX-----------------------XXXXX----------------------XXXXXX-------XXX-------------XXXXX----------------------XXXXX-----XX------X-----------XXXX------XXX--------------XXXXX-----------------------XXXXX-------------
------------XXXX--XXX---EE-E-----------XXXXX--XXX---EE-EXXXXXXX------XXX------------XXXXXXXXX-------------------XXXXXXXXX-------------------XXXXXXXXX-------------------XXXXXXXXX-------------------XXXXXXXXX-------------------XXXXXXXXX-------------------XXXXXXXXX-------------------XXXXXXXX--------------------XXXXXXXX--------------------XXXXXXXXX-------------------XXXXXXXXX-------------------XXXXXXXXX-------------------XXXXXXXXX------------------------------XXXXX--XXX---EE-E-----------XXXXX--XXX---EE-E-----------XXXXX--XXX---EE-E------------XXXX--XXX---EE-EXXXX--------XXXXX--XXX------XXXXXXXXX-------------------XXXXXXXXX-------------------XXXXXXXXX-------------------XXXXXXXXX------------------------------XXXXX--XXXX--EE-EXXXXXXXXX-------------------XXXXXXX---------------------XXXXXXX---------------------XXXXXXX---------------------XXXXXXX---------------------XXXXXXXX--------------------XXXXXXX---------------------XXXXXXX---------------------XXXXXXX---------------------XXXXXXX---------------------XXXXXXX---------------------XXXXXXX---------------------XXXXXXX---------------------XXXXXXX---------------------XXXXXXXX--------------------XXXXXXX---------------------XXXXXXX---------------------XXXXXXX---------------------XXXXXXX---------------------XXXXXXXX--------------------XXXXXXX---------------------XXXXXXX---------------------XXXXXXX---------------------XXXXXXX---------------------
---------XXXXXX---XXXXXXXXXX---------XXXXXX---XXXXXXXXXXX---------------------------X-----------------------------------------------------------------------------------X------------------------------------------------------------------------------------------------------------------------------------------------------------------------------------------------------------------------------------------------------------------------------------------------XXXXXX---XXXXXXXXXX--------XXXXXXX---XXXXXXXXXX---------XXXXXX---XXXXXXXXXX---------XXXXXX---XXXXXXXXXXXX----------XXX----XX-------------------------------------------------------------------------------------------------------------------------------XXXXXXXX--XXXXXXXXXXX-----------------------------------------------------------------------------------------------------------------------------------------------------------------------------------------------------------------------------------------------------------------------------------------------------------------------------------------------------------------------------------------------------------------------------------------------------------------------------------------------------------------------------------------------------------------------------------------------------------------------------------------------------------------------------------------------
