------------------S---S-----------------------S---------------------------S-------------------------------------------------------------------------------------------------------------------------------------------------------------------------------------------------------------------------------------------------------------------------------------------------------------------------------------------------------------------------------------------------------S-[]------------------------S---------------------------S---------------------------S-XX------------------------S-[]--------------------------------------------------------------------------------------------------------------------------------------------------------------------------------------------------------------------------------------------------------------------------------------------------------------------------------------------------------------------------------------------------------------------------------------------------------------------------------------------------------------------------------------------------------------------------------------------------------------------------------------------------------------------------------------------------------------------------------------------------------------------------------------------------------------------------------------------------
------------S-S----------S--------------S-SS--S--X---S-X------------S-Q---SXXX---S------------------------------------------------------------------------------------------------------------------------------------------------------------------------------------------------------------------------------------------------------------------------------------------------------------------------------------------------------------------------------------------S-SS-XS-XX---S--------------S-S---S--X---S--------------S-SS-XSXXX---S--------------S-S---S-XX---S--------------S-S---S-XX---S----------------------------------------------------------------------------------------------------------------------------------------------------------SSSS-----X---S----------------------------------------------------------------------------------------------------------------------------------------------------------------------------------------------------------------------------------------------------------------------------------------------------------------------------------------------------------------------------------------------------------------------------------------------------------------------------------------------------------------------------------------------------------------------------------------------------------------------------------------------------------------------
---------------------X---------------------------X---------------------------X-------------------------------------------------------------------------------------------------------------------------------------------------------------------------------------------------------------------------------------------------------------------------------------------------------------------------------------------------------------------------------------------------------X---------------------------X---------------------------X---------------------------X---------------------------X--------------------------------------------------------------------------------------------------------------------------------------------------------------S--------X--------------------------------------------------------------------------------------------------------------------------------------------------------------------------------------------------------------------------------------------------------------------------------------------------------------------------------------------------------------------------------------------------------------------------------------------------------------------------------------------------------------------------------------------------------------------------------------------------------------------------------------------------------------------------
Eo---------XX--------X------Eo---------XX--------X--E---Eo---------XX--------X--E-------------------------------------------------------------------------------------------------------------------------------------------------------------------------------------------------------------------------------------------------------------------------------------------------------------------------------------------------------------------------------Eo---------XX---------------Eo---------XX---------------Eo---------XX-----X---------Eo---------XX--------X--E---Eo---------XX--------X--E-----------------------------------------------------------------------------------------------------------------------------------------------Eo---------XXX--X-X-X---------------------------------------------------------------------------------------------------------------------------------------------------------------------------------------------------------------------------------------------------------------------------------------------------------------------------------------------------------------------------------------------------------------------------------------------------------------------------------------------------------------------------------------------------------------------------------------------------------------------------------------------------------------------------
XXX--o--ooo-oo-----XX-------XXX--o--ooo-oo-----XX--XXXXXXXX--o--ooo-oo-----XX--X--X------------------------o-oo---------------------------o---------------------------------------------------------o---------------------------o---------------------------------------------------------------------------------------------------------------oo------------------------------------------------------oo--------------------------o---------------------------XXX-----ooo-oo-----XX-------XXX-----oo--oo-----XX-------XXX-----oo--oo-----XX-------XXX--o--ooo-oo-----XX----XX-XXX--o--ooo-oo-----XX-----X-----------------------------oo----------------------------------------------------------------------------------o---------------------------XXXX----oo--So--X--XX-------------------------------------------------------------------------oo---------------------------------------------------------------------------------------------------o----------------------------------------------------------------------------------------------------------------------------------------------------------------------oo--------------------------------------------------------------------------------------------------------------------------------------------------------------------------------------------------------------------------------------------------------------------------------------------------------------------
-oo----------------XXX-------oo----------------XXX-------oo----------------XXX-------------XXXX---------X-------X-----XXXXX-----------------------XXXXX---------S-------X------XXXX---------S-------XX-----XXXXX--------S-------XX-----XXXX-----------------X------XXXX---------S-------XX----XXXXX---------Soo-----X------XXXX------X----------XXX----XXXX-----------------X------XXXXX--------So------XX-----XXXX-----------------X------XXXX------X-----------oo----------------XXX-------oo----------------XXX-------oo----------------XXX-------oo----------------XXX-------oo----------------XXX------X------XXXX----X------------XXX----XXXX-----------------------XXXXX---------S-------X------XXXX---------S-------XX-----XXXX------X-----------oo----------------XXX---?--X-----XXXXX------------------------XXXX---------So------XX--------XX--------oo-------------XXXX---------S--------------------------SS-----------------XX-------ooo----------------X---------SS-------------XXXX---------S--------------XXXXX--------SS-------------------------SS-------S------XXXX---------So------XX--------XX-------ooo-------------XXX---------SSS------X---------XX-------SS-------------XXXXX---------S-------------XXXXX---------S-------S------------------SSS----------------XX-------ooo-------------XXXXX----------------------XXXXX----------------------o----XXX-----SSSo------X--------XXX--------o-------------XXXXX---------SS------
------oo-----------XX-------------oo-----------XXX------------oo-----------XX-----------------------E-----------------------------------------------------------------------------------------------------------------------------------------------------------------------------------------------------------------------------------------------------------------------------------------------------------------------------------------------------------------ooo----------XX-------------ooo----------XX-------------ooo----------XX-------------oo-----------XX-------------oo-----------XX---------------------------------------------------------------------------------------------------------------------------------------------------------ooo----------XXX--------------------------------------------------------------------------------------------------------------------------------------------------------------------------------------------------------------------------------------------------------------------------------------------------------------------------------------------------------------------------------------------------------------------------------------------------------------------------------------------------------------------------------------------------------------------------------------------------------------------------------------------------------------------------
E-----------------XXX-------E-----------------XXX-------E------------------XX-----------------------------------------------------------------------------------------------------------------------------------------------------------------------------------------------------------------------------------------------------------------------------------------------------------------------------------------------------------------------------------E-----------------XXX-------E-----------------XXX-------E-----------------XXX-------E-----------------XXX-------E-----------------XXX---------------------------------------------------------------------------------------------------------------------------------------------------E-----------------XXXX--------------------------------------------------------------------------------------------------------------------------------------------------------------------------------------------------------------------------------------------------------------------------------------------------------------------------------------------------------------------------------------------------------------------------------------------------------------------------------------------------------------------------------------------------------------------------------------------------------------------------------------------------------------------------
XXXXXX-------------XX-------XXXXXX------------XXXX------XXXXXX-------------XX-------------------------------------oo---------------------------------------------------------------------------------------------------------------------------------X-------------------------------------------------------XX-------------------------------------------------------------------------------------------------------------------------------------------------XXXXXX------------XXX-------XXXXXX------------XXX-------XXXXXX------------XXXX------XXXXXX------------XXX-------XXXXXX------------XXX---------------------------------------------------------------------------------------------------------------------------------------------------XXXXXX------------XXXX---------o---------------------------o------------------X--------------------------XX--------------------------XX--------------------------XX-------------------------XXXX-------------------------XX------------------------------------------------------XX--------------------------XX--------------------------XX-------------------------XXXX-------------------------XX--------------------------XX----------------------------------------------------------------------------------XXX-------------------------XX------------------------------------o--------------------------------------------XXXX-------------------------XX---------------------------X-----
---------------XX-XXX----------------------XX-XXXX---------------------X--XXX--------------XXXXXXX----------------------XXXXXX---------------------XXXXXXX---------------------XXXXXo-----------------------XXXXo----XX----------------XXXXX------------------------XXXXo----XXX---------------XXXXX------------------------XXXXX-----------------------XXXXX----XX----------------XXXXX------------------------XXXX-----XX-----------------XXXXXXXXXXXX----------------------XXX-XXX----------------------XX-XXX----------------------XX-XXXX---------------------XX-XXX----------------------XX-XXX---------------XXXXXXXXXXXX----------------XXXXXX----------------------XXXX----XXXX----------------XXXXo----XX-----------------XXXXXX----------------------------XXX-XXXX--------------XXXXX----XXX----------------XXXoo----------------------XXXXoo--------------------XXXXX-oo----------------------XXXooo---------------------XXXX--o--------------------XXXXX--o---------------------XXXXXoo---------------------XXXXXX-XXX------------------XXXX-oo----------------------XXXXoo----------------------XXXXoo---------------------XXXX-oo----------------------XXXXoo----------------------XXXXoo---------------------XXXXXoo-------------------------ooo----------------------XXXXoo----------------------XXXXXX-----------------------XXXXo---------------------XXXX--o----------------------XXXXoo---------------------XXXX-oo---------------
--------------XX--XXX---------------------XXX-XXXX--------------------XX--XXX---------------------------o---------------------------------------------------------------------------------------------------------------------------------------------------------------------------------------------------------------------------------------------------------------------------------------------------------------------------------------------------------------------XX--XXX---------------------XX--XXX---------------------XXX-XXXX--------------------XX--XXX---------------------XX--XXX----------------------------------------------------------------------------------------------------------------------------------------------------------------XXXX-XXXX----------------------------------------------------------------------------------------------------------------------------------E-----------------------------E-----------------------------------------------------------------------------------------------------------------------------------------------------------------------E-----------------------------------------------------------------------------------------------------------------------------------------E-----------------------------------------------------------------------------------------------------------------E---------------------------------------------------------------------
-------------XXX--XXX--------------------XXXX-XXX--------------------XXX--XXX---------------------o----XXXXX----------------XX-------XXXX--------------XXX---------X--------------XXXXX--------X--------------XXXX--------XXX-------------XXXX-------XXXX------------XXXXX--------XXX-------------XXXXX-------XX--------------XXXX-------XXXX-------------XXXX------XXXXX-------------XXXX--------XXX-------------XXXX-------XXXX-----------------------XXXXXX--------------XXXX--XXX-------------------XXXX--XXX-------------------XXXX--XXX--------------------XXX--XXX--------------------XXX--XXX---------------------------XXXXX--------------XXX-------XXX--------------XXXX-------XXXX------------XXXXXX------XXXX---------------XX-------XXXX---------------XXXXX-XXXX-----------------XXX-------XXXX------------XXXXXX---------------------XXXXXXX---XXX---X-XX---------XXXXXX---------------------XXXXXXX---------------------XXXXXXX----------------------XXXXXX----------------------XXXXXX-----XXXXX--------------XXX----------------------XXXXXXX-----X------X---------XXXXXX---------------------XXXXXXX----------------------XXXXXX----------------------XXXXXX-----------------------XXXXX------XXXX-------------XXXX-------XXXX-----------XXXXXXX-----X----------------XXXXXX---XXX------X-----------XXX-------XXXX-------------XXXXX-----XXXXX------------XXXXXX-----------------------XXXXX----XXXXXX------------XXXXXX-------------
-----------XXXXX--XXX---EE-E------------XXXX--XXX---EE-E------------XXXX--XXX---EE-EXXXXXXXX-----XXX------------XXXXXXXXX-------------------XXXXXXXXX-------------------XXXXXXXXX-------------------XXXXXXXXX-------------------XXXXXXXX--------------------XXXXXXXX--------------------XXXXXXXX--------------------XXXXXXXX--------------------XXXXXXXX--------------------XXXXXXXX--------------------XXXXXXXXX-------------------XXXXXXXXX------------------------------XXXXX--XXX---EE-E-----------XXXXX--XXX---EE-E-----------XXXXX--XXXX--EE-E------------XXXX--XXX---EE-E------------XXXX--XXX---EE-EXXXXXXXXX-------------------XXXXXXXXX-------------------XXXXXXXXX-------------------XXXXXXXXX-------------------XXXXXXXXX------------------------------XXXXX--XXXX--EE-EXXXXXXXXX-------------------XXXXXXX---------------------XXXXXXX---------------------XXXXXXX---------------------XXXXXXX---------------------XXXXXXX---------------------XXXXXXX---------------------XXXXXXX---------------------XXXXXXX---------------------XXXXXXX---------------------XXXXXXX---------------------XXXXXXX---------------------XXXXXXX---------------------XXXXXXX---------------------XXXXXXX---------------------XXXXXXX---------------------XXXXXXX---------------------XXXXXXX---------------------XXXXXXXX--------------------XXXXXXX---------------------XXXXXXX---------------------XXXXXXX---------------------XXXXXXX---------------------
---------XXXXXX---XXXXXXXXXX---------XXXXXX---XXXXXXXXXX---------XXXXXX---XXXXXXXXXXX---------------------------X--------------------------------------------------------------------------------------------------------------------------------------------------------------------------------------------------------------------------------------------------------------------------------------------------------------------------------------------------------XXXXXX---XXXXXXXXXX---------XXXXXX---XXXXXXXXXX--------XXXXXXXX--XXXXXXXXXX---------XXXXXX---XXXXXXXXXX---------XXXXXX---XXXXXXXXXXX---------------------------------------------------------------------------------------------------------------------------------------------------XXXXXXXX--XXXXXXXXXX------------------------------------------------------------------------------------------------------------------------------------------------------------------------------------------------------------------------------------------------------------------------------------------------------------------------------------------------------------------------------------------------------------------------------------X---------------------------------------------------------------------------------------------------------------X---------------------------------------------------------------------------------------------------------------
