------------------S---------------------------SSSSS---------------------------------------------------------------------------------------------------------------------------------------------------------------------------------------------------------------------------------------------------------------------------------------------------------------------------------------------------------------------------------------------------S-[]--------------------------[]--------------------------XX------------------------S-[]------------------------S-[]------------------------------------------------------------------------------------------------------------------------------------------------------------------------------------------------------------------------------------------------------------------------------------------------------------------------------------------------------------------------------------------------------------------------------------------------------------------------------------------------------------------------------------------------------------------------------------------------------------------------------------------------------------------------------------------------------------------------------------------------------------------------------------------------------------------------------------------------------------------------------
------------------XXXX-----X------------------XXXX----------------------------------------------------------------------------------------------------------------------------------------------------------------------------------------------------------------------------------------------------------------------------------------------------------------------------------------------------------------------------------------------S-SS--S-XX---SS-------------S-SS-XXXXX---S--------------SSSSS-XXXX---S----X---------S-SS-XS-XX---S--------------S-S---S-XX---S-X----------------------------------------------------------------------------------------------------------------------------S--SS-X--X---S------------------------------------------------------------------------------------------------------------------------------------------------------------------------------------------------------------------------------------------------------------------------------------------------------------------------------------------------------------------------------------------------------------------------------------------------------------------------------------------------------------------------------------------------------------------------------------------------------------------------------------------------------------------------------------------------------------------------------
---------------------X------------X--------------X-------------------------------------------------------------------------------------------------------------------------------------------------------------------------------------------------------------------------------------------------------------------------------------------------------------------------------------------------------------------------------------------------------X------------------S--------X---------------------------X---------------------------X---------X-----------------X----------------------------------------------------------------------------------------------------------------------------------S-----X--X----------------------------------------------------------------------------------------------------------------------------------------------------------------------------------------------------------------------------------------------------------------------------------------------------------------------------------------------------------------------------------------------------------------------------------------------------------------------------------------------------------------------------------------------------------------------------------------------------------------------------------------------------------------------------------------------------------------------------------
---------------------X--E---------------------EXXX--E-------------------------------------------------------------------------------------------------------------------------------------------------------------------------------------------------------------------------------------------------------------------------------------------------------------------------------------------------------------------------------Eo---------XX--------X--E---Eo---------XX-----X---------Eo---------XX-----X---------Eo---------XX--------X--E---Eo---------XX--------X--E-------------------------------------------------------------------------------------------------------------------Eo---------XX-----X-------------------------------------------------------------------------------------------------------------------------------------------------------------------------------------------------------------------------------------------------------------------------------------------------------------------------------------------------------------------------------------------------------------------------------------------------------------------------------------------------------------------------------------------------------------------------------------------------------------------------------------------------------------------------------------------------------------------------------------
-----o--ooo-oo-----XX--ooXX---------ooo-oo-----XX---oXX--------------------------oo---------------------------------------------------------o---------------------------------------------------------------------------------------------------------------oo-------ooo----------------o---------------------------o---------------------------o---------------------------oo--------------------------oo--------------------------XXX--o--ooo-oo-----XX--XXXXXXXXX----oo--oo-----XX-------XXXX----oo--oo-----XX-------XXX-----ooo-oo-----XX-----X-XXX--o--ooo-oo-----XX--XXXXXo---------------------------o---------------------------oo--------------------------oo--------------------------XXXX----oo--oo--X--XX--------------------------------ooo----------------------------------------------------------------------------------------------------------------o---------------------------------------------------------------------------------------------------------------------------------------------------------------------------------------------------------------------------------------------------------------------------------------------------------------------------------------------------------------------------o------------------------oo---------------------------------------------------------------------------------------------------------------------------------------------o---------------------------
-oo----------------XXX-------oo----------E-----XXX-------------XXXX-----------------------XXXXX-----------------------XXXXX-----------------XX-----XXXX-----------------X-----XXXXX---------S--------------XXXXX--------S--------------XXXXX--------S-------XXX---XXXXX---------So------XX-----XXXX-----------------X----o-XXXXX-------oS-------X------XXXX---------S-------XX----XXXXX-----------------XX-----XXXX------------------oo----------------XXX-------oo----------------XXX-------oo----------------XXX-------oo----------------XXX-------oo----------------XXX------XX----XXXXX-----------------XX-----XXXXX----------------XX-----XXXXX----------------XX-----XXXX------------------oo----------------XXX------XX----XXXXX---------o----------------XX-------SSSS------------XXXXX--------SSS------S-----XXXXX---------So-----------o----XXX-----SSS------------o-XXXXXX-------S--------------XXXX--------SS--------------XXXXX--------So------S-----XXXXX---------S-------S-----XXXXXX--------So------X------XXXX---------SS--------------XXX---------So--------------------------S-------------XXXXX---------SS----------------XX-------SS--------------XXXX---------S--------------XXXX---------S-------------XXXXX---------S-------XX----XXXXXX----------------------XXXXX---------S--------------XXXX--------SSS------------XXXXX---------SS------------XXXXX---------So------------XXXXX---------oo------X------XXXXX-------oo-------
-------o-----------XX--------------------------XXX----------------------------------------------------------------------------------------------------------------------------------------------------------------------------------------------------------------------------------------------------------------------------------------------------------------------------------------------------------------------------------------oo-----------XX-------------ooo----------XX-------------ooo----------XXX------------oo-----------XX-------------oo-----------XX-----------------------------------------------------------------------------------------------------------------------------ooo----------XXX----------------------------------------------------------------------------------------------------------------------------------------------------------------------------------------------------------------------------------------------------------------------------------------------------------------------------------------------------------------------------------------------------------------------------------------------------------------------------------------------------------------------------------------------------------------------------------------------------------------------------------------------------------------------------------------------------------------------------------
E------------o---XXXX-------E------------o---XXXX-----------------------------------------------------------------------------------------------------------------------------------------------------------------------------------------------------------------------------------------------------------------------------------------------------------------------------------------------------------------------------------E-----------------XXX-------E----------------XXXX-------E-----------------XXX-------E------------------XX-------E----------------XXXX-----------------------------------------------------------------------------------------------------------------------E-----------------XXX-----------------------------------------------------------------------------------------------------------------------------------------------------------------------------------------------------------------------------------------------------------------------------------------------------------------------------------------------------------------------------------------------------------------------------------------------------------------------------------------------------------------------------------------------------------------------------------------------------------------------------------------------------------------------------------------------------------------------------------
XXXXX-------------XXXX------XXXXX-------------XXXX-----------------------------------------------------------------o---------------------------------------------------------------------------------------------------------------------------------------------------------------------------------------------------------------------XX-----------------------------------------------------------------------------------------XXXXXX------------XXXX------XXXXXX------------XXXX------XXXXXX------------XXXX------XXXXXX-------------XX-------XXXXX-------------XXX-----------------------------------------------------------------------------------------------------------------------XXXXXX------------XXXX--------------------------XXX--------------------------XX--------------------------XX--------------------------XX-------------------------XXX----------------------------------------------------------------------------------XX--------o---------------------------------------------XX-----------------------------------------------------XXXX----------------------------------------------------XXX--------------------------XX--------------------------------------------------------------------------------------------------------------X---------------------------XX--------------------------XX--------------------------XX--------------------------XX--------------------------XX--------------------------XX-----
---------------XX-XXXX---------------------XX-XXXX-------------XXXXXXX----------------------XXXXXXXXXXXXX--------------XXXXXX--XXXXX---------------XXXXXX----XX----------------XXXXX-----------------------XXXXXXX-X-------------------XXXXX------------------------XXXX-----------------------XXXXXXXX-----XX-------------XXXX-oXXX-------------------XXXXX-----XX----------------XXXXXXXX---------------------XXXXXXXXXXXXXX---------------------XX-XXXX--------------------XXX-XXXX---------------------XX-XXXX---------------------XX-XXX----------------------XX-XXXX--------------XXXXX---XXXX----------------XXXX------------------------XXXXo-----------------------XXXXX----XX-----------------------XXX-XXXX-------------XXXXXXX----------------------XXooo----------------------XXXXoo----------------------XXXXXo---------------------XXXX--o----------------------XXXXoo----------------------XXXXoo---------------------XXXXX-o----------------------XXXXXo---------------------XXXXXXo----------------------XXXXoo--------------------XXXXX-oo----------------------XXXooo--------------------XXXXXXX----------------------XXXXXoo---------------------XXXXXoo----------------------XXXXoo----------------------XXXooo----XX----------------XXXXXXX--------------------XXXXXoo--------------------XXXXX-oo---------------------XXXXXXo---------------------XXXXXoo---------------------XXXXXoo----------------------XXXXoo---------------
--------------XXX-XXXX--------------------XXX-XXXX--------------------------o---------------------------------------------------------------------------------------------------------------------------------------------------------------------------------------------------------------------------------------------------------------------------------------------------------------------------------------------------------------------XXX-XXXX-------------------XXXX-XXXX--------------------XX--XXXX--------------------XX--XXX---------------------XXX-XXX-------------------------------------------------------------------------------------------------------------------------------------XX--XXXX----------------------------------------------------------------------------------------------------------------------------------------------------------------------------------------------------------------------------------------------------------------------------------------------------------------------------------------E-------------------------E-------------------------------------------------------------------------------------------------------------------------------------------E-----------------------------------------------------------------------------------------------------------------------------------------------------------------------E-------------------------------------------
-------------XXXX-XXXX-------------------XXXX-XXXX--------------------o----XXXXX-------------------------XXXX------------------------XXXX--------------XXX-------XXXX-------------XXXXX--------X---------------XXX--------XXX-------------XXXX--------XXX------------XXXXXX-------XX--------------------------XXX-------------XXXX----------X-------------XXXX--------XXX------------------------XXXX-------------------------XXX----------------XXXX-XXX-------------------XXXX--XXX-------------------XXXX--XXX-------------------XXXX--XXX--------------------XXXX-XXX-----------------------------XXX-------------XXXX-------XXXX-------------XXXX-------XXXX-------------XXXX-------XXXX---------------XXXX--XXXX-----------------XXX------XXXX-------------XXXXXX----------------------XXXXXX-----------------------XXXXX-----XXXX--------------XXXX------------------------XXXX----------X------------XXXXXX-----------------------XXXXX-----XXXX--------------XXXXX------XXX--------------XXXXX-----XXXX-------------XXXXXX------XXX-------------XXXXXX---------------------XXXXXXX----XXXXX---------------XXX---------X-------------XXXXX------X----------------XXXXXX----XXXXXX------------XXXXXX--------X-------------XXXXXX------XXX---------------XXX-------XXXX-------------XXXXX--------X-------------XXXXXX-----------------------XXXXX------XXX-------------XXXXXX----------------------XXXXXX------XXX--------------XXXX-----XX--XX--X
------------XXXX--XXXX--EE-?------------XXXX--XXXX--E-S?XXXXXXXX-----XX-------------XXXXXXXXX-------------------XXXXXXXXX-------------------XXXXXXXXX-------------------XXXXXXXX--------------------XXXXXXXXX-------------------XXXXXXXX--------------------XXXXXXXX--------------------XXXXXXXX--------------------XXXXXXXX--------------------XXXXXXXXX-------------------XXXXXXXXX-------------------XXXXXXXXX-------------------------------XXXX--XXX---EE-E-----------XXXXX--XXXX--EE-E-----------XXXXX--XXXX--EE-E-----------XXXXX--XXX---EE-E------------XXXX--XXX---EE-EXXXXXXXXX-------------------XXXXXXXX--------------------XXXXXXXXX-------------------XXXXXXXXX------------------------------XXXXX--XXXX--EE-EXXXXXXXX--------------------XXXXXXX---------------------XXXXXXX---------------------XXXXXXX---------------------XXXXXXX---------------------XXXXXXXX--------------------XXXXXXX---------------------XXXXXXX---------------------XXXXXXX---------------------XXXXXXX---------------------XXXXXXX---------------------XXXXXXX---------------------XXXXXXX---------------------XXXXXXX---------------------XXXXXXX---------------------XXXXXXX---------------------XXXXXXX---------------------XXXXXXX---------------------XXXXXXXXX-------------------XXXXXXX---------------------XXXXXXX---------------------XXXXXXX---------------------XXXXXXX---------------------XXXXXXX---------------------XXXXXXX---------------------
---------SXXXXX---XXXSXXS?SX---------SXXXXX---XXXS--??S?X---------------------------X---------------------------X----------------------------------------------------------------------------------------------------------------------------------------------------------------------------------------------------------------------------------------------------------------------------------------------------------------------------XXXXXX---XXXXXXXXXX--------XXXXXXXX--XXXXXXXXXX--------XXXXXXX---XXXXXXXXXX---------XXXXXX---XXXXXXXXXX---------SXXXXX---XXXXXXXXXX------------------------------------------------------------------------------------X-----------------------------------XXXXXXX---XXXXXXXXXX------------------------------------------------------------------------------------X-------------------------------------------------------------------------------------------------------------------------------------------X---------------------------------------------------------------------------------------------------------------------------------------------------------------------------------------------------------------------------------------------------------------------------------------------------------------------------------------------------------------------------X---------------------------------------------------------------------------------------------------------------
