------------------S-[]------------------------S-[]--------------------------------------------------------------------------------------------------------------------------------------------------------------------------------------------------------------------------------------------------------------------------------------------------------------------------------------------------------------------------------------------------------------------------------S-[]------------------------S---------------------------SSSS------------------------S--SS-----------------------S---S-------------------------------------------------------------------------------------------------------------------------------------------------------------------------------------------------------------------------------------------------------------------------------------------------------------------------------------------------------------------------------------------------------------------------------------------------------------------------------------------------------------------------------------------------------------------------------------------------------------------------------------------------------------------------------------------------------------------------------------------------------------------------------------------------------------------------------------------------
------------S-S---S-XX---S--------------SQSS--S-XX---S----------------------------------------------------------------------------------------------------------------------------------------------------------------------------------------------------------------------------------------------------------------------------------------------------------------------------------------------------------------------------------------------------------------------S-S-XXS-XX---S--------------SQSS-XS------S--------------S-SS-XSSSS---S----X---------S-S------SS--S---------------------------S----------------------------------------------------------------------------------------------------------------------------------------------------------------------------------------SS-----X----------------------------------------------------------------------------------------------------------------------------------------------------------------------------------------------------------------------------------------------------------------------------------------------------------------------------------------------------------------------------------------------------------------------------------------------------------------------------------------------------------------------------------------------------------------------------------------------------------------------------------------------
---------------------X---------------------------X-----------------------------------------------------------------------------------------------------------------------------------------------------------------------------------------------------------------------------------------------------------------------------------------------------------------------------------------------------------------------------------------------------------------------------------X---------------------------X---------------------------X---------X-----------------X---------------------------X------------------------------------------------------------------------------------------------------------------------------------------------------------------------------------------S--------X----------------------------------------------------------------------------------------------------------------------------------------------------------------------------------------------------------------------------------------------------------------------------------------------------------------------------------------------------------------------------------------------------------------------------------------------------------------------------------------------------------------------------------------------------------------------------------------------------------------------------------------------
Eo---------XX--------X--E---Eo---------XX--------X--E-----------------------------------------------------------------------------------------------------------------------------------------------------------------------------------------------------------------------------------------------------------------------------------------------------------------------------------------------------------------------------------------------------------Eo-------X-XX---------------Eo---------XX--------X------Eo---------XX---------------Eo---------XX--------E--E---Eo---------XX--------X--E----------------------------------------------------------------------------------------------------------------------------------------------------------------------------o--------------X-X-------------------------------------------------------------------------------------------------------------------------------------------------------------------------------------------------------------------------------------------------------------------------------------------------------------------------------------------------------------------------------------------------------------------------------------------------------------------------------------------------------------------------------------------------------------------------------------------------------------------------------------------------
XXX-----ooo-oo-----XX-------XXX-----ooo-oo-----XX-------oo--------------------------o---------------------------oo------------------------------------------------------oo------------------------------------------------------oo------------------------------------------------------oo--------------------------o---------------------------oo------------------------------------------------------o---------------------------o---------------------------XXX-----oo--oo-----XX-------XXX-----oo--oo-----XX-------XXX-----oo--oo-----XX-------XXX--o--ooo-oo-----XXX-XXXXXXXX--o--ooo-oo-----XX-----X-oo--------------------------o---------------------------oo--------------------------oo-------ooo----------------o---------------------------o---------------X-----------XXX-----oo--So-XX--XX-------oo--------------------------------------------------------------------------------------------------------------------------------------------------------------------------------------------------------------------------------------------------------------------------------------------------------------------------------------------------------------------------------------------------------------------------------------------------------------------------------------------------------------------------------------------------------------------------------------------------------------------------------------
-oo----------------XXX-------oo----------------XXX------XX-----XXX-----------------------o-XXXX------X----------XX---o-XXXX-----------------------XXXXX---------So------XX---o---XXXX------oo-------------XXXXX---------S-------XX-----X-XX-----------------------XXXXX---------SQo-----XX-----XXXX-----------------XX-----XXXX-----------------XX-----XXXX---------So------------XXXXX---------S-------XX-----XXXX-----------------XX-----X---------------------oo----------------XXX-------oo----------------XXX-------oo----------------XXX-------oo----------------XXX-------oo----------------XXX------XX---ooXXX------------------X------XXXX----X-X----------XX---o-XXXXX-----X----------XXX-------------------------XX-----XXXXXX-------S-------X------XXXX----XXXX----------oo----------------XXX---?--XXX--ooX-XX------------------------------------SSS------X--------XXX--------oo----------------XX--------So------X--------XX-----------------X------X-XXX-------oS--------------XXXX---------S-------------XXXXXX--------So------------XXXXX---------S-------------XXXXXX-----------------------XXXXX--------oo------------XXXXX---------So------S-----XXXX---------SSSS------------XXXXX--------S-------X--------XXX--------o-------X---------X--------oSo------------XXXXX---------So------------XXXXX---------S-------X------XXXX---------S-------X----o----XXX------ooo------S-----XXXXX---------SS-------------XXX----------SS------
-----oooo----------XX-------------oo-----------XXX--------------------------------------------------------------------------------------------------------------------------------------------------------------------------------------------------------------------------------------------------------------------------------------------------------------------------------------------------------------------------------------------------------------------ooo----------XX-------------ooo----------XX-------------ooo----------XX-------------oo-----------XX-------------oo-----------XX-------------------------------------------------------------------------------------------------------------------------------------------------------------------------------------ooo----------XXX----------------------------------------------------------------------------------------------------------------------------------------------------------------------------------------------------------------------------------------------------------------------------------------------------------------------------------------------------------------------------------------------------------------------------------------------------------------------------------------------------------------------------------------------------------------------------------------------------------------------------------------------
E-----------------XXX-------E-----------------XXX---------------------------------------------------------------------------------------------------------------------------------------------------------------------------------------------------------------------------------------------------------------------------------------------------------------------------------------------------------------------------------------------------------------E-----------------XXX-------E-----------------XXX-------E-----------------XXX-------E------------------XX-------E-----------------XXX-------------------------------------------------------------------------------------------------------------------------------------------------------------------------------E-----------------XXXX----------------------------------------------------------------------------------------------------------------------------------------------------------------------------------------------------------------------------------------------------------------------------------------------------------------------------------------------------------------------------------------------------------------------------------------------------------------------------------------------------------------------------------------------------------------------------------------------------------------------------------------------
XXXXXX-------------XX-------XXXXXX------------XXXX--------------------------------------------------------------------------------------------------------------------------------------------------------------------------------------------------------------------------------------------------------------------------------------------------------------------------------------------------------------------------------------------------------------XXXXXX------------XXX-------XXXXXX------------XXX-------XXXXXX------------XXX-------XXXXXX-------------XX-------XXXXXX------------XXX-------------------------------------------------------------------------------------------------------------------------------------------------------------------------------XXXXX-------------XXXX------------------------------------------------------XXXX-------------------------XX--------------------------XX------------------------------------------------------XX--------------------------XX--------------------------------------------------------------------------------------------------------------XX--------------------------XX--------------------------XX--------------------------XX--------------------------XX--------------------------XX-------------------------XXX---------------------------------------------------------------------------------XXXX-------------------------XX---------------------------------
--------------XX--XXX----------------------XX-XXXX--------------XXXXXX-XXXX----------------XXXXXXXXX---XXX--------------XXXXXXXX-------------------XXXXoo----------------------XXXX-oXXX-------------------XXXXX-----XX-----------------XXXXo---------------------XXXXXX------------------------XXXXX-----------------------XXXXXX-XXXXX---------------XXXXX-----------------------XXXXXX----XXX----------------XXXXX----XX-----------------XXXXXXXXXXX-----------------------XX--XXX---------------------XXX-XXX---------------------XXX-XXX----------------------X--XXX----------------------XX-XXX---------------XXXXXX-X-X------------------XXXXX--XXXXX---------------XXXXXXXX----------------------XXXo----------------------XXXXoo-----------------------XXXXXX-XXXXXX---------------------XXX-XXXX-------------XXXXXXXXX------------------XXXX-oo----------------------XXXXoo---------------------XXXX-oo----------------------XXXooo----------------------XXXXoo---------------------XXXXXoo---------------------XXXXXXo----------------------XXXXoo----------------------XXXXXo---------------------XXXXXoo--------------------XXXXXXXo---------------------XXXXooo---------------------XXXXXXo----------------------XXXXoo----------------------XXX-oo--------------------XXXXXXX-----------------------XXXXXo---------------------XXXXXX-----------------------XXX-oo---------------------XXXXooo----------------------X--ooo---------------
-------------XXX--XXX---------------------XXX-XXX-----------------------------------------------------------------------------------------------------------------------------------------------------------------------------------------------------------------------------------------------------------------------------------------------------------------------------------------------------------------------------------------------------------------------------XX--XXX---------------------XX--XXX---------------------XX--XXX---------------------XX--XXX---------------------XX--XXX--------------------------------------------------------------------------------------------------------------------------------------------------------------------------------------------XXXX-XXXX------------------------------------------------E---------------------------------------------------------------------------------E-----------------------------------------------------------------------------------------------------------------------------------------------------------------------------------------------------------------------------------------------------------------------------------------------------------------------------------------------------------------------------------------------------------------------------------------------------------------------------------------------------------
------------XXXX--XXX--------------------XXX--XXX----------------------------XXXX--------------------------XX---------------X----------X-------------XXXXXX------XXXX-------------XXXX----------XXXX----------XXXX--------XXX-------------XXXX--------XX--------------XXXXX------XXX---------------XXX-------XXXX------------------------XXXX-------------XXXX--------XX--------------XXXX-------XXXX---------------X--------XXXX-----------------------XXXXX---------------XXXX--XXX-------------------XXXX--XXX-------------------XXXX--XXX--------------------XXX--XXX--------------------XXX--XXX-----------------------------XX----------------XX--------XXX-------------------------XXX-------------XXXX-------XXX--------------XXXX----------X-------------------------XXX---------------XXXXX-XXXX------------------------------------------XXXXXXX----------------------XXXXXX---------------------XXXXXXX---------------------XXXXXXX----XXXXXX------------XXXXXX----------------------XXXXXX-----XXXX--------------XXXXX------XXXX-------------XXXX-------XXXX-------------XXXX-------XXXX-------------XXXXX-----------------------XXXXX----------------------XXXXXX-----------------------XXXXX------XXX-------------XXXXXX---XXXXXX------------XXXXXXX-----X-----------------XXXXX-----XXXX--------------XXXX--------XXX------------XXXXX------XXXXX-----------XXXXXXX----------------------XXXXXX--------X-------------XXXXXX--------X----
-----------XXXXX--XXX---EE-E-----------XXXXX--XXX---EE-EXXXXXXXXX-------------------XXXXXXXXX-------------------XXXXXXXXX-------------------XXXXXXXX--------------------XXXXXXXX--------------------XXXXXXXX--------------------XXXXXXXX--------------------XXXXXXXX--------------------XXXXXXXXX-------------------XXXXXXXXX-------------------XXXXXXXX--------------------XXXXXXXXX-------------------XXXXXXXXX-------------------XXXXXXXXX------------------------------XXXXX--XXX---EE-E-----------XXXXX--XXX---EE-E-----------XXXXX--XXX---EE-E------------XXXX--XXX---EE-E------------XXXX--XXX---EE-EXXXXXXXXX-------------------XXXXXXXXX-------------------XXXXXXXXX-------------------XXXXXXXXX-------------------XXXXXXXX--------------------XXXXXXXXX------------------------------XXXXX--XXXX--EE-EXXXXXXXXX-------------------XXXXXXX---------------------XXXXXXX---------------------XXXXXXX---------------------XXXXXXX---------------------XXXXXXX---------------------XXXXXXX---------------------XXXXXXX---------------------XXXXXXX---------------------XXXXXXX---------------------XXXXXXX---------------------XXXXXXX---------------------XXXXXXX---------------------XXXXXXX---------------------XXXXXXX---------------------XXXXXXX---------------------XXXXXXX---------------------XXXXXXX---------------------XXXXXXX---------------------XXXXXXX---------------------XXXXXXX---------------------XXXXXXX---------------------
---------XXXXXX---XXXXXXXXXX---------XXXXXX---XXXXXXXXXXX----------------------------------------------------------------------------------------------------------------------------------------------------------------------------------------------------------------------------------------------------------------------------------------------------------------------------------------------------------------------------------------------------------------XXXXXX---XXXXXXXXXX---------XXXXXX---XXXXXXXXXX---------XXXXXX---XXXXXXXXXX---------XXXXXX---XXXXXXXXXX---------XXXXXX---XXXXXXXXXX--------------------------------------------------------------------------------------------------------------------------------------------------------------------------------XXXXXXX---XXXXXXXXXX--------------------------------------------------------------------------------------------------------------------------------------------------------------------------------------------------------------------------------X---------------------------------------------------------------------------------------------------------------X-------------------------------------------------------------------------------------------------------------------------------------------------------------------------------------------------------------------------------X-------------------------------------------------------
