-------------------------------------------------------------------------------------------------------------------------------------------------------------------------------------------------------------------------------------------------------------------------------------------------------------------------------------------------------------------------------------------------------------------------------------------------------------------------------------------------------------------------------------------------------------------------------------------------------------------------------------------------------------------------------------------------------------------------------S------------------------------------------------------------------------------------------------------------------------------------------------------------------------------------------------------------------------------------------------------------------------------------------------------------------------------------------------------------------------------------------------------------------------------------------------------------------------------------------------------------------------------------------------------------------------------------------------------------------------------------------------------------------------------------------------------------------------
------------------------------------------------------------------------------------------------------------------------------------------------------------------------------------------------------------------------------------------------------------------------------------------------------------------------------------------------------------------------------------------------------------------------------------------------------------------------------------------------------------------------------------------------------------------------------------------------------------------------------------------------------------------------------------------------------------------------------X-------------------------------------------------------------------------------------------------------------------------------------------------------------------------------------------------------------------------------------------------------------------------------------------------------------------------------------------------------------------------------------------------------------------------------------------------------------------------------------------------------------------------------------------------------------------------------------------------------------------------------------------------------------------------------------------------------------------------
---X--X-------------------------------------------------------------------------------------------------------------------------------------------------------------------------------------------------------------------------------------------------------------------------------------------------------------------------------------------------------------------------------------------------------------------------------------------------------------------------------------------------------------------------------------------------------------------------------------------------------------------------------------------------------------------------------------------------------------------------------------------------------------------------------------------------------------------------------------------------------------------------------------------------------------------------------------------------------------------------------------------------------------------------------------------------------------------------------------------------------------------------------------------------------------------------------------------------------------------------------------------------------------------------------------------------------------------------------------------------------------------------------------------------------------------------------------------------
---------------------E--E--E----------------------------------------------------------------------------------------------------o-------------------------------------------------------------------------------------------------------------------------------------------------------------------------------------------------------------------------------------------------------------------E-----------------------------------------------------------------------------------------------------------------------------------------------------------------------------------------------------------------------------X-----------------------------------------------------------------------------------------Eo-------X---XX----------------------------------------------------------------------------------------------------------------------------E-------------------------------------------------------------------------------------------------------------------------------------------------------------------------------------------------------------------------------------------------------------------------------------------------------------------------------------o--------------------------------------------------------------------------------------------------------------o---------------------------------------------------------------------------------------------------------------------------
-----oo--oo----------XXXXXXX-------------------------------------o-----------------------E-----------------------o----o---oo--oo----------------------oo--oo--------------------------------------------------------------------oo----------------------------------------------------------------o---------------------------------------------ooo--------------------------------------------------XX---------------------------------------------------------oo-----------------------------------------------------------o-----------------------------------------------XXX------------------------------------------oo------------ooo----------------------------------------------------------------------E----------XXX------------------------------------------------------------------------------------------------------------------oo--oo--------------XXX-------------------------------------ooo--o------------------------------------------------------------------------------oo-------------------------------------------------------------------------o-------------------------------------------------------oo----------------------------------ooo---o-----------------------------------------------------------------------------------------------------------------------------------------------------------------------------------------------------------------o--------------------------------------------Eo---------
XXX-----------------------------------XX-------------------------------------------------E--E-------------------------------------QSS-------X?-------------------------------------XX------SS------------E--E------------------------------------SSSSS----------------------------------XXS-----------------S-------------------------SSSS------XX--------XXX----SSSS-----------------------------------S-------------------S------?----------------------------------------------------------------------------------------------------------------------------------------------------------------S-----------------------------------XXXXX-------------SSSS----------------------------------------------------?-------------------------------------------------------------------------------------------------------------------------XXS---------------------------------------------------------------------------------SXS-----------------------------------------------------XX--------------------------------------------------------------------------------------------XXX---------------------------------------------------------------S---------------------------------------------------------------XX-------------------------------------X---------------------------------SSSS---?--------E----------------------XX--------XXX-------S---------------------------------------------XXX-----SSS--------------------o---XXX--------
---ooo-------o---o-------------------------o---------------------------------E-------------XXXX--------E--E------------------------------------------------------------------------------------------------XXXXXX------E--o---XX---------E--------------------------------oo-----EE--------------E--ES----------------------------oo-----------------X-----------------------------------------------------------E--------------------------------o---------o-----------------oo----------------------------------o-----------o------------E--E---XX-------------o--------o--------------E--------------o-------------------------------------------------------------------------oo---------------------------o----o---o---------------------XXXXX--------o---------o---o----E--------------------o----o---o-------------------------o------------------o---o----o------------------o--------E------------------------------------------E--Eo---o----o------------------ooo----o----------ooo-----------------------------------------------------ooo------------------------XXXX----------------------------------------------o------------E-------------------------------------------------------E-------------------------------o---o--E----------------------o----E---------------------------------------------XXX--o---E--o---XX-------------------------------------------o-----------------X---------o----------------------------------------
------------XXX-XXX-----------------------------XX--oo------------------XXXXXXXXXX-X---------------XXXXXXXXXXX---------XX---------XXXXXX------------X-----------XXXXXX-X---XXXXXX--------o------------------------XXXXXXXXXXXX-o----XXXXXXX-XXX-------------------------------XXXXXXXXXX------XXXXXXXXX--XX--------------------------------------------XXX----------------------------------------------------XXXX----------XX-------------------------XXX-XXX------XXXX------------X----XX----------------XXXXXXXXXX--------XXX-X---XXXXXXXXXXXXXo-------------XXX-XXXXXXXX-X-------XXXXXX---------XX-XXX-X--------------------------------------------------------------------------------XX---------------------XXX-XXX-X---------------------------------XXXXXX-XXX-XXXXXXXXXXXX-------XXX--------XXXXXXXXXX---------------------XXXX---------------XXX-XXXXXXXX-X-X---------------XXXXXXXXXXX---------------------XXXXXXXXX--------XXX-XXX-XXXXXXXX-----------------------XXX--o----------------------------------------------------------------------------------------------XXX--------------------------------------XXXXXX------XXXXXXX-------------------------------------XXXX-XXX----XXXXXXX-----XXXXXXXX-X-X-------XXX--X---XXXXXXXXXX-X------------------XXXXXXXX-X------------------------------------------XXXXXXXXXX-----------XXX----------XXXXXX-X-------------------XXX--o----------XXX--------------XX-?-------------------------XXX
XXX-------------------XX-------------------------------------------------------------------------------------------------------------------------------------------------------------------------------------------------------------------------------------------------------------------------------------XXXX-----------------------------------------------------X------------------------------------------------------XX-----------------------------------------------------------------------------------------------------------------------------------------------------------------------X--------------X---------------------------------------------------------------------------------------------------------------------------------o---------------------------------------------------------------------------------------o----------------------------------------------------------------------------------------------------------------------------------------XXX------------------------------------------S-----------X-----------------------------------------------XX-------oo---------------------------------------------XXX------oo---------------------------------------------XXX-----------------------------------------------------------------------------------------------------------------------------------------XXX----------------------------------------------------------------------------------------
----------EE-E----------------------------XXXX--------------------EE--------------------------------------------------------o----------------XXX------ooo---X-----------XX-----ooo--o-------------------------------------------XXX---------oooo------XX-----------------------------------XX-------o---------------------------o-XXXX----X-----XXX---------o--XX----XXXX----------------EE--XXX-----------------oooo----------------------------XXXX-----------XXX-----------XXXX-----E--E----------------------------------------------------------------------------------------------oooo--o---------------------------------XXE-------------------XXXXX-XXXXX----------------XXXX-------------------------XXXX--XX---------------E------------------------------------------------------oooo-------------------------EE-E--------------------------------------------------------------------------------EE----------------------------------------------------------XXXX--------------------EE-E-------E--------------------E-----------------------EE-E---------------------------XXXX----------------------E--------------------------ooo-------------------------------------------------------o--------------------------oo-------------------------ooo--X--------------E----------XXXXX--XXXX-----------------E-----------------------oooo--XX--------------------------XXX-----------XX------oooo-XXX-----X-------------------XXXX--XXXX----
--------XXXXXXX--XXXXX?-----------------------------------------XXXXXX------X--------------XXXXXX?--------E-----------------E------------------------------------------X---------E---------------------------XXXXX-?--XXXX?-------------------------------------------XXXXX?--XXXX?-----------------E----------------------------------XXXXXXXXX--------------------------------------XXXXXXX--XX-------------------E----------------------------------------E----------------------XXXXXXXX---------XXXXXX?-----<>-------------XXXXXX-----------------------XXXXXX?--XXX-?-----------------E---------------------------------XXXXXXXXXX-----------------------------------------------XXXXXXXXX----------------------------XX-?---XXXXXX---------E------------XXXXXX---------------------------E----------------------XXXXXXXXXXXXXXX?--------------XXXXXXX-XXXXX?---------------XXX---------E--------------XXXXXX----XX---------------XXXXXX--------E-------------------------------E---------XXXXXXXX-XXXXXX?--------------XXXXXX?-------------------XXXXXXX?------E------------------------------------------XXXXX--------------------------E-----XXXXX-XXXX---------XXXXX------------------------------------------------------E----------------------------------------XXX-<>----------------------------------XXXXXX?--XXX-------------------E--------------------------------------------------------------------XX------------------------XXXXX
------XXXXX----------------------XXX----------XXX--------------------------------------------------------<>----------XXXXXXXXX------------XX------XXX-XXXX----o------------XXXXXXXXXXX-----------XXX--------------------------------XXXX--XXXXXX----------XX----------------------------------XXXXXXXXX----XX------------XXX------------------------XXXX---XXX----o------XXX-------------------------------XXXXXXXXXXX---XXXXX--XXXX----XXXX----------XX------------XXXX-----------------------------------------[]----------------------------------------------------------------XXXXXXXXXXXXXXXXXX---XXXX------------------------------------------------------------XXXXX--------------------------------------------XX----------------------<>---------XXXXXXX-------XXX-----X-----XXXXXXXXXX----XXX---XXXX-----------------------------------------------------------------------------<>-----------XXXXX--------------------------------------<>--------------------------<>--<>--------XXXX------------------------------------------------------------------<>---------XXXXX---------o-----------------------------------------XXXXXXXXXX----------------------------------------------XXXXXXXXXX----XXX---XXXX----XXXXXXXXXX---XXXXX--XXXX----XXXXX-XXXX----XXX---XXXX-[]--XX-----------------------------------------------------XXXXXXXXXX----oo----XXXX--------------------------------XXXXX-XXXX----o-----XXXX----XXX---------------------
---------------------------------------------------------------------------------------------------------[]-------XXX---------------------XX--XXXX-----------XXX--------XXX-------------------------------------------------------------------------------------------------------------XXX----------------------------------------------------------------------XXX-------------------------------------------------------------------------------------------------------oo------------------------------------[]-------------------------------oo---------------------------X-----------------------------------o-------------------------------------XXX-------------------------------------------------------------------------------------[]----E----------------------------XXXXXX---------------------------------------------------------------------------------------------------[]------------------------------------------------------[]----E------------oo-------[]--[]-----------------------------------------------------E-EE---------------------[]-E-EE------------------XX---------------------------------------------------------------------------------------------------------------------------------------------------X-----------------------------[]----------------------------------------------------EXXXXX------------XXX---------------------oo--------------XX--------------XXX------------------------------------
----------------------------XXX---------X------------X------XX---------------XXXXXX-XXXXXXE------XXX-X---XXXXXXX------------------------------------------------------------------------------------XXXXXXXX------XXXX----XXXX--XX--------------------------XXXXXXXXXXX----X------XXXXX-----------------------------XXX-------------------------X---------------------------XXXXXXXXXX------------XXXX--XX--------------------------XXX--------XXX-----XX-----XX-----------XX------------XX-XXXXXXXX------XXXXXXXXXXXXXXX---XXX--------X------XXXXXXXXXXXXXX-------X-X---XXXXXXXXX--------------------------XXX---XX--------------------XX--------------------------XX--------------------------XXX---XXXX--XX-----------------XXXX----X---XXXXXXXXXXXXX----------------------------X-------------------------------XX----------------XXXXX-XXX-------------------------XXXX---------XXX-XXXXXXXXXXX----------------------------XXXXXXX--------X-X---XXXXXXXXXXX--------XXXX-XXXXXXXXXXX----------------------XXXXX-X--XXXXXXXX-----XX---XXXXXXX---XXXX--------XXXXXXXXXXXXXXX--------------------------XXXXXXX---------------XXXXX-XX--------------------------XX------------------------------------------------------XX--------------------------XXX--------------------------XX---XXXX--X------------XX-XXX--XX-------EX------X-XXXX----------------------------XXXX-----X--XXX-------XXXX------------------------------XXX-------------------------
