---------------------------------------------------------------------------------------------------------------------------------------------------------------------------------------------------------------------------------------------------------------S----------------------------------------------------------------------------------------------------------------------------------------------------------------------------------------------------------------------------------------------------------------------------------------------------------------------------------------------------------------------------------------------------------------------------------------------------------------------------------------------------------------------------------------------------------------------------------------------------------------------------------------------------------------------------------------------------------------------------------------------------------------------------------------------------------------------------------------------------------------------------------------------------------------------------------------------------------------------------------------------------------------------------------------------------------------------------------------------------------------------------------------------------------------------------------------
------------------------------------------------------------------------------------------------------------------------------------------------------------------------------------------------------------------------------------------------------------XXX-------X---------------------------------------------------------------------------------------------------------------------------------------------------------------------------------------------------------------------------------------------------------------------------------------------------------------------------------------------------------------------------------------------------------------------------------------------------------------------------------------------------------------------------------------------------------------------------------------------------------------------------------------------------------------------------------------------------------------------------------------------------------------------------------------------------------------------------------------------------------------------------------------------------------------------------------------------------------------------------------------------------------------------------------------------------------------------------------------------------------------------------------------------------------------------------------
----------------------------------------------------------------------------------------------------------------------------------------------------------------------------------------------------------X----------------------------------------------------XE------------------------------------------------------X----------------------------------------------------------X------------------------------------------------------------------------------------------------------------X---------------------------------------------------------------------------------------------------------------------------------E---------------------------------------------------------------------------------------------X-------------------------------------------------------XE----------------------------------------------------------------------------------X--X-------------------------------------------------------------------------------------------------------------------------------------------------------------------------------------------------------------------------------------------------------------------------------------------------------------------------------------------------------------------------------------------------------------------------------------------------------------------------------------------------------------------------------------------------------------------------
--------------------------------------------o---------------------------------------------------------------------------------------------------------------o----------------------------------------XX-------------o-------E-------------------------------E------------XX-?----X--E------------------------------------------------------------------------------------------------------oo-------------------------------------------------------o----------------------------------------XX-----------------------------------------------------------------------------------------------------------------------------o----E--E--E-------------------------------------------------------------------------------------XX---------------------E---------------------------------------------------------------------------------------------------------------------X-------------o-----------------------------------------------------------------------------------o-----------------------------------------------------------------------------------------------------------------------------------------------------------------------------?-----------------------------E-------------------o-------------------------------------------------------------------------------------------------------------------------------------------------------------------------------E-----------------------------------------------------------
oo--------------------------oo---oo---oo--oo----------------------------------------XXX--oo--o---------------------------------------------o--------------------------------------------------------------o--o-----------XXX-XXXoo--------------------------XXX------oo--------------XXXo---------------------------XXX--o----------------------oo--------oo--oo-----------------oo---o----------------------oo--ooooooo----------------------------------------oo-------------------------------S----------------------oo-----------------------------------------------------------------o---------------------oo--oo----------XXXXXXX-------------------------------------oo--o-------------------------------------------------------------------XX-oo--------------------------XXX------o----------------------------------------------oo-------------------------------oo----------------------------------------------------------------------------------oo---o--------------------------------------------------------------------------------------------------------------ooo--o-----------------------------------------oo---------------E-----------------------------------XXX------------------------------------------oo----------------------o----------------Xoo----------------------------------------o-------------o----------------?--------------------------------X--XX-Eo---------------------------o--------------------------
----------XX------SSSS------X-----------------------------------------------------------------------------------S---------XXX-------o----------------------------------------------------------------X-------------------------------------XX----XXX---------X----------------------oo------------XXX---------------------------------------------------------------------------------------------------XXX---------------------------------------------------------------XXX----XXX---------X--------------------------X---------XXX--------------?--------------------------------------------------------XX-------------------------------------Xo-------S------?--------------------------------------------------------XX--------------------------XX--------XXX----XXX------------------------------------XX---------X--------------------------------------------XX--------------------------SSS------------------------------------------SSSSS--?---XX---------------------------------------------SS-------------------------SSSS----------------XXX------SS-------XXX-----------------oo------------------------SSS-------------o---XXX----SSSS---?-?---------------------------------------------------------------------------SSS-------XXS-------------------------------------------SSSS--?--?-----------XX-------------------------XXX----SSSS---?--?----------------------------XXX-----------------------------------------------------
------------------------------------------------E-E--------------------oo-------o------------------o---o------XX---------E-------------------------------o-----E--o--------------------o--------o----------------o---o-E--o---------------------------------------o------------X----------------------E-----o--------------------------E-------X---------E--------------E---------o--E------------E------------------------------------------E--Eo---o----o---------E?-----------------------------------------------------------------o---------------------------------------------------------------------------------o---o--------------XX--------E---------------------------------------------------------------o------------------------------------------------------------------oo--------------------------X--------o----------------------------o-----E--E----------------------E--o---XX-----------------o-----------------------ooo----------------------------------E--------------E-------------------------------------------------------------o--------E----------------------------------------E-----------------------------------------------------------oo------oo---------------X--------E--o--XXX-----------------------------------------------------------------E--------------------------------o----------------------------------------------------------------------------------o---o----o--------------E----------E-------
-------XXX----------------------------------XXXXXXXXXXXX-------------------XXXXXXX-X--------------XXX-XXX-XX-----------XXX-----------------------XXXXXX-XXX-XXXXXXXX--o---------------------XXXXXX--------------XXX-XXXXXXXX------XXXXXXX--------------XXXXX--------------------------------XXXXXX-------------XXX-X---------------XX-XXX------------XXXXXX--------XXXXXXXXX--XX-XXXXXX-XXXXXXXXXXXXXXXX--------XX----------XXXX-X-o-----XXXXXX-XXX-XXXXXXXX-------XXXXXXX-------------XXXXX---------------------------------XXXXX----------XX-XXX-?--------------------------------------------------XX----------------XXX-XXX------------XXXX------<>---------------------------------X-XX--------------------------XX-------------------------------------XXXXX-------------XXXXX-----------------------------------XXX----------XXXXXX-X-------------------XXXXXXXXX-------------XXXXXXXXXXX----------------------------------------------------X----oo-----------------XXXXXXXXXX-X----XXXXXXX----------XXXXX-X-------XXX--------------------------------------XXXXXX-X---------------------------X-----XXXXXX-------------------------------------------------------------XXXXXXXXXXXX--------------XXXXXXXXXX-------------X-------------------------XXXX-----------X---------XXXXXX--------------------------X--------XXXXXXXXX-X-----XXXX------------------------------------------------------XXX--XXX-XXX--XX-----------XXXXX-------XXXXXXXXXX
-------------------------------------------------------------------------------------------------------------------------------------XXX-------------------------------------------------------------------------------------------------------------------------------------------------------------------------------------------------------------------------------------------------------------------------------------------------------------------------------------------------------------------------------------------------------------------------------------------------------------------------------------------------------------[]--------------------------------------------------------------------------------------S---------------------------------------------------------------------------------------XX--------------------------------------------------------------------------------------------------------------------------------------------------------------------------------------------------XXX-----------------------------------------------------XXX--------------------------X-------------X-------------------------------------------------------------------------------------------------XX-------------------------XXXX------------------------XX---------------------------------------------------------------------------------------------------------------XX--------------------------------
----------ooo--XXXX--XX------XXX----------------------------------ooo-XXXX--------------------EE-E---------------XXXX----oooo----------------------------------------------------------XXXX-------------------EE-E-----------------------o----------------------------E----------S-------X-----------XXXX---------------------EE-E--------------------------o--------------E----------E-------------------------------------------------------------------------XXX------o----XXX-------------------------------SS------XXX------o----XXX----------------------E------------------------------E-----------------------EE----------------XX-----------XXXX----XX---------------EE-E------------------------EE-E------------------------------------------XXX----------XXXX---------------------EE-E--------E------XXX----------XXX------------X-------oooo--XX---------------------EE-E--------------------------------------------E-----------XXXX---XXX---------------------------------X-------oooo-------------------------ooo----------------XX-------ooo-XXXX---XX-------------------------------------------ooo--XXXX---------XXXX---------XXXX---XXXX--------------EE------------------------------------------------------------XX--------------------ooo--XXX----------XX------------XXX-----X------XX---------o---------------XX------------XXXX---XXX--------------E--EEE--------------------------------------------------ooo---------------
------------E-------------------------X--------------XXX------------------------XXX---------XXXXXXX?------------------------------------------------------------------------------XXXX---------------------XXXXXXXX?---X--E-----------------------------------------XXXXXXX?-----------X-------------------------E---------XXXXXXXX?-------------------------------XXXXXXXXX---------XXXXXX----X------------------XXXXX---XXXX-------------XXXXX-----------------------------------------o----------XXXXXXX?-------------------------------------X----------XXXXXXX-----------------------XXXXXXXXXXXXXXX----------XXXXXXX---XXXXX?------------------------------E----------XXXXXXX?-XXXXX?--------------XXXXXXX--XXX-?--------------XXXXXX?-------------------------------------X----------XXXXXXX?-----<>------------------------------XXX------------------------------------XXXXXXXXXXXXX-?----------------------------------<>----------------------------------XXXXX--------------------------E-------------------------------------------------------------------XXXX----------XXX---------------------------E----------------------------------------XXX----------XXXXXXXXXXX---------------XXXXXXX?--XXX-?---------------XXXXXX--XXXXX-------------------------------------------------------------------------------------XXXX--------------------------------------XXXXXXX-XXX-?--------------XXXX---------------------------E---------------
----XXXX--XXXX----------XXXX------XXX---------XXX----XXX----XXXX----XX----XXX---------------------------------------XXXXXXXXXX----oXX---XXXX-----------------------------------------------------------------------------<>-------XXXXXXXXXXXX-----XX---XXXX-------------------------------XXXXXX-X--X----XXX---XXX-----------------------------------XXXXX-----------------------XXXXX------------------------XXXX----------------------XXXX----------------------XXXXXX-XXXX----oXX---XXXX-------------------------------XXXXXXXXXXX----XXX---XXXX--------X-----------------------------------------------------------------------------XXXXXX------------------------------------------------------------------------------------------------------------XXXX----------oXX---XXX----------------------[]---------XXXXXX--------XXXX--XXX------XXX--XXX-----XXX----------------------------------------------------------------[]-------------------------------XXX-X---------X------X----XXXXXXXXXXXX---XX---XXXX----XXXX--XXXX----XXX-----------XXXX-----X----o-----XXX--------XXXXXXX------------------XXXXXXXXXX-----------XXX----XXXX---------oo-----XXX---------------------------------------------------------------------XX--------------------XXXXXXXX----o--------o----XXXX----XX----XXX---XXXX----XXXXX---XX----oXX---XXXX---XXXXX--XXXX----------XXXX--------------------------------XXXXXXX-------XXX-----------XXXXXXXXXX----XXX---XXXX
---------------------------------------------------------------------------------------------------------------------------------XXX-----------------------------EE-E--E-------------------------------------------------[]----E-------------------------------------------------------E-------------------------------------------------------E-------------------------------------------------------o-------------------------------------------------E-------------------------------------------------------------------------------------------------------------------------------------------------------------------------------------------------------------------------------------E--------------------------EE------------------------E-EE-----------------XXX-----------------------------[]-E-EE-------------------------------X---------------------------------------------------E---------------------E-------[]---------o------------------------------------------oXXXXX--------------------------------------------------------------------XXX---------XXXXX----------------------------------------XX-------------------------XXX---------------------------------------------------------------E------------------------------XXX------------XXX-------------------------------------------------------X--------------------------------------------------------------EE--------------------------------------------------------
XXX-----------------------------------------------------XXX-----------------------------XXX--------X-X----X-XXXX----------------------------XXX----XXX-------XXXXXXXXXXXXXX--X-------X--------XXXXX----XXXX--------X-X---XXXXXXX-------------------------------XXXX--------XXXX-X-XXXXXXXX-----------------------------XXXX-------EXXX----XXXXXX--------------------------------------------------X-XXXX----------------------------XXXX--------X--XXXXXXXX------------------------------------XXXXX-------XXXX-X-XXXXXX-----------------------------XXX-X-------------X-XXXXXXXXXX---XX-----------------------XXXX---------------XX------------------------XX-XXXXX---XXXX--------XXX----XXXXXX---XXXXX-------X------XXXXXXX--XXXXXXX-----XXXXXXXXXXXXXX------------------------------XXXX--------XXXXXXXXXXXXX----------------------------XX-------------------------X----XXX---------------X-XXXXXXXXXX-X----XX---XXXXXXXXXXX-XX---------XXXXXXXXXX------XXX-----------------------------------------------------XXX-------------------------XXX-------------------------------------------------------------------------------------------------------------XXX-------------------XXXXX-XXXXXXXX------XX-X----XXXXXXXXX-----------------------------------------------------XX--------------------------XX--------------------------XX--------------------------XXX--XXXXXX------X----XXXXXX----------------------------XXX-------------------------
