--------------------------------------------------------------------------------------------------------------------------------------------------------------------------------------------------------------------------------------------------------------------------------------------------------------------------------------------------------------------------------------------------------------------------------------------------------------------------------------------------------------------------------------------------------------------------------------------------------------------------------------------------------------------------------------------------------------------------------------------------------------------------------------------------------------------------------------------------------------------------------------------------------------------------------------------------------------------------------------------------------------------------------------------------------------------------------------------------------------------------------------------------------------------------------------------------------------------------------------------------------------------------------------------------------------------------------------------------------------------------------------------------------------------------------------------------------
--------------------------------------------------------------------------------------------------------------------------------------------------------------------------------------------------------------------------------------------------------------------------------------------------------------------------------------------------------------------------------------------------------------------------------------------------------------------------------------------------------------------------------------------------------------------------------------------------------------------------------------------------------------------------------------------------------------------------------------------------------------------------------------------------------------------------------------------------------------------------------------------------------------------------------------------------------------------------------------------------------------------------------------------------------------------------------------------------------------------------------------------------------------------------------------------------------------------------------------------------------------------------------------------------------------------------------------------------------------------------------------------------------------------------------------------------------
-------------------------------XE-X---------------------------------------------------------------------------------------------------------------------------------------------------------------------------------------------------------------------------------------------------------------------------------------------------------------------------------------------------------------------------------------------------------------------------------------------------------------------------------------------------------------------------------------------------------------------------------------------------------------------------------------------------------------------------------------------------------------------------------------------------------------------------------------------------------------------------------------------------------------------------------------------------------------------------------------------------------------------------------------------------------------------------------------------------------------------------------------------------------------------------------------------------------------------------------------------------------------------------------------------------X-----------------------------------------------------------------------------------------------------------------------------------------------------------------
-----------------------------XX-----------------------------------------------------------------------------------------------------------------------------------------------------------------------------------------------------------------------------------------------------------------------------------------------------o-----------------------------------------------------------------------------------------------------------------------E--E--------------------------------------------------------------------------------------------------------------------------------------------------------------------------------------------------------------------------------------------------------E-----------------------------------------------------------------------------------------------------------------o-------------------------------------------------------------------------------------------------------------------------------------------------------------------------------------------------------------------------------------------------------------------------------------------------------------------------------------------------------------------------------------------------------------------------------------------------------------------------------------------------------------------------------------------------------------------------------------------------------------
----------o----------------------S-----------------------o--------------ooo---------XX-------o-------------------------------------------------------o--------------------------------------------------------oo--oo------------------------------------------------------------------------------------------------oo---oo---oo--oo---------------------------------------------o---ooo--oo------------oo---------------------------o---oo-oooooooo---------XXXoo----------------o---------Eo---oo-oooo--oo---------------------------------------------E---------------------------------------------------o------------------------------------------------------------------------------------------------------------X--------------------------------------------------------------------------------------o---oo--oooo-oo---------XXX----------------------------oo--------oo----------------XX----------------------------------------------------------------------------------oo---------------oo-------------------------------------ooo----------------------------------oo---------------------------oo--oo-----------------------------------------------------------------------------------------------------------------------------------------------------------------oo-----------X--XXX-----------------------------o---oo--oo--------------XXX--------------------------------------o---------------------------------------------
-----------------------------------------------------o-------------------XXX--------------------------------------------------------------------------------------------------------------------------------------------------------------------------------------------------SSSS------X---------XXX-------S-------XX----------------QSS-------------------XX----SSS-------XXX-------------------------------------------SSS-------XXX-----------------------------------XXX----XXX--------XXX-------------------------XXS------------------------------E----------------------SS---------------XX---------XXX-----------------------------------XXX------SS---?-----------------------------------------------------------XXX------------------------------------X--------------------------------------------XXX------------------------------------------------------------------------X----------------------------------------------------------------SX-------------------------------------------XXX----------------------------------------------XXX-----SSS---?-?-SXS---------------------------------------------------------------------------------SSS-----------------S-----------------------------------SSS-----------------------------------------------------XXX--------------------------------------------SS-------XXX------------------------------------XX-------------------------------------------XXX-------XXX---------------
----------------------o------------------------E-----XXX---------------------o--E---------o------------------------------------o-----E--E----------------ooo------E--------------------o---E------XX-----------------------------------------------------------------E--------------------------------oo--------o------------E------------------------------------------------------------------------------------------------------------------------------------------------------------------------------------o--------------E----------------------------XXX-Eo---o------XX---------E--------------E------------E---o--------E-------------------oo-------------------------------E--E-------------------------------------------------------o------------------oooo---EE--E------o------------------o---XX-----------------------------------------oooo--------------------------------E--E--------------------------------------------------------------------------------EE------------------------------------o--------------------------------------------------------------------------E--------------E--------------------------------ooo----E---------------E--ES--------o-------------------oo------E----------------------o----o-------------------ooo----E--E------ooo-------------------------XXo---------------------------------------o---------------------------------------------------o---o----o--------------------o------------
-------XXX---------XXXXXXXXX--------------XXXXXXXXXX--o------XXXX-----------XXXXXXXX-----------------------------------XX----------XXXXXXXXX------------------XXXXXXXX----------------XXX-XXX-------------X---------XXXXXXXXXX---------------------XXXXXXXXX-----XXXXXX-XXX--X-----------------XXX----------XX-XXX-X-----XXXXXX-XXX--XX----------------------------------X-X--------XXX-XXX-------X---------XXXXXXX---------------------------------XXX-------------XXXXXX--------------XX-X----------------XXX-XXXX--oo-------XXXX---------XXXXXXXX--------------XXX-XXX-XX----------XXXX----------XXXXXXXX-----XXXXXX-XXX-XXXXXXXXXX---------X------------XX--XX-X-----XXX------XXXXXXXXXXXXXX-------------------------------------------XX---XXXX-----------------------XXXXXXXXX--------------------XXXX------------XX-----------XX----------------------------------------XX-----------XXXXXXXX-------------------------------------------XX---------------------------XXXXXXXXXX-X--------------------XXXXXXXX--------------------------------XXXXX-----------------------------------XXXXXXXXXXXX----XXXXXXX-XXX-XXXXXXXX-----------------------XXXXXXXXX-----XXXXXX-XXX--XX-XXXX--------------------XXXXXXXXXX------------------XXXXXXXX-X---------------------XXXXXXXXX-------------XX-XX---XX-----------XXXX---------------------------X--XXX-XXX---------------------------------o---------------XXX-XXXXXXXX-XoX-------XX------------XXXXX-X
------------------------------------------------------XX-----------------------------------------------------------------------------------------------------------------------------------------------------------------------------------------------------------------------------------------------------XX--------------------------XXX--------------------------------------------------------------------------------------------------------------XXX-------------------------------------------------------------------------------------------------------------------------------------------------------------------------------------------------------------------------------------------------------------------------------------------------------------------------------------------------------------------------XX-----------------------------------------XX-----------------S-------------------------------------------------------------------------------------------------------------------------------------------------------------------------oo-------------------------------------------------------------------------------------------------------------------------------------------o-----------------------------------------------------------------------------------------------------XXX-------------------------XXXX--------------------------------------------------------------------------------XXX----
----------ooo-------------------------EE-E---------------------------XXXX----XX---------------EE-E-E----------------------ooo-------------------------EE-E-------E-------------------------------------------------------EEE--EE---------oo-----------------------------o----------------XX-------ooo-XXX-----------------------o------------------------------XXXX-XXXX---------------------------------X----------o--XXX--------------------------------------XX------------XXXX---XX-------------------------------------------ooo-------------------------E--------------------------oooo--XXX---------------------------------------X------------XXXX--------------------EE--------------------------EE-E-E----------------------EE-E-E--------------------------XXXX--------------------EE-E--------------------------------------------------------XXXX--------E--XX------------XX---------------------E---------------------------------------E---------------E------------------X--------ooo--XX---------------------EE-E--------E-----XXX----------XXXX----XX---------------------------------XXX---------o-----------------------------XXX---------------------ooo--------------------------------------------------------------------------------------XXX--------------------EE-E-----------------------------XXX----------------------------------------------------XXXX--------------------EE-E-------------------------oo--XXX----------
----------XXXX----XXXXXXXXXX-X------XXXXXXXXXXXXX-------------------------------------------XXXXXXXXX-----E---------------------------XXXXXX-------XXXXXXXX--XXXXXXX---?--------XXXXXX-------------------------XX-----XXXXXXXXXX--------------------------------------------------------------------E------------XX------------XX----------------------------------------------------XXXXX----XXXXXXXXXX-------------------------------------XXXXXXX--XXX--------------------------------------------XXXXXX---XXX-------------------E---------------------XXXXXXX?--------------------------E-----------------------XXXXXX--------------------------------------XXXX---------XXXXXX---XXXX---------------XXXXXXXX--X----------------XXXXXXXXXXXXXX?------------------------------X----------XXXXXXX?---X------------------XXXX----XXXXX----------XXXXX---------------<>-----------------------XXXXXX---?---XXXXXXX-?------E-------------XXXXX?-------<>-------------XXXXXXX?--XXX-?----------------------------------------XXXXXXXX?-----<>------------------------------XXX----------XXXXX---XXXXX--XXX------------E---------------------------------XXXXXXXXXX------------E---------------------XX--XXX------XX-----------------XXX?----------------------------------XXX-XXXX--------XXXXXXXXXXXXX-?------------------------XXXX--------------XXXXXX-------------------------------------------------XXXXXXXXXXXXXX?-------------------------------XX
------XXXXXXXX----------------------------------------------XXXX----------o-----------------------------------------XXXXXXXXXX----XXX-------------------------------------------------------------------XXXX-------------------------XXXXXXXXX----XXX------------XXX--XXXX-X----------------XXXXXXXXXX----oXXX--XXXX------XXXXXXXX------------XX----XXX------X-----------XXX------XXXXX---------------------XXXX---XXX------------X---------X-XXXX------------------XXXX-----X----------XXX-------XXXXX-----------------------XXXXXXXX----XXX---------------------------------------XXXXXXXXXX----XXX----XX-------XXXXX---------------------XXXX-----------XX---------------------------------XX------------------------------------------------------------XXXXX-------------------------------------------------------XXXXXX---------------------------------------[]------XXX-----------------------------------------<>--------------------------[]-------------------------------------XXXX--XXXX----------XXX----------------------[]---------XXXX----------o-----XXXX--------------------------------XXXXXXXXXX----XXX-----XX------XXX-----------X-----------XXXXXXXXXXX---XXX---------------------------------------------X---------------------XXXX----------XXX-----------------------------------XX----XXX-------------------------XXXXXXXX-----XX-------------------------XXX-------------XXX-------------------------XXXXXXX-----o-------XX
-------------------------------------------------------E-----------------XXX----------------------------------EE----------------------------------------------------------------------------------oo----------------------------XXXX-----------------------o---------------------------------------------XXX------------------------------------------------------------------------------------------------------------------------XXXXXX-------------------------------------------------------------------------------------------------------------------------------------E-------------------------------------------------------X-----------------------------------------------------------------------------------E-----------------------------------------------------------------------------------EXXXXXXX----------------------------------------------[]----X---------------------------------------------[]---EE-----------------EE--[]---EE-----------------------------------------------------------------------------[]-E-EE-----------------XXX----------------------------------------------------------------------------------------------------------------------XX---------------------------------------------------------------------------------------------------------------E-----------------XXX-----------------------------------X-----------E-------------------------------------------------------------XXX--------
XX------------------------------XXX---------------X-XXXXXXX-----------------------------XXX----------X-XXXXXXXXXXX------------------------------XXX----------------XXXX------XX--------X-X----X-XXXXXX----------------------------------------------------XXXXX---------X---------------XX--------------------------X---------------------------XXX-----------------------------------------------------XX--------------------------X---------------------------XX------------------------------------------------------XXX-------------------------X--XXXX------XXXXXXXXXX-XX-XXX-----------------------------------------------XXXXXX-XXX-------------------------XX-----------X--------------X--XXXXXXX------------XXXXXXXXX-------------------XXXX--XXX-----------------------------XXX--------X------XXXXXX-----------------------------XXXX------XXX-----XXXXXXXXX-------------------------------XXXX--------XXXXXXXXXXXXX---XXXX------XXXXXXXXXXXXXXXXXXXXXX--------X------XXX---XX-----------------------------XXXX--------XXXXXXXXXXXXX----------------------------XXX-------------------------X-------------------------------------------------------X--------------------------XXXX--XE------X---------XXXX-XXX-------------------------XXX-----------------------------XXX--------X-X----XXXXXX----------------------------XX--------------------------XXX-------XXXX---------XXXXXX-------------------------------------------------------
