--------------------------------------------------------------------------------------------------------------------------------------------------------------------------------------------------------------------------------------------------------------------------------------------------------------------------------------------------------------------------------------------------------------------------------------------------------------------------------------------------------------------------------------------------------------------------------------------------------------------------------------------------------------------------------------------------------------------------------------------------------------------------------------------------------------------------------------------------------------------------------------------------------------------------------------------------------------------------------------------------------------------------------------------------------------------------------------------------------------------------------------------------------------------------------------------------------------------------------------------------------------------------------------------------------------------------------------------------------------------------------------------------------------------------------------------------------
-------------------------------------------------------------------------------------------------------------------------------------------------------------------------------------------------------------------------------------------------------------------------------------------------------------------------------------------------------------------------------------------------------Q---------------------------------------------------------------------------------------------------------------------------------------------------------------------------------------------------------------------------------------------------------Q-----------------------------------------------------------------------------------------------------------------Q---------------------------------------------------------------------------------------------------------------------------------------------------------------------------------------------------------------------------------------------------------------------------------------------------------------------------------------------------------------------------------------------------------------------------------------------------------------------------------------------------------------------------------------------------------------------------------------------------------------------------------------Q----------------------------
SSSSSSSSSSSSSSSS-----------S-------------------SSS---------------------------------------o-------------------------------------------------------oo-----------------------------------------------------------------------------------------------------------------------------------------------------------------------------------------------------------------------------------------------------------------------------------------------------------------------------------------------------------------------------------------------------------------------------------------------------------------------------------------------------------------------------------------------------------------------------------------------------------------------------------------------------------------------------------------------------------------------------------------------------------------------------------------------------------------------------------------------------------------------------------------------------------------------------------------------------------------------------------------------------------------------------------------------------------------------------------------------------------------------------------------------------------------------------------------------------------------------------------------------------------------------------------------------------
-----------------------------------------------SSS--------------------------------------XXXX----------------------------------------------------XXXX-------------------------------------------------------------------------------------------------------------XXX-----------------------------------------------------------------------------------------------------------------------------------------------------------------------------------------------------------------------------------------------------------------------------------XXXX------------------------------------------------------------------------------------------------------------------------------------------------------------------------------------------------------------------------------------------------------------------------------------------------------------------------------------------------------------------------------------------------------------------------------------------------------------------------------------------------------------------------------------------------------------------------------------------------------------------------------------------------------------------------------------------------------------------------------------------------------------------------------------------------------------------------------------------XX-------------------------------------------------
-----------------------------------------------SSSS--E--------------------------------------------------------------------------------------------------------------------------------------------------------------------------------------------------------------------------------------------------------------------------------------------------------------------------------------------------------------------------------------------------------------------------------------------------------------------------------------------------------------------------------------------------------------------------------------------------------------------------------------------------------------------------------------------------------------------------------------------------------------------------------------------------------------------------------------------------------------E-----------------------------------------------------------------------------------------------------------------------------------------------------------------------------------------------------------------------------------------------------------------------------------------------------------------------------------------------------------------------------------------------------------------------------------------------------------------------------------------------------------------------------------
------------------------------------------S----SSSSSSSSS----------------S----------------------------------SSSSS-----------------------SSSS----------------------SQSSSSS--------------------------QS---------?-?E-SS-----------------------Q--------------------------------------SSSSSS------------------------SSSS-----------Q-------------------------?--E------------------------Q--E------------SSS-------------------------SSS-------------------------SSS------------E------------------------?--E------------------------Q-----------------------------------------SSSSS--------SSS--------------SSS-------------------------------------?---------------SSS---------?--E--------SSSSSSS---------Q-Q------------QSQ----------?--E-----------SSS--------?-QQ-X------------SSS-------?QQQQQQ-----------------------?-QQ------------------------?---SSS-----SQSSSS--------------------------SQS--------------QS------S--SQS---------Q---------------SQQ------------------------SSSS---------QQQ------------------------------------------S---------------------------QQo--------?--E-------------S--------SSSS?SSSS-----SQSS---o------?QQQQQ----------------------------------------------------Q-Q------------Q--------------------------SSSSSSSSS---------Q--Q-------------------SSSS---------------------------------------------------------------------------------QQ?QSSS-----SQSSSS------------------------SSSSS---------Q--------------SSQQ
------------------------------------------------------------------------------------------------------------------------------------------------------------------------------------------------------------------X----------------------------------------------------------------------------------------------------------------------------------------------------------------------------------------------------------------------------------------------------------XXX-----------------------XXXXX---o------------------------------------------------------------------------------------------------------------------------------------------------------------------XX---------------------------------------------------XXXXXX-----------------------X-XX---------------------------------------------------QXXXXX------------------------------------------------------------------------------------------------------------------------------------------------------------------------------------------------------------------------------------------------------XXXXXX-----------------------------------------------------------------XX--------------------------XX--------------------------------------------------------------------------------------------------------------------------------------------------------------------------------------XX------------------------------------------E-------------------------
----------------------------------------------------------------------------------------------------------------------------------------------------------------------------------------------------------------------------------------------------------------------------------------------------------------------------------------------------------------------------------------------------------------------------------------------------------------------------------------------------------Q---XXXXXXX---------------------------------------------------------------------------------------------------------------------------------------------------------------------------------------------------------------------------------------------------------------------------------------------------------------------------------------------------------------------------------------------------------------------------------------------------------------------------------------------------------------------------------------------------------------------Q-----------------X---------------------------X-----------------------------------------XXX-----------------------------------------------------------------------------------------------X---------------------------------------------------------------------------------------------Q------------------------------------------<>-------------------------
------------------------------------------------------------------------------------------------------E-------------------------------------------------------------------------------------------------E--------------------------------------------E--------E---------------E-----------E---------------E--E----------------------------------------E-----------E---------------------------E-----------E---------------E--E------------------------E-------------------------------------------E-------------------------E-------------E--E--?---------------------E-----------E------------------E-----------------------------E----------E-----------E-----------E---------------E-----E-----E---E--------------E--------E------------------E--------E---------------------------E-E----------------E----------------------------------------E-----------E-----------E---------------E--E---------------------------E--------E---------------E--E--------E---E-----------E--E---------------------------E--------E---------------E-----------E---------------E-------------E---------------------------S---------------------------E----------------E--------E-------------------------------E-------------------------oo------------E-----E---------------------------------E------------------E----------E-----------------------------------------E-----------E---E--------------E------------------------E----------[]---------------E--E------
-----------------------------------Q------Q-------S--SSSo----------------------------QQ--------------<>-------------E----<>--------------XXX------E---QQQ--------S?--SSS-------Q--------------E-------E<>----S-------------------------E--QQQ-------<>-----Q-<>----Q---------<>-------SS-<>--------------<>-<>--------E--------Q--------<>--------E--<>---QQQ----<>----------<>----E?QQ------<>-----E----<>--------------<>-<>---E?S--E--------------<>-----E-----E-E<>--Q-Q-----<>--------------<>--SQQQQ---Q------------E<>---?QQ------<>-<>--------E-------Q------<>-----E----<>-----SS----------<>--------E-E----S-----------E<>------E--<>---QQQ----<>-----E----<>----E?SQ-Q----<>----<>----<>--<>---Q---------<>---QQQ-<>---E--SQQQ-------<>----Q--<>----E?SQQQ----------------<><>--Q?QQ-Q-------<>----QQ--E------QQQQ-------------E---E--<>---Q-Q-Q--<>------QQ?-<>----QQQ-------<>-<>----E---------------Q-----<>-----S-<>---E---Q-Q----<>-<>-----?-<>--<>----------<>-<>--E--S--------QQQ---------<>---QQQ-<>----Q--Q------<>-------?S-<>------Q-------<>-----E-----E<>---SSQQQ-----------E-----E-X--ESS-QQ----Q-QQQQ-------E<>--S?SQQQ-------<>----EQ-<>---E------------------QQQ--E--<>---QQQ-------<>---QQQ-----------------<>----<>-------------QQQQ--QQQQ---------<>----S------------<>---QQ---E<>---------------------------E----QQQ-----<>----------<>--<>---QQQ-------<>----Q?-----------------<>-----E--S-[]----E?SQ------<>-<>----ES
--------------------------------------------------------------E--------------------------------------[]-----------E<>----[]-------------XXXX--E--<>--------------------------------------------E-----<>[]-------------------------E-----------------[]-------[]--------------[]----------[]--------------[]-[]-------<>-----------------[]----E--<>--[]----------[]-----E----[]--------------[]----<>----[]--------------[]-[]-------<>--------------[]----<>----<><>[]----------[]--------------[]----------------------<>[]------------[]-[]-------<>--------------[]----<>----[]-----------------[]--E----<><>---------------<>[]-----<>--[]----------[]----<>----[]--------------[]----[]----[]--[]-------------[]-------[]--<>-------------[]-------[]---------------------E----[][]---------------[]-------<><>--------------------<>--<>--[]----------[]----------[]--------------[]-[]--------E-----------------[]-------[]--<>----------[]-[]-------[]--[]----------[]-[]-<>-----------------------[]-------[]--------------[]----------[]--------------[]----<>----<>[]------------------<>----<>--------------------------<>[]---------------[]-------[]--<>----------------------<>--[]-------------[]-----------------------[]----[]----------------------------E---[]-----------------[]-------<>[]-------------------------E<>oo----------[]----------[]--[]-------------[]-----------------------[]----<>----[]--------------[]-[]--E---
-------------------------------------------------------------<>--------------------------------------[]----------<>[]----[]-----------EXXXXX-<>--[]-------------------------------------------<>-----[][]------------------------<><>---------------[]-------[]--------------[]----------[]--------------[]-<>-------[]-----------------[]---<>--[]--[]----------[]----<>----[]--------------[]----[]----[]--------------[]-<>-------[]--------------[]----[]----[][][]----------[]--------------[]----------------------[][]---------------[]-------[]--------------[]----[]----[]-----------------[]-<>----[][]---------------[][]-----[]--[]----------[]----[]----[]--------------[]----[]----[]--[]-------------[]-------[]--[]-------------[]-------[]--------------------<>----[]-----------------[]-------[][]--------------------[]--[]--[]----------[]-<>-------[]--------------[]-[]-------<>-----------------[]-------[]--[]----------[]-[]-------[]--[]----------[]-<>-[]-----------------------[]-------[]--------------[]----------[]--------------[]----[]----[][]------------------[]----[]--------------------------[][]---------------[]-------[]--[]----------------------[]--[]-------------[]-----------------------[]----[]------X-------------------------[]------SS---------[]-------[][]------------------------<>[][]----------[]----------[]--[]-------------[]-------<>--------------[]----[]----[]--------------[]-[]------
---------E----------------------------EE---------------------[]------E--E----EE---XX---------E-EE-E--[]----------[][]-E--[]--EE-E-----XXXXXX-[]--[]-------E-EE---------------EE-------E-EE----[]-----[][]--------E--E--E---------[][]---------E-EE--[]-------[]-------EE-----[]----------[]---------E-E--[]-[]-------[]-----------EE-E--[]-E-[]--[]-E[]------EE-E[]----[]----[]--------E--E--[]----[]----[]-------EE-----[]-[]-------[]--------E--E--[]----[]----[][][]------EE-EX---------------[]-E-----E-E------------[][]-E-------E-----[]-------[]--------E--E--[]----[]----[]--E-E------E-----[]-[]----[][]-------E-EE----[][]-----[]-E[]------EE--[]-X--[]----[]--------E-EE--[]E---[]----[]-E[]-------EE----[]-------[]--[]-------E-EE--[]-------[]-----------E-EE-E---[]----[]-----------E-----[]-------[][]--------EE-E--EEE---[]--[]--[]----E-EE--[]-[]-------[]--------E--E--[]-[]-------[]------E-E-E------[]-------[]--[]----E--E--[]-[]-------[]--[]---EE-----[]-[]-[]---------------E-EE----[]-------[]--------E-EE--[]----------[]----------EE--[]----[]----[][]--------EE-EE-E---[]----[]-----------E-EE-----------[][]---------E-EE--[]-E--E--[]--[]-------EE-E------E-E--[]--[]-------------[]--------------E-E---E--[]----[]----E-X------------EE-----------[]-----------------[]-E-----[][]---------E-EE-----E-----[][][]----E-E---[]-------E--[]-E[]-------E--E--[]-------[]---------E-E--[]----[]----[]--------E--E--[]-[]------
----XXXXXXXXXXXXXXXXXXXXXXXX-----XXXXXXXXXXXXXXXXXXXXXXXXXXXXXXXXXXXXXXXXXXXXXXXXXXXXXX--XXXXXXXXXXXXXXXXXXXXXXX-XXXXXXXXXXXXXXXXXXXXXXX-XX--XXXXXXXXXXXXXXXXXXXXXXXXXXXXXXXXXXXXXXXXXXXXXXXXXXXXXXX-XXXXXXXXXXXXXXXXXXXXXXXXXXXXXXXXXXXXXXXXXXXXXXXXXXXXXXX-XXXXXXXXXXXXXXXXXXXXXXXXXXX-XXXXXXXXXXXXXXXXXXXXXXXXXXX-XXXXXXXXXXXXXXXXXXXXXXXXXXX-XXXXXXXXXXXXXXXXXXXXXXXXXXX-XXXXXXXXXXXXXXXXXXXXXXXXXXX-XXXXXXXXXXXXXXXXXXXXXXXXXXX-XXXXXXXXXXXXXXXXXXXXXXXXXXXXXXXXXXXXXXXXXXXXXXXXXXXXXXXXXXXXXXXXXXXXXXXXXXXXXXXXXXX-XXXXXXXXXXXXXXXXXXXXXXXXXXX-XXXXXXXXXXXXXXXXXXXXXXXXXXX-XXXXXXXXXXXXXXXXXXXXXXXXXXX-XXXXXXXXXXXXXXXXXXXXXXXXXXX-XXXXXXXXXXXXXXXXXXXXXXXXXXXXXXXXXXXXXXXXXXXXXXXXXXXXXXX-XXXXXXXXXXXXXXXXXXXXXXXXXXX-XXXXXXXXXXXXXXXXXXXXXXXXXXXXXXXXXXXXXXXXXXXXXXXXXXXXXXX-XXXXXXXXXXXXXXXXXXXXXXXXXXX-XXXXXXXXXXXXXXXXXXXXXXXXXXXXXXXXXXXXXXXXXXXXXXXXXXXXXXX-XXXXXXXXXXXXXXXXXXXXXXXXXXXXXX--XXXXXXXXXXXXXXXXXXXXXXX-XXXXXXXXXXXXXXXXXXXXXXXXXXX-XXXXXXXXXXXXXXXXXXXXXXXXXXXXXXXXX--XXXXXXXXXXXXXXXXXXXX-XXXXXXXXXXXXXXXXXXXXXXXXXXX-XXXXXXXXXXXXXXXXXXXXXXXXXXX-XXXXXXXXXXXXXXXXXXXXXXXXXXX-XXXXXXXXXXXXXXXXXXXXXXXXXXXXXXXXXXXXXXXXXXXXXXXXXXXXXXXXXXXXXXXXXXXXXXXXXXXXXXXXXXX-XXXXXXXXXXXXXXXXXXXXXXXXXXXXXXXXXXXXXXXXXXXXXXXXXXXXXXXXXXXXXXXXXXXXXXXXXXXXXXXXXXX-XXXXXXXXXX-XXXXXXXXXXXXXXXX-XXXXXXXXXXXXXXXXXXXXXXXXXXXXXXXXXXXXXXXXXXXXXXXXXXXXXXX-XXXXXXXXXXXXXXXXXXXXXXXXXXX-XXXXXXXXXXXXXXXXXXXXXXXXXXX-XXXXXXXXXXXXXXXXXXXXXXXXXXX
