--------------------------------------------------------------------------------------------------------------------------------------------------------------------------------------------------------------------------------------------------------------------------------------------------------------------------------------------------------------------------------------------------------------------------------------------------------------------------------------------------------------------------------------------------------------------------------------------------------------------------------------------------------------------------------------------------------------------------------------------------------------------------------------------------------------------------------------------------------------------------------------------------------------------------------------------------------------------------------------------------------------------------------------------------------------------------------------------------------------------------------------------------------------------------------------------------------------------------------------------------------------------------------------------------------------------------------------------------------------------------------------------------------------------------------------------------------
-----------------------------------------------------------------------------------------------------------------------------------------------------------------------------------------------------------------------------------------------------------------------------------------------------------------------------------------------------------------------------------------------------------------------------------Q-------------------------------------------------------------------------------------------------------------Q------------------------------------------------------------------------------------------------------------------------------------------------------------------------------------------------------------------------------------------------------------------------------------------------------------------------------------------------------------------------------------------------------------------------------------------------------------------------------------------------------------------------------------------------------------------------------------------------------------------------------------------------------------------------------------------------------------------------------------------------------------------------------------------------------------------------------------------------------------------------------------------------------
--------------------------------------------------------------------------------------------------------------------------------------------------------------------------------------------------------------------------------------------------------------------------------------------------------------------------------------------------------------------------------------------------------------------------------------------------------------------------------------------------------------------------------------------------------------------------------------o--------------------------------------------------------------------------------------------------------------------------------------------------------------------------------------------------------------------------------------------------------------------------------------oo-------------------------------------------------------------------------------------------------------------------------------------------------------------------------------------------------------------------------------------------------------------------------------------------------------------------------------------------------------------------------------------------------------------------------------------------------------------------------------------------------------------------------------------------------------------------------
--------------------------------------------------------------------------------------------o----------------------------------------------------------------------------------------------------------------------------------------------------------------------------------------------------------------------------------------------------------------------------------------------------------------------------------------------------------------------------------------------------------------------------------------------------------------------------------------XXX-------------------E----------------------------------------------------------------------------------------------------------------------------------------------------------------------------------------------------------------------------------------------------------------XXXX------------------------------------------------------------------------------------------------------------------------------------------------------------------------------------------------------------------------------------------------------------------------------------------------------------------------------------------------------------------------------------------------------------------------------------------------------------------------------------------------------------------------------------------------------------------------
--------------------------------------------------------------------------------------------------------------------------------------------------------------------------------------------------------------------------------------------------------------------------------------------------------------------------------------------------------------------------------------------------------------------------------------------------------------------------------------------------------------------------------------------------------------------------------------------------------------------------------------------------------------------------------------------------------------------------------------------------------------------------------------------------------------------------------------------------------------------------------------------------------------------------------------------------------------------------------------------------------------------------------------------------------------------------------------------------------------------------------------------------------------------------------------------------------------------------------------------------------------------------------------------------------------------------------------------------------------------------------------------------------------------------------------------------------
-------------SS------SSSS----------QQQQQ-----------------------------------------------------?-------------------------------------------SSS---------QQ---------------------------SSSS-------------------------?-SSSS--------------------?-Q------------SSS-------------E------------------------Q---------------SQQ-------?SSS--------------S-------S-------SSS-------------------------------------SQ--------------------------SSS-----------Q-------------------------------------------X---------?--E------------------------Q-QQ-----------SSSQ------------------------SSSS---------Q-Q------------SSSS---------QQ?QSQS-------SSSSS---------Q-Q-------------------------Q-?QSSS-------SSSS--------------------------SSS----------QQ---S-----------------------------------------------------------------------------???SS-----------SS-----------------------------------------------------SQSQ---------?--E------------------------Q---SSSS-----Q--------------Q---------------SQQ----------------------S--SSS-------------------------------------Q-Q-SSSS-----------------------------------SSSS-------Q-QQQ-----------------------------------------------------?-?E--------------S---------Q---------------------------QQQ-----------------------?QQQQQ------------------------?--E----------SSSS--------?-QQ?QSQS-----SQSQQQ-----------QQ-------------------------?QQQ-----------------------------------------------------------------------
--------------------------------------------------------------------------------------------------X-----------------------------------------------------------------------------------------------------------------------------------------------------------------------X----------------------------------------------------------------------------------------------------------------------------------------------------------------------------------------------------------------------------QXXXXX---------------------------------------------------------------------------------------------------------------------------------------------------------------------XX-----------------------------------------------------------------------------------------------------------------------------------------XXX-------------------------------------------------------------------------------XXXXX---------------------------------------------------------------------------------------------------------------------------------------------------------------------------------------------------------------------------------------------------------XXX----------------------------------------------------------------------------------X------------------------XXXXX-------------------------------------------------------------------------------Q-XXX----------XX--------------------------------------------------------
------------------------------------------------------------------------------------------------------------------------------------------------------------------------------------------------------------------------------------------------------------------------------------------------------------------------X---------------------------------------------------------------------------------------------------------------------------------------------------------------------------------Q-----------------------------------------------------------------------------------------------------------------------------------------------------------------------Q-------------------------------------------------------------------------------------------------------------------------------------------Q---------------------------------------------------------------------------------------------------------------------------------------------------------------------------------------------------------------------------------------------------------------------------------------------------------------------------------------------------------------------------------------------------------------------------------------------------------------Q--------------------------------------------XX-------------------------------------Q---X-X---------------------------------------------------------------
-----------------------------------------------------------------------------o-o------E------------------E-E----------------------E--S--E-----E------------------E----------------------------------------------------------------E---E---------------------------------------------E---------------------E--E--------E-----------------------------------------------------------------------E-----------E---------------E-----E--o---------------------E--------E-------------------------------E-----------------------E---E-----------E--E----------E-------------E--S--------E---------------E-----------E---E-----------E--E---------------------------E------------E--------------E------------------------E-----E------------------------E----------E---------------------------E-------------------------E---E--------------------------o---------------E--------E---------------E-------------------------------------------E--------------E--------E---------------E--E--------------------------------------E-------------E-----------E---E--------------E----------E--------------------------------------------E--?-----------------------------------E-------------------E-------E----------------E---------------------------E----------E----------------E------------E-----------E--E--------E---E------------------------XS----------------E------------E--------------E-------------------------------------------------------E------
--E----------S-------S?S-----------QQQQQ---------------------------------E-----------<>----E?SQ---------<><>---------------------<>----<>----<>----E--Q---------<>-----------------------E------------E---E---QQQQQ--Q-----------<>--<>--SQQQ-------<>---QQQ----E------------------<>------<>----QQ------<>-<>--E----<>-X--E---------------------------------------------QQQ--E---E----------<>--------S-<>--------------<>----<>-----------------------<>-------<>---------------------------E-E<>---QQQ----------------<>--<>--SQQQ----<>-<>---QQQ--E<>---QQQ------<>-----E----<>----E?-QQQ----<>----------<>--<>---Q-Q-Q--<>-<>-----S--E---E---QQQQ------<>---QQQ--E--<>---QQQ-------<>---QQQ-----------------<>----<>----------Q--Q---------<>--------E<>-------------------------E<>----Q-------------------<>--<>---QQQ-----------E--------------------<>-<>-------<>--------------<>------S?S----E----SQQQ----Q-------QQQ--E--<>---QQQQQQ-Q--<>---QQQ-<>----E-QQ------<>-<>---EE?-------Q------Q------------S--E<>------------<>-----E----<>--<>---QQQQ------<>---QQQ--E<>-------------------E-----E----Q-QQ---------<>--------E-E-------------------------E<>----SQQQ----------<>-----E<>-----QQQ-------<>-------------QQQQ------<>-<>--------E<>--E?SQQQ-------<>--------E-E<>--SQQQ----<>-<>---QQQ-<>--<>---Q-QQQ-----<>---QQQ--EEX--E--QQ-----E--<>---QQQ--E--<>--SQQQ-------<>-----QoQ--------E------------XX-----E-----------------<>------
-<>--------------------------------------------------------------E------<>-----------[]-----------------[][]------E--------E-----[]----[]----[]-----------------[]----------------------<>-----E-----<>--<>----------------------[]--[]-------------[]-------<><>-----E------------[]------[]------------[]-[]-<>----[]------------------E-----------------------------------<>--<>----------[]----------[]--------E-----[]----[]-----------------------[]-------[]--------------------------<><>[]-----------------E----[]--[]----------[]-[]-------<>[]------------[]----<>----[]--------------[]-----E----[]--[]----------[]-[]-------<>--<>-------------[]-------<>--[]-------------[]-----------------E-----[]----[]-----------------------[]-------<>[]------------E-----------<>[]------------------------[]--[]----------------<>--------------------[]-[]-------[]--------------[]--E--------E<>oo--------------E-------<>--[]-------------[]-------[]--------------[]-[]-----------------------------------<>[]------------[]----<>----[]--[]-------------[]-------<>[]----<>------------<>----<>-----------------[]-------<><>------------------------<>[]------------------[]----<>[]---------------[]-----------------------[]-[]-------<>[]---------------[]-------<><>[]----------[]-[]-------[]--[]-------------[]-------<>-X-----------<>--[]-------<>--[]-------------[]-------------E-<>----------XXXX----<>-----------------[]------
-[]------------------------X--------------------<>--------------<>------[]-----------[]-----------------[][]-----<><>-----<>-----[]----[]----[]-----------------[]----------------------[]----<>-----[]--[]----------------------[]--[]-------------[]-------[][]----<>------------[]----<>[]------------[]-[]-[]----[]-----------------<>-------<>-----------------<>-------[]--[]----------[]----------[]--------E-----[]----[]-----------------------[]-------[]--------------------------[][][]-------------<>-<>----[]--[]----------[]-[]-------[][]------------[]-<>-[]----[]--------------[]-<>-<>----[]--[]----------[]-[]-------[]--[]-------------[]-------[]--[]-------------[]-----------------------[]----[]----<>-----------------[]-------[][]-----------<>-----------[][]------------------------[]--[]----------------[]--------------------[]-[]-------[]--------------[]-<>-------<>[][]-------------<>-------[]--[]-------------[]-------[]--------------[]-<>-----------------------------------[][]------------[]----[]----[]--[]-------------[]-------[][]----[]------------[]----[]-----------------[]-------[][]------------------------[][]------------------[]----[][]---------------[]-------<>--------------[]-[]-------[][]---------------[]-------[][][]----------[]-[]-------[]--[]-------------[]-------[]-----S-------[]--[]-------[]--[]-------------[]---------------[]---------XXXXX----[]-----------------[]------
-[]-------------EE--------XX-----EE-------E-----[]-EE-E----E----[]------[]-----------[]-----------E-EE--[][]-----[][]-----[]--E--[]----[]----[]--------E--EE----[]--------------------E-[]----[]-E---[]--[]------E--EE-E---------[]--[]-------E-EE--[]----E--[][]-E--[]--EE-E----E-[]----[][]---------E--[]-[]-[]----[]--------E--E-EE--[]-E-----[]-----------EE----[]-E--E--[]--[]-------E--[]----------[]--EE-E-----E--[]----[]---------E-----E-E-----[]-E-EE--[]--EE--E--E-E--------------[][][]-E----EE-E---[]-[]----[]--[]-------E--[]-[]-------[][]---------E--[]-[]-[]----[]--------E--E--[]-[]-[]----[]--[]----E--E--[]-[]-------[]--[]-------EE----[]-------[]--[]-------E-----[]-----------E--E-----E--[]----[]----[]--------EE-EE----[]---E---[][]--E------E-[]----EE-----[][]--------E--E------------[]--[]------EE-EE-E---[]--------EE-------E--[]-[]-------[]-----EE-EE-E--[]-[]-------[][][]------EE-E---[]-------[]--[]---------E---[]-------[]--------E--E--[]-[]----------------EE-E---E-EE-E------[][]--------EE--[]----[]----[]-E[]-------EE----[]-E-----[][]----[]--EE-EE-E---[]----[]---------E-EE----[]-E-EE--[][]---------E-EE-----E-----[][]--------EE-E--E---[]----[][]---------E-EE--[]-E-E---[]-----------E--XX-[]-------[][]---------E-E---[]-------[][][]------EE-EXX-[]-------[]--[]----E-EE-----[]-------[]-----------E-[]--[]-E--E--[]--[]-------E-EE--[]-E--E----------[]-----E--XXXXXX----[]-E-E------E--EE--[]------
-XX--XX--XXXXXXXXXXXXXXXXXXXXXXXXXXXXXXXXXXXXXXXXXXXXXXXXXXXXXXXXXXXXXXXXXXXXXXXXXXX-XXXXXXXXXXXXXXXXXXXXXXXXXXX-XXXXXXXXXXXXXXXXXXXXXXXXXXX-XXXXXXXXXXXXXXXXXXXXXXXXXXXXXXX-X---XXXXXXXXXXXXXXXXXXX-XXXXXXXXXXXXXXXXXXXXXXXXXXX-XXXXXXXXXXXXXXXXXXXXXXXXXXX-XXXXXXXXXXXXXXXXXXXXXXXXXX--XXXXXXXXXXXXXXXXXXXXXXXXXXX-XXXXXXXXXXXXXXXXXXXXXXXXXXX-XXXXXXXXXXXXXXXXXXXXXXXXXXX-XXXXXXXXXXXXXXXXXXXXXXXXXXXXXXXXXXXXXXXXXXXXXXXXXXXXXXXXXXXXXXXXXXXXXXXXXXXXXXXXXXX-XXXXXXXXXXXXXXXXXXXXXXXXXXXXXXXXXXXXXXXXXXXXXXXXXXXXXXXXXXXXXXXXXXXXXXXXXXXXXXXXXXX-XXXXXXXXXXXXXXXXXXXXXXXXXXX-XXXXXXXXXXXXXXXXXXXXXXXXXXXXXXXXXXXXXXXXXXXXXXXXXXXXXXX-XXXXXXXXXXXXXXXXXXXXXXXXXXXXXXXXXXXXXXXXXXXXXXXXXXXXXXXXXXXXXXXXXXXXXXXXXXXXXXXXXXX-XX--XXXXXXXXXXXXXXXXXXXXXXX-XXXXXXXXXXXXXXXXXXXXXXXXXXX-XXXXXXXXXXXXXXXXXXXXXXXXXXXXXXXXXXXXXXXXXXXXXXXXXXXXXXXXXXXXXXXXXXXXXXXXXXXXXX-XXXX-XXXXXXXXXXXXXXXXXXXXXXXXXXXXXXXXXXXXXXXXXXXXXXXXXXXXXXXXXXXXXXXXXXXXXXXXXXXXXXXXXXX-XXXXXXXXXXXXXXXXXXXXXXXXXXXXX--X-XXXXXXXXXXXXXXXXXXXXXXXXXXXXXXXXXXXXXXXXXXXXXXXXXX-XXXXXXXXXXXXXXXXXXXXXXXXXXX-XXXXXXXXXXXXXXXXXXXXXXXXXXX-XXXXXXXXXXXXXXXXXXXXXXXXXXX-XXXXXX--XXXXXXXXXXXXXXXXXXX-XXXXXXXXXXXXXXXXXXXXXXXXXXX-XXXXXXXXXXXXXXXXXXXXXXXXXXXXXXXXXXXXXXXXXXXXXXXXXXXXXXX-XXXXXXXXXXXXXXXXXXXXXXXXXXXXXXXXXXXXXXXXXXXXXXXXXXXXXXX-XXXXXXXXXXXXXXXXXXXXXXXXXXX-XX--XXXXXXXXXXXXXXXXXXXXXXXXXXXXXXXXXXXXXXXXXXXXXXXXXXXXXXXXXXX-XXXXXXXXXXXXXXX--XXXXXXXXXXXXXXXXXXXXXXXXXXXXXX
