--------------------------------------------------------------------------------------------------------------------------------------------------------------------------------------------------------------------------------------------------------------------------------------------------------------------------------------------------------------------------------------------------------------------------------------------------------------------------------------------------------------------------------------------------------------------------------------------------------------------------------------------------------------------------------------------------------------------------------------------------------------------------------------------------------------------------------------------------------------------------------------------------------------------------------------------------------------------------------------------------------------------------------------------------------------------------------------------------------------------------------------------------------------------------------------------------------------------------------------------------------------------------------------------------------------------------------------------------------------------------------------------------------------------------------------------------------
-------------------------------------------------------------------------------------------------------------------------------------------------------------------------------------------------------------------------------------------------------------------------------------------------------------------------------------------------------------------------------------------------------Q-------------------------Q-----------------------------------------------------------------------------------------------------------------------------------------------------------------------------------------------------------------------------------------------------------------------------------------Q---------------------------------------------------------------------------------------------------------------------------------------------------------------------------------------------------Q---------------------------------------------------------------------------------------------------------------------------------------------------------------------------------------------------Q--------------------------------------------------------------------------------------------------------------------------------------------------------------------------------------------------------------------------------------------------------------------------------------------------------------------
-----------------------------------------------------------------------------------------------------------------------------------------------------------------------------------------------------------------------------------------------------------------------------------------------------------------------------------------------------------------------------------------------------------------------------------------oo-------------------------------------------------------------------------------------------------------------------------------------------------------------------------------------------------------------------------------o-----------------------------------------------------------------------------------------------------------------------------------------------------------------------------------------------------------------------------------------------------------------------------------------------------------------------------------------------------------------------------------------------------------------------------------------------------------------------------------------------------------------------------------------------------------------------------------------------------------------------------------------------------------------------------------------------------------------------------------------------------------------------------
-----------------------------------------------------------------------------------------------------------------------------------------------------------------------------------------------------------------------------------------------------------------------------------------------------------------------------------------------------------------------------------------------------------------------------------------XXX-----------------------------------------------------------------------------------------------------------------------------------------------------------------------------------------------------------------------------XXX----------------------------------------------------------------------------------------------------------------------------------------------------------------------------------------------------o-------------------------------------------------XXX-X--------------------------------------------------------X--------------------------------------------------------------------------------------------------------------------------------------------------------------------------------------------------------------------------------------------------------------------------------------------------------------------------------------------------------------------------------------------------------------------------------------------------------
--------------------------------------------------------------------------------------------------------------------------------------------------------------------------------------------------------------------------------------------------------------------------------------------------------------------------------------------------------------------------------------------------------------------------------------------------------------------------------------------------------------------------------------------------------------------------------------------------------------------------------------------------------------------------------------------------------------------------------------------------------------------------------------------------------------------------------------------------------------------------------------------------------------------------------------------------------------------------------------------------------------------------------------------------------------------------------------------------------------------------------------------------------------------------------------------------------------------------------------------------------------------------------------------------------------------------------------------------------------------------------------------------------------------------------------------------------
---------?S?--------------S---------------------------------SSSS---SSSS----Q---------------------------E--E-----------------------------SSSS-------------------------SQS-------------------------------------------------------------------?SSS---------------------------------------------------------------SSSSSS---------------------------S--------------------------QQ---------?--E------------SSS-------------SSSS----SSSSSSS------------------------SSSS---------QQQ-------------SQ------------Q-----------------------------------------------------?-QE------------SSS---------------------------S------------E------------SSS-------------------------SSS----------------------QSSSSS-------------------------SSQ---------QQQQSSS------QSSSS--------------------------------------Q---------------SSS---------------------------------------Q-Q-----------------------?-QQ---------------------------------------SSQQ-----------------------SSSSS--------------------------QQ---------Q-Q------------SSS----------?-?E-----------SSSS-------Q-QQQ-Q--------QSQQQQ---------?-----------SSSSSS----------?--E----------SSSSS---------?--E-----------SSSS-------------SQSS-----QS-----------------------------SQQ-------------QQQQ--------------------?-?E---------------------------E--E-------------------------------------------------QQQ-------------------------Q------------QSSSSQ-------------------------SSS----------SS---------------S
-------------XXX---------------------------------------------------E-------------------------------------X---X----------------------------------------------------------------------------------------------------------------------------------------------------------------------------------------------------------------------------------------------------------------------------------------------------------------------------------------------------------------------------------------------------------------------------------------------------X------------------------------------------------------XXX-----------------------------------------------------------------------------------------------------------------------------------------------------------------------------------------------------------------------------------------------------------X-----------------------------------------------------------------------------------------------------------------------------------------XXX------------------------------------------------------X------------------------XX-XXX--------------------------------------------------------------------------------------------------------------------------------------XXXXX--------------------------XXX-------------------------------------------------------------------------------------------------------------------------------------------------------
------------------------------------------------------------------XSS--------------------------------------E-------------------------------------------------------------------------------------------XX-------------------------------------------------------------------------------------------------------------------------------------------------------------------------------------------------------------------------------------------------------------------------------------------------------------------------------------------------------------------------------------------------------------------------------------------------------------------------------------------------------------------------------------------------------------------------------------------------------------------------------------------------------------------------------------------------------------------------------------------------------------------------------------------------------------------------Q-------------------------------------------E-----------------------------------------------------------------------------------------------------------------------------------------------------------------------------------Q-------------------------------------------------------------------------------------------------------------------------------------------------------------------------------------
-----------------------------------------E-----------------------XXS--------------------------------------<>--------E-----------------------------------------E-----------E---------------------------XXS-------------------------E---E-------------------------E-----------------------------E-----------E------------------------------E--------E---------------E-----------E---------------E---------------E------------------------------------------E---------------------------E--------E---------------------------E-----------------------------E-------------------------E---------------E--S------------E-----------------------E-E-------------E--S--E---------------------E-----------E---------------E------------------------------E---------------------------E------------------------E-----E--?-----ooo----------------E-------------------------------------E-----------------------E---------------E--E----------o-------------E--S--------E---------------E---------------E--------------E------------E-----------------E------------------------E-------<>--<>-----------E-----------E---------------E--S--E---------E-----------E---------------E-----------------------E-------------------------------------------------------E---E----------------------------------------------------------------------E--------E---------------------------E---------------E--E--------E---------------------E-----E------------------E------
--E--XX--S------------------------------<>----------------------XXX---S-----Q-------X---------------X-----[]-------<>-------------E-----E-------E----QQ------<>-----E----<>--------------------------XXXX--S--------<>--------E--<>--<>----Q--------Q----QQQ--E<>---QQQ------<>-----E-----E--<>-------Q--<>-----E--S--------------------<>-------<>--------------<>----------<>----E-SQ------<>--------S--E--<>---QQQQ----S-------E?--E----Q-QQ---------<>-----S-------Q?SQ---------<>-------<>----E-QQQQ------------QQQ-<>----E----------------------E<>--E--QQQ----------------<>----E?QQ------<>-----E-----E-E<>----Q-----------------<><>----Q-------<>----<>----<>--------------<>------S?S-<>----E--Q------<>-----E-----E---E--SQQQQ------<>---QQQ--------------------<>---Q------------Q---Q--<>----<>---------------------E----<>-----E----Q--QQQQ---Q---E---QQQ--E--<>---QQQQ---Q--Q--------<>---E--Q-------<>------E?S-----------------<>-----E----<>----E--QQQ----<>-----------E--<>---QQQ----<>-<>---QQ?--E--<>----QQ-----E----<>-----E----Q-QQ-Q-------<>---QQQ-[]--[]----------<>-------ES-<>-----?S-------<>-----E-----E--<>---QQQ----<>-------Q?--E--<>----QQQQ--------------<>-----?Q-----------------S----------Q--QQ--Q---------Q-<>--<>--SQQQ----Q-------------------S--------------E----------Q--Q---------<>---QQQ-<>----E?SQQQ-------<>-------<>----E-QQ------<>-<>---QQQ-<>---------------E----<>----<>-----------------<>------
-<>--XX---------------------------------[]---------------------XXXX-----------------XX--------------X-----[]-------[]------------<>----<>-----E<>------------[]----<>----[]------------------E-E----XXXXX-S---------[]---E---<>--[]--[]----------------------<>[]------------[]----<>----<>--[]----------[]----<>-----------------------[]-------[]--------------[]----------[]--------------[]--E--E----<>--[]----------------------<>-----------------[]--------------------------[]-------[]--------------------------[]--------------------------<>[]------------------------[]--------------[]----<>----<><>[]----------------------[][]------------[]----[]----[]--------------[]--E-------[]--------------[]----<>----<>--<>-------------[]--------E-E---------------[]-----------------------[]----[]----XX--------------<>----[]----<>-----------------<>-------<>--[]--------------E-------[]--<>----------[]--------------------------[]----<>----[]--------------[]----------<>--[]----------[]-[]-------<>--[]----------<>----[]----<>-----------------[]-------[]--[]----------[]----------[]--------------[]----<>----<>--[]----------[]--E-------<>--[]----------------------[]---------------------E--------------------------------[]--[]----------------------------E---------------<>-----------------------[]-------[]-----------------[]-E-----[]--------------[]-[]-------[]-------------E<>----[]----[]-----------------[]------
-[]--XX--S------------------------------[]--------------------XXXXX-----------------XX--------------X-----[]-----<>[]------------[]----[]----<>[]------------[]----[]----[]-----------------<><>----XXXX------------[]--<>---[]--[]--[]-------------<>-------[][]------------[]----[]----[]--[]----------[]----[]-----------------------[]-------[]--------------[]----------[]--------------[]-<>-<>----[]--[]-------------<>-------[]-----------------[]--------------------------[]-------[]--------------------------[]--------------------------[][]------------------------[]--------------[]-<>-[]----[][][]----------------------[][]------------[]----[]----[]--------------[]-<>-------[]--------------[]----[]----[]--[]-------------[]-------<>-----------------[]-----------------------[]----[]---XXX--------------[]----[]----[]-----------------[]-------[]--[]-------------<>-------[]--[]----------[]-<>-----------------------[]----[]----[]--------------[]----------[]--[]----------[]-[]-------[]--[]----------[]----[]----[]-----------------[]-------[]--[]----------[]----------[]--------------[]----[]----[]--[]----------[]-<>-------[]--[]----------------------[]-----------------<>-<>--------------------------------[]--[]--------------------------------------------[]-----------------------[]-------[]-----------------[]<>-----[]--------------[]-[]-------[]------------<>[]----[]----[]-----------------[]------
-[]--XX-------E-EE-E-------------EE-----[]--------------EE-E-XXXXXXX-----------E-E--XX---EE-----E---X-----[]-----[][]--------EE-EXX-E--[]-X--[][]---------E--[]----[]----[]--E-----EE-E--E--[][]----XXXX--E-----E---[]--[]-E-[]--[]--[]-------E-EE--[]-E-EE--[][]--------EE--[]----[]----[]-E[]---EE-E---[]----[]--------EE-E---E-E-----[]-------[]--------E-----[]----------[]-----------E--[]-[]-[]----[]--[]------E---E--[]-------[]--------EE-E-----[]-----------EE-------E-EE--[]-E-E---[]-----------E-EE--------E--[]-----------E-EE--------E--[][]--------EE-EE-----E-----[]-----------E--[]-[]-[]----[][][]------EE-E--E---------[][]------E--E--[]----[]----[]--------EE-E--[]-[]-------[]--------E--E--[]----[]----[]--[]-------E-----[]-E-E---[]-----------E-EE--[]-----------------E--E--[]-E--[]---XXX---E-------E--[]----[]----[]-----------E--E--[]-------[]--[]-------------[]-E-----[]--[]---EE-E---[]-[]----------------EE--E--[]----[]----[]--------E--E--[]----------[]-E[]------EE--[]-[]-------[]-E[]------EE--[]E---[]----[]-----------EE----[]-------[]--[]----E-EE--[]----------[]-----E-----E--[]----[]----[]--[]------EE--[]-[]-------[]-E[]----E-EE--E-E---------[]--EE-----E-E-----[]-[]----------------EE--------------[]--[]-------E-EE-----------------------EE-E------[]----------------EEE----[]-EE-E--[]-----------EE----[][]-----[]-----------E--[]-[]-------[]-------EE---[][]-E--[]----[]--EE-------E-----[]------
-XX--XX--XXXXXXXXXXXXXXXXXXXXXXXXXXXXXXXXXXXXX-X-XXX--XXXXXXXXXXXX-------XXXXXXXXXXXXXXXXXXXXXXXXXXXXXXXXXXXXXXXXXXXXXXXXXXXXXXXXXXXXXXXXXXX-XXXXXXXXXXXXXXXXXXXXXXXXXXX-XXXXXXXXXXXXXXXXXXXXXXXXXXXXXXXXXXXXXXXXXXXXXXXXXXXXXXX-XXXXXXXXXXXXXXXXXXXXXXXXXXXXXXXXXXXXXXXXXXXXXXXXXXXXXXX-XXXXXXXXXXXXXXXXXXXXXXXXXXXXXXXXXXXXXXXXXXXXXXXXXXXXXXX-XXXXXXXXXXXXXXXXXXXXXXXXXXX-XXXXXXXXXXXXXXXXXXXXXXXXXXXXXXXXXXXXXXXXXXXXXXXXXXXXXXX-XXXXXXXXXXXXXXXXXXXXXXXXXXXXXXXXXXXXXXXXXXXXXXXXXXXXXXX-XXXXXXXXXXXXXXXXXXXXXXXXXXX-XXXXXXXXXXXXXXXXXXXXXXXXXXX-XXXXXXXXXXXXXXXXXXXXXXXXXXX-XXXXXXXXXXXXXXXXXXXXXXXXXXX-XXXXXXXXXXXXXXXXXXXXXXXXXXX-XXXXXXXXXXXXXXXXXXXXXXXXXXX-XXXXXXXXXXXXXXXXXXXXXXXXXXX-XXXXXXXXXXXXXXXXXXXXXXXXXXX-XXXXXXXXXXXXXXXXXXXXXXXXXXX-XXXXXXXXXXXXXXXXXXXXXXXXXXXXXXXXXXXXXXXXXXXXXXXXXXXXXXXXXXXXXXXXXXXXXXXXXXXXXXXXXXX-XXXXXXXXXXXXXXXXXXXXXXXXXXXXXXXXXXXXXXXXXXXXXXXXXXXXXXX-XXXXXXXXXXXXXXXXXXXXXXXXXXXXXXXXXXXXXXXXXXXXXXXXXXXXXXX-XXXXXXXXXXXXXXXXXXXXXXXXXXXXXXXXXXXXXXXXXXXXXXXXXXXXXXXXXXXXXXXXXXXXXXXXXXXXXXXXXXX-XXXXXXXXXXXXXXXXXXXXXXXXXXX-XXXXXXXXXXXXXXXXXXXXXXXXXXX-XXXXXXXXXXXXXXXXXXXXXXXXXXXXXXXXXXXXXXXXXXXXXXXXXXXXXXX-XXXXXXXXXXXXXXXXXXXXXXXXXXXXXXXXXXXXXXXXXXXXXXXXXXXXXXXXXXXXXXXXXXXXXXXXXXXXXXXXXXX-XXXXXXXXXXXXXXXXXXXXXXXXXXXXXXXXXXXXXXXXXXXXXXXXX-XXXXXXXXXXXXXXXXXXXXXXXXXXXXXXXXX-XXXXXXXXXXXXXXXXXXXXXXXXXXX-XXXXXXXXXXXXXXXXXXXXXXXXXXX-XXXXXXXXXXXXXXXXXXXXXXXXXXX-XXXXXXXXXXXXXXXXXXXXXXXXXXX
