--------------------------------------------------------------------------------------------------------------------------------------------------------------------------------------------------------------------------------------------------------------------------------------------------------------------------------------------------------------------------------------------------------------------------------------------------------------------------------------------------------------------------------------------------------------------------------------------------------------------------------------------------------------------------------------------------------------------------------------------------------------------------------------------------------------------------------------------------------------------------------------------------------------------------------------------------------------------------------------------------------------------------------------------------------------------------------------------------------------------------------------------------------------------------------------------------------------------------------------------------------------------------------------------------------------------------------------------------------------------------------------------------------------------------------------------------------
-------------------------------------------------------------------------------------------------------------------------------------------Q-----------------------------------------------------------------------------------------------------------------------------------------------------------------------------------------------------------------------------------------------------------------------------------------------------------------------------------------------Q---------------------------------------------------------------------------------Q-Q-------------------------------------------------------------------------------------------------------------------------------------------------------------------------------------------------------------------------------------------------------------------------------------------------------------------Q----------------------------------------------------------------------------------------------------------------------------------------------------------------------------------------------------------------------------------------------------------------------------------------------------------------------------------------------------------------------------------------------------------------------------------------------------------------------------------------------------------------------------------------------------
-------------------------------------------------------------------------------------------------------------------------------------------------------------------------------------------------------------------------------------------------------------------------------------------------------------------------oo--------------------------------------------------------------------------------------------------------------oo---------------------------------------------------------------------------------------------------------------------------------------------------------------------------------------------------------------------------------------------------------------------------------------o--------------------------oo-----------------------------------------------------------------------------------------------------------------------------------------------------------------------------------------------------------------------------------------------------------------------------------------------------------------------------------------------------------------------------------------------------------------------------------------------------------------------------------------------------------------------------------------------------------------------------------------------------------------------------------------------------------------------------------------
-----------------------------------------------------------------------------------------------------------------------------------------------------------------------------------------o------------------------------------------------------------------------------------------------------------------------------XXXX----------------------------------------------------------------------------------------------------------XXXXXX-----------------------------------------------------------------------------------------------------------------------------------------------------o------------------o------------------------------------------------------------------------------------------------------------XXX-------------------E----XXXX-----------------------------------------------------------------------------------------------------------------------------------------------------------------------------------------------------------------------------------------------------------------------------------------------------------------------------------------------------------------------------------------------------------------------------------------------------------------------------------------XXX--------------------------------------------------------------------------------------------------------------------------------------------------------------------------------------------
--------------------------------------------------------------------------------------------------------------------------------------------------------------------------------------------------------------------------------------------------------------------------------------------------------------------------------------------------------------------------------------------------------------------------------------------------------------------------------------------------------------------------------------------------------------------------------------------------------------------------------------------------------------------------------------------------------------------------------------------------------------------------------------------------------------------------------------------------------------------------------------------------------------------------------------------------------------------------------------------------------------------------------------------------------------------------------------------------------------------------------------------------------------------------------------------------------------------------------------------------------------------------------------------------------------------------------------------------------------------------------------------------------------------------------------------------------
-----------------------------------------------------------------------------------------------------------------------?SQQ?-----------------------------------------SSQ--------------SSS--------------------?-?E-----------SSSS------------------------SSSS---------------------------S-----------------------------------------------------SSS---------Q-Q-------------------------?--E----------------------?QQ-QQ------------------------Q-Q-----------SSSS--------------SSS--------SSSS---SSSSS---SSSSSSSSQ---------------------SSS-----SSS-------------Q-------------SSSSS--------------SSS------------------------------------------------QQ?-------------SSS-------------------------SSS---------------------SSSSSSS------------------------SSSQ----------------------SSSSSS-------------------------SSS---------Q-?QSSSS---------Q----------?--E------------SSS------------------------SSSS----------------------------------------E----------------------------------------------------------------------S--------------------------------------S?SSSS-------------------------------------------------Q----S----------SQ--------------------------SSS---------Q---------------SSS-------------SSSSS------------------------------------------------------------SSSSSS-------------------------SQQ------------E------------------------?-?Q------------------------QQQ------------SSQQ-----------------------------------------------------SQQ
------------------------------------------------------------------------------------------------------------------------------X-----------------------------------------------------------------------E---------X-XX-------------------------------------------------------------------------------------------------------------------------------------------------------------------XXXXXX-------------------------XX------------------------------------------E------------------------------------------------------------------XX---------------------------------------------------------------------------------------------------------------------------------------------------------------------------------------------------------------------------------------------------------------------------------------XX--------------------------X--------------------------------------------------------------------------------XXXXX--------------------------------------------------------------------------------------------------------------------------------------------------------------------------------------------------------------------------------------------------------------------------------------XX-----------------------------------------------------------------------------------------------------------XXXXX------------------------------------------------------------------------------------------------
--------------------------------XX-------------------------------------------------------------------------------------------------------------------------------------------------------------------<>----------------------------------------------------------------------------------------------------------------------------------------------------------------------------------------------------------------------------------------------------------<>---E-------------------------------------------------------------------------------------------------------------------------------------------------------------------------------------------------------------------------------------------------------E-----------------------------------------------------------------------------------------------Q-----------------------------------------------------------------------------------------------------------------------------------------------------------------------------------------------------------------------------------------------------------------------------------------------------------------------------------------------------------------------------------------------------------------------------------------------------------------------------------------------------------------------Q---------------------------------------------E---------------------------------------------------
-------------------------------XXX---------------------------------------------E--------E----------------E-----------------------------------------------------------------------------------E-------[]---------------E-----------E---------------E---------------E-----------------E------------------------E------------------------E--o------------E--------------E------------E-----------E-----------E-E----------------E--------E---------------E----------[]--<>-----------E-------------------------------------------E---------------------------------------------E---------------------------------------------------------------E---------------------------E-------------E-----E---------------------E----------<>---------------E------------------------------E--------E---------------E--S--------E---E--------------E----------E-------------------E-----E---------------E------------------------------E----------E-------------------E--o------------------------------------------------------------------o---------------------------------------------------------------------------E------------------E------------------------------E--o----E------------------------------------------------------------------------E--------E---------------E-----------E---------------E--E----------E-----------------------------E------------------------------------------E----------S----------------E------------------------E---------
------------------------------XXXX--------------------------------------------<>------E<>---QQQQQ-------<>--------E---E??SQQQ-----------------E----E--QQQ------Q---------------Q--Q---------<>----E--[]----E?S-------<>-----E--S-<>--------------<>------E?S--E--<>----------------<>-----------------------<>-----------------------<>--------------<>---QQQQ------<>---QQQ--E-E<>--SQQQ----<>----------<>----E?-QQQ-------<>-------<>-------Q------<>------E?S-[]--[]----------<>-----E----QQQQS---------------------------<>----Q-Q---S--------E----------Q-Q-----<>----<>----QQ-----------S?S-------------E--<>---QQQQ----------------E<>----QQ-------E-----E------<>---Q--------<>----<>----------Q--Q------<>-----E----[]--------------<>------E??-------Q--Q---------<>-------<>----E--Q-Q----<>-----E----<>--<>---QQQQ------<>---QQQ--E<>---?Q--------E----<>----<>--------------<>-----E--------------------E--<>--------E<>---?SQ-------E----<>-------E----QQQQ-------<>---QQQ------------------------------XXXX--E--------E-----<>-----E--X------------------E-----E--------------------------<>----E--Q---------<>----QQ--E---------------E----<>-----E<>---QQ-----------------------X-------QQ--Q------------E--<>---QQQ-------<>-------<>--------------<>-----ES?S-<>----E-Q-------<>-<>-----S--E<>---QQQQQ-----------------E--<>----QQ----Q--------------E---QQ----------<>---QQ------XX-------------<>---------->----Q-------<>------QQQ
-----S?----------------------XXXXX--S-----------------------------------------[]-----<>[]---------------[]-------<>--<>----------------------<>---------------------------------------------[]-------[]--------------[]----<>----[]--------------[]----------<>--[]----------------[]--------SS-------------[]-----------------------[]-----------E--[]-------------[]-------<><>[]----------[]-----E----[]-----------------[]-------[]--------------[]----------[]--[]----------[]----<>------------XX----------------------[]------------------<>------------------[]----[]--------------------------------<>--[]----------------------<>[]------------<>----<>------[]------------[]----[]-----E--------------[]----<>----[]--------------[]-----------------------------[]-------[]--------------[]----<>----[]--[]-------------[]-------<>[]------------<>----[]----[]--------------[]----<>-------------------<>--[]-------<>[]------------<>----[]-----E<>---------------[]-----------------------------------XXXXXX---------<>-----[]----<>--XX----------------<>----<>--------------------------[]-----------------[]-------<>--------------<>----[]----<>[]------------<>--------------X-----------------------<>--[]-------------[]-------[]--------------[]----<>----[]--------------[]-[]--E----<>[]------------------------<>--[]------------------------<>---------------[]----------XXX-------------[]--------E[]------------[]---------
-----------------------------XXXXX------------------------------------X-----X-[]-----[][]---------------[]-------[]--[]----------------------[]---------------------------------------------[]-------[]--------------[]----[]----[]--------------[]----<>----[]--[]----------------[]-----------------------[]-----------------------[]----------<>--[]-------------[]-------[][][]----------[]----<>----[]-----------------[]-------[]--------------[]-<>-<>----[]--[]----------[]----[]-----------XXX----------------------[]------------------[]------------------[]----[]--------------------------------[]--[]----------------------[][]------------[]----[]----<>[]------------[]----[]----<>--------------[]----[]----[]--------------[]----------<>-----------------[]-------[]--------------[]----[]----[]--[]-------------[]-------[][]------------[]----[]----[]--------------[]----[]-------------------[]--[]-------[][]------------[]----[]----<>[]---------------[]---------------------------------XXXXXXXX-----<>--[]-----[]----[]--XX----------------[]----[]--------------------------[]-----------------[]-------[]--------------[]----[]----[][]------------[]--------------X-----------------------[]-E[]-------------[]-------[]--------------[]----[]----[]--------------[]-[]-<>----[][]------------------------[]--[]------------------------[]---------------[]----------XXX-------------[]-------<>[]------------[]---------
--------------EE------------XXXXXX-----E--E-EE-E---E-------E-EE-----E---X---X-[]-----[][]--------EE-----[]-E-----[]--[]-------E-EE-E---------[]-----------E-EE---------------------E-E-E----[]-------[]--------E--E--[]----[]----[]-----E-----E--[]----[]----[]--[]------EE-EE-E---[]---------------E-------[]---------------EEE-----[]----------[]--[]-------E-EE--[]----E--[][][]-E----EE-E[]----[]----[]----------EE-----[]-------[]--------EE-E--[]-[]-[]----[]--[]----E-E---[]----[]---EE-----XXXX------------E-E---E---[]---------E--E-E---[]-------------E-E--[]----[]------------------E-E-----EE-E--[]--[]-------E-EE-----E-EE--[][]--E------E--[]----[]----[][]--------EE--[]----[]----[]-------EE-EE--[]----[]----[]------EEE--E--[]----------[]--------EE-E--E--[]-E-EE--[]--------E-EE--[]----[]----[]--[]------E------[]-------[][]--------EE--[]E---[]----[]-----EEEE--E--[]----[]---------------E-E-[]--[]-E--E--[][]--------EE-EXXE---[]----[][]--------EEEE---[]-----------------E-E------------XXXXXXXX------[]--[]-----[]----[]--XX-------E-EE-E---[]----[]----------EE-EE-----------[]--------E--E--E--[]-E-EE--[]--------E-EE--[]-E--[]----[][]---------E--[]--------------X----------EE-E---------[][][]------EE-----[]-------[]-------EE--E--[]----[]----[]---E----E--E--[]-[]-[]----[][]--------EE-E--E---------[]-E[]---------E--EEE---------[]-E-----E-E-----[]----------XXX----E--------[]-------[][]---------E--[]---------
XXXXX---XXXXXXXXXXXXXXX--XXXXXXXXX-XXXXXXXXXXXXXXXXXXXXXXXXXXXXXXXXXXXXXXX-XXXXXXXXXXXXXXXXXXXXXXXXXXXXXXXXXXXXX-XXXXXXXXXXXXXXXXXXXXXXXXXXX-XXXXXXXXXXXXXXXXXXXXXXXXXXXXXXXXX-XXXXXXXXXXXXXXXXXXXXX-XXXXXXXXXXXXXXXXXXXXXXXXXXXXXXXXXXXXXXXXXXXXXXXXXXXXXXXXXXXXXXXXXXXXXXXXXXXXXXXXXX-XXXXXX---XXXXXXXXXXXXX--XX-XXXX---XXXXXXXXXXXXXXXXXXXXXX-XXXXXXXXXXXXXXXXXXXXXXXXXXXXXXXXXXXXXXXXXXXXXXXXXXXXXXX-XXXXXXXXXXXXXXXXXXXXXXXXXXXXXXXXXXXXXXXXXXXXXXXXXXXXXXXXXXXXXXXXXXXXXXXXXXXXXXXXXXXXXXXXXXXXX--------XXXXXXXXXXXXXXXXXXXXXXXXXXXXXXXXXXXXXXXXXXXXXXXXXXXXXXXXXXXXXXXXXXXXXX-----XXXXXXXXXXXXXXXXXXX-XXXXXXXXXXXXXXXXXXXXXXXXXXX-XXXXXXXXXXXXXXXXXXXXXXXXXXXXXXXXXXXXXXXXXXXXXXXXXXXXXX--XXXXXXXXXXXXXXXXXXXXXXXXXXX-XXXXXXXXXXXXXXXXXXXXXXXXXXX-XXXXXXXXXXXXXXXXXXXXXXXXXXX-XXXXXXXXXXXXXXXXXXXXXXXXXXX-XXXXXXXXXXXXXXXXXXXXXXXXXXX-XXXXXXXXXXXXXXXXXXXXXXXXXXX-XXXXXXXXXXXXXXXXXXXXXXXXXXXXXXXXXXXXXXXXXXXXXXXXXXXXXXXXXXXXXXXXXXXXXXXXXXXXXXXXXXX-XXXXXXXXXXXXXXXXXXXXXXXXXXXXXXXXXXXXXXXXXXXXXXXXXXXXXXXXXXXX----XXXXXXXXXXXXXXXXXX--XX--XX--XXXXXXXXXXXXXXXXXXX-XX--XXXXXXXXXXXXXXXXXXXXXXX-XXXXXXXXXXXXXXXXXXXXXXXXXXXXXXXXXXXXXXXXXXXXXXXXXXXXXXXXXXXXXXXXXXXXXXXXXXXXXXXXXXXXXXX-X---XXXXXXXXXXXXXXXXXXXXXXXXXXXXXXXXXXXXXXXXXXXXXXX-XXXXXXXXXXXXXXXXXXXXXXXXXXX-XXXXXXXXXXXXXXXXXXXXXXXXXXX-XXXXXXXXXXXXXXXXXXXXXXXXXX--XXXXXXXXXXXXXXXXXXXXXXXXXXXXXXXXXXXXXXXXXXXXXXXXXXXXXXXXXXXXXXXXXXXXXXXXXXXXXXXXXXXXXXXXXXXXXXXXXXXXXXXXXXXXXXX
