----------------------------------------------------------------------------------------------------------------------------------------------------------------------------------------------------------------------------------------------------------------------------------------
----------------------------------------------------------------------------------------------------------------------------------------------------------------------------------------------------------------------------------------------------------------------------------------
----------------------------------------------------------------------------------------------------------------------------------------------------------------------------------------------------------------------------------------------------------------------------------------
--------------------------------------------------------------------------------------------------------------------------------------------------------------------------------------------------------------------o-------------------------------------------------------------------
----------------------------------------------------------------------------------------------------------------------------------------------------------------------------------------------------------------------------------------------------------------------------------------
----------------------------SSSS----------Q-----------------------------------------SSQ--------------XXX---------------?----------------------------------------------------------------------------XX---E----------------------------------------------S-------------------------------
------------------------------------------------------------------------------------------------------------------------------oo---o------XX---------------------oo----------------------------------------XXXX-Eo---o-----------XXX----------o-----------------------------------------
---------------------------------------------------XX---------------------XXXXXXX----------------------------------XX---------XXX-XXX---------------------------------------------------------------------------XXX-XXX-X-----------------E---------------------------------------------
-----------------------------------------------------------oo------------------------------------------------------XX----------------------X------------------E--------------------------------------------------------------------------XXXX-------------------------------------------
--------QQQ--------------E---------Q--QQQQ--Q-QQ---------o---------------------------QQ---------------------------XXX--SS------------------------------------<>----------------------------------------------------------------X-E--EE-E------XXX---XXXX------X-------------------------
------------------E--E--<>---------------------------------------------------------------------------------------XXXX----------------------------------------[]------------------------------------------XXXXXX-?-------------XXXXXXXXXXXX------------XXXXXX----------------------------
-----------------<>-<>--[]---------------------------------------------------------X-----------------XXXX---------XXX----------------------------------------[]--------------------------------------------------------------XXX--------------------------------------------------------
--------EE--E-EE-[]-[]--[]-------------E-----E--------------------------------------------------------------------XXX---------E-EE--------oo-----------------[]-------------------------------------------------------------XXXX--------------------------------------------------------
XXXXXXXXXXXXXXXXXXXXXXX-XXXXXXXXXXXXXXXXXXXXXXXXXXXXXXXXXXXXXXXXXX---XXX-----XXX----XXX-------------------------XXXXXXXXXXX-XXXXXXXXX---XXXXXXXXX----XXXXXXXXXXXXXXXXXXX----------XXXXXXXXXXXX---XXXXXXXXX-----XXXXXXXXXXXXXXXXX----------XXXX-----X-----XXX----------XXXXXXXXXXXX----XX
