--------------------------------------------------------------------------------------------------------------------------------------------------------------------------------------------------------------------------------------------------------------------------------------------------------------------------------------------------------------------------------------------------------------------------------------------------------------------------------------------------------------------------------------------------------------------------------------------------------------------------------------------------------------------------------------------------------------------------------------------------------------------------------------------------------------------------------------------------------------------------------------------------------------------------------------------------------------------------------------------------------------------------------------------------------------------------------------------------------------------------------------------------------------------------------------------------------------------------------------------------------------------------------------------------------------------------------------------------------------------------------------------------------------------------------------------------------
--------------------------------------------------------------------------------------------------------------------------------------------------------------------------------------------------------------------------------------------------------------------------------------------------------------------------------------------------------------------------------------------------------------------------------------------------------------------------------------------------------------------------------------------------------------------------------------------------------------------------------------------------------------------------------------------------------------------------------------------------------------------------------------------------------------------------------------------------------------------------------------------------------------------------------------------------------------------------------------------------------------------------------------------------------------------------------------------------------------------------------------------------------------------------------------------------------------------------------------------------------------------------------------------------------------------------------------------------------------------------------------------------------------------------------------------------------
------------------------------------------------------------------------------------------------------------------------------------------------------------------------S-------------------------------ooo----------------------------------------------------------------------------------oo------------------------------------------S------------------------------------------------------------------------------------------------------------------------------------------------------------------------------------------------------------------------------------------------------------------S-----S--------------------------oo----------------------------------------------------------------------------------------------------------------------------------------------------------------------oo----------------------------------------------------------------------------------------------------------------------------------------------------------------------------------------------------------------------------------------------------------------------------------------------------------------------------------------------------------------------------------------------------------------------------------------------------------------------------------------------------------------------oo-------------------------------------------------SSS--SS------SS-----------------------------------------
----------------------------------------------------------------------------------------------------------------------X---------------------------------------------------------------------------------XXXX---------------------------------------------------------------------------------XXX-------------------------------------------------------------------------------------------------------------------------------------------------------------------------------------------------------------o-------------------------------------------------------------------------------------------------------------------------------XXX---------------------------------------------------------------------------------------------------------------------------------------------------------------------XXX-------------------------------------o-------------------------------------------------------------------------------------------------------------------------------XXX-------------------------------------------------------------------------------------------------------------------------o-------------------------------------------------------------------------------------------------------------------------------------------------------------------------------------------------------------------XXX--------------------------------------------------------------------------------------------------------
------------------------------------------------------------------------E-----------------------------------------------------------------------------------------------------------------------------------------------------------------------------------------------------------------------------------------------------------------------------------------------------------------------------------------------------------------------------------------------------------------------------------E-------------------------------------------------------------------------------------------------------------------------------------------------------------------------------------------------------------------------------------------------------------------------------------------------------------------------------------------------------------------------------------------------------------------------------------------------------------------------------------------------------------------------------------------------------------------------------------------------------------------------------------------------------------------------------------------------------------------------------------------------------------------------------------------------------------------------------------------------------------------------------------------------------------------------------------------
-------------------------SQQ------------------------SSSS--------------SSS------------------------------------SQS------------------------SSSS--------------SSS------------------------------------SSS------------------------SSSS--------------SSS------------------------------------S-S------------------------SSQS--------------SSQ----------------------------------------------------------------SQS-------------------------------------------------------S------------------------SSSS--------------SSS----------------------------------------------------------------SSS--------------SSS------------------------------------SSS----------------------SSSSSS----------------S--------------------------------------o-------------------------SSS--------------SSS------------------------------------SSS------------------------SSSS----------------S--------------------------------------S------------------------SSSS--------------SSS------------------------------------SSS------------------------SSQS--------------SSS---------------------------------------------------------------SSSS--------------SQS--------------------------------------S-------------------------SSS--------------SSS--------------------------------------S------------------------SSSS--------------SSS------------------------------------SSS------------------------SSSS-----------------------------------------------------SSS------------------------SSQS
-----------------------------------------------------------------------------------------------------------------------------------------------------------------------------------------------------------------------------------------------------------------------------------------------------------------------------------------------------------------------------------------------------------------------------------------------------------------------------------------------------------------------------------------------------------------------------------------------------------------------------------------------------------------------------------------------------------------------o--------------------------------------------------------------------------------------------------------------------------------------------------------------------------------------------------------------------------------------------------------------------------------------------------------------------------------------------------------------------------------------------------------------------------------------------------------------------------------------------------------------------------------------------------------------------------------------------------------------------------------------------------------------------------------------------------------------------------------
---------------------------------------------------------------------------------------------------------------------------------------------------------------------------------------------------------------------------------------------------------------------------------------------------------------------------------------------------------------------------------------------------------------------------------------------------------------------------------------------------------------------------------------------------------------------------------------------------------------------------------------------------------------------------------------------------------------------------------------------------------------------------------------------------------------------------------------------------------------------------------------------------------------------------------------------------------------------------------------------------------------------------------------------------------------------------------------------------------------------------------------------------------------------------------------------------------------------------------------------------------------------------------------------------------------------------------------------------------------------------------------------------------------------------S----------------------------
------------------E---------------------------E--------S----------------------------------------------E--o------------------------E--S----------------------------------------------------E--S-----S------------------E-------------------------------------------------------E--------S------------------E--o----------------------------------------------------E---------------------------E--o----------------------------------------------------E--S------------------------E--o----------------------------------------------------E---------------------------E--S----------------------------------------------------E--o-----S------------------E-------------------------------------------------------E--S-----S------------------E--S-----S----------------------------------------------E--------S------------------E------------------------------E------------------------E--------S------------------E--S----------------------------------------------------E--------S------------------E-------------------------------------------------------E---------------------------E--S----------------------------------------------------E---------------------------E-------------------------------------------------------E---------------------------E-------------------------------------------------------E---------------------------E--S----------------------------------------------------E--S-----S------------------E---------
-----------------<>------E?S-QQ--------------<>------E-S---Q----QQQ----------E----QQ-----------------<>------E?S-----------------<>-----E--S---Q---Q--Q----------E----QQ-----------------<>------E-S-----------------<>------E?S-QQQQQ--QQQ----?S----E----QQ-----------------<>------E-S-QQ--------------<>------E?S-Q------------S?S----------o---ooo-----------<>------E-------------------<>------E?SQ---QQ---------------------Q-----------------<>--------------------------<>------E?S--QQQ---QQQ----------E-----Q-----------------<>--------------------------<>-----E--S---Q---Q--Q---------------QQ-----------------<>------E?S-------Q---------<>------E?S-----QQ-------------<>---QQQ-----o-----------<>-----------S--------------<>-----E----Q-Q------Q---------------QQ-----------------<>------E-S-----------------<>-----E--S---QQ---QQQQ--------<>-----Q----o------------<>--------------------------<>-----E--S-QQQ------Q---Q?S----------Q-----------------<>------E-S-----------------<>------E?S---QQQ---------?-----------Q---ooo-----------<>--------------------------<>-----E--S-QQ-QQQQ--QQ--QQS----------Q----o------------<>--------------------------<>-----E--S-Q-QQ----QQ---------------QQ---oo------------<>------E-------------------<>-----ES?S---Q------Q----------E----QQ-----------------<>--------------------------<>-----E--S-QQQ----Q-Q----------------o-----------------<>-----E--S-------QQ--------<>------E-S
-----------------[]--------------------------[]-----------------------------<>-----------------------[]--------------------------[]----<>-----------------------<>-----------------------[]-----E--------------------[]-----E-----------------------<>-----------------E-----[]-----E--------------------[]------------------------------------------------------[]--------------------------[]-----E------------------------------------------E-----[]-----E--------------------[]-----E-----------------------<>-----------------------[]-------------<>-----------[]----<>------------------------------------------------[]-----E--------------------[]-----------------------------[]---------E-------------[]--------------------------[]----<>-----------------------<>-----------------------[]-----E--------------------[]----<>-----------------------[]-----------------E-----[]----<>--------------------[]----<>------------------------------------------------[]-----E--------------------[]------------------------------------------------------[]--------------------------[]----<>------------------------------------------------[]-----E--------------------[]----<>-----------------------<>-----------------------[]--------------------------[]----<>-----------------------<>-----------------------[]--------------------------[]----<>------------------------------------------------[]----<>--------------------[]---------
-----------------[]--------------------------[]-----------------------------[]-----------------------[]--------------------------[]----[]-----------------------[]-----------------------[]--------------------------[]-----------------------------[]-----------------------[]--------------------------[]------------------------------------------------------[]--------------------------[]-----------------------------<>----------------<>-----[]--------------------------[]-----------------------------[]-----------------------[]-------------[]-----------[]----[]-----------------------<>-----------------------[]--------------------------[]-----------------------------[]--------<>-------------[]--------------------------[]----[]-----------------------[]-----------------------[]--------------------------[]----[]-----------------------[]----------------<>-----[]----[]--------------------[]----[]------------------------------------------------[]--------------------------[]------------------------------------------------------[]--------------------------[]----[]------------------------------------------------[]--------------------------[]----[]-----------------------[]-----------------------[]--------------------------[]----[]-----------------------[]-----------------------[]--------------------------[]----[]-----------------------<>-----------------------[]----[]--------------------[]---------
---------E-EE-E--[]--------------E---E-EE-E--[]----------E------------EE----[]-EE-E----------E-E-----[]-----------------EEEE--E--[]----[]-----------------EE----[]--E-E------------------[]------------------E-EE-E--[]-----------------------EE----[]-EE-E---------E--------[]------------------E-EE-E--[]-----------------------EE--------E-E------------------[]-----------------EE-EE-E--[]-----------------------EE----[]--E-E-------E-E-[]-----[]----X-------------EEEE-E--[]----------E------------EE----[]-EE-E------------------[]-------------[]--EEE---E--[]----[]-----------------EE----[]--E-E------------------[]--------------------E--E--[]---------E-------------EE----[]--E-E---[]-------------[]------------------EE------[]----[]-----------------EE----[]--E-E---------EE-------[]-----------------EE-EE-E--[]----[]-----------------EE----[]-EE-E---------E-[]-----[]----[]--------E--EE--E-E--[]----[]-----------------EE-------EE-E------------------[]-----------------EE-EE-E--[]-----------------------EE--------E-E------------------[]-----------------EEE---E--[]----[]---E-------------EE-------EE-E------------------[]------------------EEE-----[]----[]----E------------EE----[]--E-E----------------E-[]-----------------EEEE-----[]----[]----E------------EE----[]--E-E---------------E--[]----X-------------EEE--E--[]----[]---------------E-EE----[]-EE-E------------------[]----[]------------E-EE-E--[]---------
XXX---XXXXXXXXXXXXXXXXXXXXXXXXXXXXXXXXXXXXXXXXXXXXXXXXXXXXXXXXXXXXXXXXXXXXXXXXXXXXXXXXXXXXXXXXXXXXXXXXXXXXXXXXXXXXXXXXXXXXXXXXXXXXXXXXXXXXXXXXXX-XXXXXXXXXXXXXXXXXXXXXXXXXXXXXXXXXXXXXXXXXXXXXXXXXXXXXXXXXXXXXXXXXXXXXXXXXXXXXXXXXXXXXXXXXXXXXXXXXXXXXXXXXXXXXXXXXXXXXXXXXXXXXXXXXXXXXXXXXX--XXXXXXXXXXXXXXXXXXXXXXXXXXXXXXXXXXXXXXXXXXXXXXXXXXXXXXXXXXXXXXXXXXXXXXXXXXXXXXXXXXXXXXXXXXXXXXXXXXXXXXXXXXXXXXXXXXXXXXXXXXXXXXXXXXXXXXXXXXXXXXXXXXXXXXXXXXXXXXXXXXXXX---XXXXXXXXXXXXXXXXXXXXXXXXXXXXXXXXXXXXXXXXXXXXXXXXXXXXXXXXXXXXXXXXXXXXXXXXXXXXXXXXXXXXXXXXXXXXXXXXXXXXXXXXXXXXXXXXXXXXXXXXXXXXXXXXXXXXXXXXXXXXXXXXXXXXXXXXXXXXXXXXXXXXXXXXXXXXXXXXXXXXXXXXXXXXXXXXXXXXXXXXXXXXXXXXXXXXXXXXXXXXXXXXXXXXXXXXXXXXXXXXXXXXXXXXXXXXXXXXXXXXXXXXXXXXXXXXXXXXXXXXXXXXXXXXXXXXXXXXXXXXXXXXXXXXXXXXXXXXXXXXXXXXXXXXXXXXXXXXXXXXXXXXXXXXXXXXXXXXXXXXXXXXX---XXXXXXXXXXXXXXXXXXXXXXXXXXXXXXXXXXXXXXXXXXXXXXXXXXXXXXXXXXXXXXXXXXXXXXXXXXXXXXXXXXXXXXXXXXXXXXXXXXXXXXXXXXXXXXXXXXXXXXXXXXXXXXXXXXXXXXXXXXXXXXXXXXXXXXXXXXXXXXXXXXXXXXXXXXXXXXXXXXXXXXXXXXXXXXXXXXXXXXXXXXXXXXXXXXXXXXXXXXXXXXXXXXXXXXXXXXXXXXXXXXXXXXXXXXXXXXXXXXXXXXXXXXXXXXXXXXXXXXXXXXXXXXXXXXXXXXXXXXXXXXXXXXXXXXXXXXXXXXXXXXXXXXXXXXXXXXXXXXXXXXXXXXXXXXXXXXXXXXXXXXXXXXXXXXXXXXXXXXXXXXXXXXX-XXXXXXXXXXXXXXXXXXXXXXXXXXXXXXXXXXXXXXXXXXXXXXXXXXXXXXXXXXXXXXXXXXXXXXXXXXXXXXXXXXXXXXXXXXXXXXXXXXXXXXXXXXXXXXXXXXXXXXXXXXXXXXXXXXXXXXXXXXXXXXXXXXXXXXXXXXXXXXXXXXXXXXXXXXXXXXXXXXXXXXXXXXXXXXX
