--------------------------------------------------------------------------------------------------------------------------------------------------------------------------------------------------------------------------------------------------------------------------------------------------------------------------------------------------------------------------------------------------------------------------------------------------------------------------------------------------------------------------------------------------------------------------------------------------------------------------------------------------------------------------------------------------------------------------------------------------------------------------------------------------------------------------------------------------------------------------------------------------------------------------------------------------------------------------------------------------------------------------------------------------------------------------------------------------------------------------------------------------------------------------------------------------------------------------------------------------------------------------------------------------------------------------------------------------------------------------------------------------------------------------------------------------------
--------------------------------------------------------------------------------------------------------------------------------------------------------------------------------------------------------------------------------------------------------------------------------------------------------------------------------------------------------------------------------------------------------------------------------------------------------------------------------------------------------------------------------------------------------------------------------------------------------------------------------------------------------------------------------------------------------------------------------------------------------------------------------------------------------------------------------------------------------------------------------------------------------------------------------------------------------------------------------------------------------------------------------------------------------------------------------------------------------------------------------------------------------------------------------------------------------------------------------------------------------------------------------------------------------------------------------------------------------------------------------------------------------------------------------------------------------
--------------------------------------------------------------------------------------------------------------------------------------------------------------------------------------------------------------------------------------------------SSSSSSSSSS--------------------------------ooo----------------------------------------------------------------------------------------------------------------------------------------------------------------------oo-------------------------------------------------------------------------------------------------------------------------------------------------------------------------------------------------------------------------------------------------------------------------------------------------------------S-----------------------------------------------------------------------------------------------------------------------------------------------------------------------SSSSSSSSSSSSSSS------------------------------------------------------------------------------------------------------oo----------------------------------------------------------------------------------------------------------------------------------------------------------------------------------------------------------------------------------------------------------oo----------------------------------------------------------------------------------oo---------------------
-------------------------------------------------------------------------o-------------------------------------------------------------------------------------------------------------------------------XX---------------------------------------------------------------------------------XXXX--------------------------------------------------------------------------------------------------------------------------------------------------------------------XXXX-------------------------------------o-------------------------------------------------------------------------------------------------------------------------------------------------------------------------------------------------------------------------------------------------------------------------------------------------------------------------------------------------------------------------------------------------------------------------------------------------------------------------------------------------------------------------------------------------------------------XXX----------------------------------------------------------------------------------X--------------------------------------o-------------------------------------------XX---------------------------------------------------------------------------------XXXX--------------------------------------------------------------------------------XXXX--------------------
-----------------------------------------------------------------------------------------------------------------------------------------------------------------------------------------------------------------------------------------------------------------------------------------------------------------------------------------------------------------------------------------------------------------------------------------------------------------------------------------------------------------------------------------------------------------------------------------------E-----------------------------------------------------------------------------------------------------------------------------------------------------------------------------------------------------------------------------------------------------------------------------------------------------------------------------------------------------------------------------------------------------------------------------------E--------------------------------------------------------------------------------------------------------------------------------------------------------------------------------------------------------------------------------------------------------------------------------------------------------------------------------------------------------------------------------------------------------------------
-------------------------SSS------------------------SSS---------------SSS----------------------------------------------------------------SSS--------------SSS------------------------------------SSS------------------------SSSS--------------SSS------------------------------------SQQ----------------------SSSSSS--------------SSS----------------------------------------------------------------SSS--------------SSS------------------------------------SSS------------------------SSSS--------------SSS---------------------------------------------------------------SSSS--------------SQS------------------------------------SQS------------------------SSSS--------------SSS------------------------------------SQS------------------------SSSS--------------SSS----------------------------------------------------------------SSS-----------------------------------------------------SSS------------------------SSSS-----------------------------------------------------SSS------------------------SSSS--------------SQS--------------------------------------S------------------------SSQS-----------------------------------------------------S-S------------------------SSSS--------------SSS--------------------------------------S------------------------SSSS--------------SSS--------------------------------------S------------------------SSSS-----------------------------------------------------SSS----------------------S-SSSS
--------------------oo----------------------------------------------------------------------------------------------------------------------------------------------------------------------------------------------------------------------------------------------------------------------------------------------------------------------------------------------------------------------------------------------------------------------------------------------------------------------------------------------------------------------------------------------------------------------------------------------------------------------------------------------------------------------------------------------------------------------------------------------------------------------------------------------------------------------------------------------------------------------------------------------------------------------------------------------------------------------------------------------------------------------------------------------------------------------------------------------------------------------------------------------------------------------------------------------------------------------------------------------------------------------------------------------------------------------------------------------------------------------------------------------------------------------------------
---------------------------------------------------------------------------------------------------------------------------------------------------------------------------------------------------------------------------------------------------------------------------------------------------------------------------------------------------------------------------------------------------------------------------------------------------------------------------------------------------------------------------------------------------------------------------------------------------------------------------------------------------------------------------------------------------------------------------------------------------------------------------------------------------------------------------------------------------------------------------------------------------------------------------------------------------------------------------------------S------------------------------o----------------------------------------------------------------------------------------------------------------------------------------S----------------------------------------------------------------------------------------------------------------------------------------------------------------------------------------------------------------------------------------------------------------------------------------
------------------E--S------------------------E-------------------------------------------------------E---------------------------E--S-----S----------------------------------------------E--------S------------------E--S----------------------------------------------------E---------------------------E--o----------------------------------------------------E--SS-----------------------E--S----------------------------------------------------E--------S------------------E--o----------------------------------------------------E--SS-----------------------E--S-----S----------------------------------------------E---------------------------E-------------------------------------------------------E--o-----S------------------E------------------------------E-------------------S----E--------S------------------E--S-----S----------------------------------------------E--S-----S------------------E------------------------------E------------------------E--------S------------------E-------------------------------------------------------E---------------------------E--o----------------------------------------------------E--S-----S------------------E--o---------------------------E------------------------E--------S------------------E--S----------------------------------------------------E---------------------------E-------------------------------------------------------E--S-----S------------------E--o------
--S--------------<>-----E--------------------<>------S?S-----QQQ--QQ---Q-----E----QQ-----------------<>--------------------------<>-----E--S-Q--------Q----------------Q-Q---------------<>------E-S-----------------<>-----E--S-QQQQ---Q-Q---S?S---<>-----Q-----------------<>------E?S-----------------<>------E?S-Q-QQQQ---Q----------E----QQ---ooo-----------<>--------------------------<>-----E--S-Q--QQ-Q--Q----?----------QQ-----------------<>------E?S-----------------<>-----E??S-QQQ---QQ-Q---QQS----------Q---ooo-----------<>--------------------------<>-----E--SQQ---QQQ------Q?S----------Q-----------------<>------E-------------------<>-----E??S-Q-QQQQ---QQ-------------QQQ-----------------<>------E?S-----------------<>------E?S-------Q--Q---------<>----QQ---ooo-----------<>------E-S-----------------<>-----E--S-Q-QQ-----Q---------------QQ-----------------<>----------------QQ--------<>-----E------QQ---QQQ---------<>----QQ---ooo-----------<>------E?S-----------------<>-----E--SQQ--QQ--------Q?S----------Q-----------------<>----------QQ--------------<>------E?S-Q-QQ---QQQ----------------Q----o------------<>------E-S-Q---------------<>------E?S---Q---QQQQ---------<>----QQ-----------------<>-----E--------------------<>-----E--S---Q------Q---------------QQ----oo-----------<>------E-S-----------------<>-----E--S-Q-QQ----QQ----------E----QQ---oo------------<>------E-S-QQ--------------<>------E?S
-----------------[]----<>-----E--------------[]-----------------------------<>-----------------------[]--------------------------[]----<>------------------------------------------------[]-----E--------------------[]----<>-----------------------[]-----------------------[]--------------------------[]-----------------------------<>-----------------------[]--------------------------[]----<>------------------------------------------------[]-----E--------------------[]----<>------------------------------------------------[]--------------------------[]----<>------------------------------------------------[]--------------------------[]----<>------------------------------------------------[]--------------------------[]-----------------------------[]-----------------------[]--------------------------[]----<>------------------------------------------------[]-----E--------------------[]----<>-----------------------[]-----------------------[]-----E--------------------[]----<>------------------------------------------------[]-----E--------------------[]------------------------------------------------------[]-----E--------------------[]-----------------------------[]-----------------E-----[]----<>--------------------[]----<>------------------------------------------------[]--------------------------[]----<>-----------------------<>-----------------------[]-----E--------------------[]---------
-----------------[]----[]----<>--------------[]-----------------------------[]-----------------------[]--------------------------[]----[]------------------------------------------------[]--------------------------[]----[]-----------------------[]-----------------------[]--------------------------[]-----------------------------[]-----------------------[]--------------------------[]----[]------------------------------------------------[]--------------------------[]----[]-----------------------<>-----------------------[]--------------------------[]----[]------------------------------------------------[]--------------------------[]----[]-----------------------<>-----------------------[]--------------------------[]-----------------------------[]-----------------------[]--------------------------[]----[]------------------------------------------------[]--------------------------[]----[]-----------------------[]-----------------------[]--------------------------[]----[]------------------------------------------------[]--------------------------[]------------------------------------------------------[]--------------------------[]-----------------------------[]----------------<>-----[]----[]--------------------[]----[]-----------------------<>-----------------------[]--------------------------[]----[]-----------------------[]-----------------------[]--------------------------[]---------
--------EEE------[]----[]----[]------E-E-----[]-----------------------EE----[]--E-E------------------[]-----------------EEE-E-E--[]----[]-----------------EE--------E-E----------E-------[]-----------------EE--E-E--[]----[]----E------------EE----[]--E-E----------E--E-E--[]------------------EEEE-E--[]----------E------------EE----[]--E-E----------------E-[]-----------------EEE-E-E--[]----[]-----------------EE--------E-E-------E-EE-------[]------------------EEE--E--[]----[]---EE------------EE----[]-EE-E------------------[]-----------------EEE------[]----[]---E-------------EE--------E-E---------EE-EE-E--[]-----------------EEE---E--[]----[]------------E----EE----[]--E-E----------E-------[]--------------------E--E--[]-----------------------EE----[]--E-E------------------[]--------------E--EEE------[]----[]-----------------EE--------E-E---------E---E----[]--------------------E--E--[]----[]-----------------EE----[]--E-E------------------[]-----------------EE-E--E--[]----[]-----------------EE--------E-E-------------E----[]------------------E-EE-E--[]-----------------------EE----X--EE-E---------E--------[]----X-------------E-EE-E--[]----------E------------EE----[]-EE-E---------E-[]-----[]----[]-----------EEEE--E--[]----[]-----------------EE----[]--E-E------------------[]-----------------EE-EE-E--[]----[]-----------------EE----[]--E-E------------------[]------------------E-EE-E--[]---------
XXXXXXXXXXXXXXXXXXXXXXXXXXXX-XXXXXXXXXXXXXXXXXXXXXXXXXXXXXXXXXXXXXXXXXXXXXXXXXXXXXXXXXXXXXXXXXXXXXXXXXXXXXXXXXXXXXXXXXXXXXXXXXXXXXXXXXXXXXXXXXXXXXXXXXXXXXXXXXXXXXXXXXXXXXXX-XXXXXXXXXXXXXXXXXXXXXXXXXXXXXXXXXXXXXXXXXXXXXXXXXXXXXXXXXXXXXXXXXXXXXXXXXXXXXXXXXXXXXXXXXXXXXXXXXXXXXXXXXXXXXX---XXXXXXXXXXXXXXXXXXXXXXXXXXXXXXXXXXXXXXXXXXXXXXXXXXXXXXXXXXXXXXXXXXXXXXXXXXXXXXXXXXXXXXXXXXXXXXXXXXXXXXXXXXXXXXXXXXXXXXXXXXXXXXXXXXXXXXXXXXXXXXXXXXXXXXXXXXXXXXXXXXXXX--XXXXXXXXXXXXXXXXXXXXXXXXXXXXXXXXXXXXXXXXXXXXXXXXXXXXXXXXXXXXXXXXXXXXXXXXXXXXXXXXXXXXXXXXXXXXXXXXXXXXXXXXXXXXXXXXXXXXXXXXXXXXXXXXXXXXXXXXXXXXXXXXXXXXXXXXXXXXXXXXX-XXXXXXXXXXXXXXXXXXXXXXXXXXXXXXXXXXXXXXXXXXXXXXXXXXXXXXXXXXXXXXXXXXXXXXXXXXXXXXXXXXXXXXXXXXXXXXXXXXXXXXXXXXXXXXXXXXXXXXXXXXXXXXXXXXXXXXXXXXXXXXXXXXXXXXXXXXXXXXXXXXXXXXXXXXXXXXXXXXXXXXXXXXXXXXXXXXXXXXXXXXXXXXXXXXXXXXXXXXXXXXXXXXXXXXXXXXXXXXXXXXXXXXXXXXXXXXX--XXXXXXXXXXXXXXXXXXXXXXXXXXXXXXXXXXXXXXXXXXXXXXXXXXXXXXXXXXXXXXXXXXXXXXXXXXXXXXXXXXXXXXXXXXXXXXXXXXXXXXXXXXXXXXXXXXXXXXXXXXXXXXXXXXXXXXXXXXXXXXXXXXXXXXXXXXXXXXXXXXXXXXX--XXXXXXXXXXXXXXXXXXXXXXXXXXXXXXXXXXXXXXXXXXXXXXXXXXXXXXXXXXXXXXXXXXXXXXXXXXXXXXXXXX--XXXXXXXXXXXXXXXXXXXXXXXXXXXXXXXXXXXXXXXXXXXXXXXXXXXXXXXXXXXXXXXXXXXXXXXXXXXXXXXXXXXXXXXXXXXXXXXXXXXXXXXXXXXXXXXXXXXXXXXXXXXXXXXXXXXXXXXXXXXXXXXXXXXXXXXXXXXXXXXXXXXXXXX-XXXXXXXXXXXXXXXXXXXXXXXXXXXXXXXXXXXXXXXXXXXXXXXXXXXXXXXXXXXXXXXXXXXXXXXXXXXXXXXXX---XXXXXXXXXXXXXXXXXXXXXXX
