--------------------------------------------------------------------------------------------------------------------------------------------------------------------------------------------------------------------------------------------------------------------------------------------------------------------------------------------------------------------------------------------------------------------------------------------------------------------------------------------------------------------------------------------------------------------------------------------------------------------------------------------------------------------------------------------------------------------------------------------------------------------------------------------------------------------------------------------------------------------------------------------------------------------------------------------------------------------------------------------------------------------------------------------------------------------------------------------------------------------------------------------------------------------------------------------------------------------------------------------------------------------------------------------------------------------------------------------------------------------------------------------------------------------------------------------------------
--------------------------------------------------------------------------------------------------------------------------------------------------------------------------------------------------------------------------------------------------------------------------------------------------------------------------------------------------------------------------------------------------------------------------------------------------------------------------------------------------------------------------------------------------------------------------------------------------------------------------------------------------------------------------------------------------------------------------------------------------------------------------------------------------------------------------------------------------------------------------------------------------------------------------------------------------------------------------------------------------------------------------------------------------------------------------------------------------------------------------------------------------------------------------------------------------------------------------------------------------------------------------------------------------------------------------------------------------------------------------------------------------------------------------------------------------------
------------------------------------------------------------------------------------SSSSSSS--------------------------------------------------------------------------------------------------------------oo-------------------------------------------------------------------------------------------------------------------------------------------------------------------------------------------------------------------------------------------------------------------------------------------------------------------------------------------------------------------------------------------------------------------------------------------------------------------------------------------------------------------------------------------------------------------------------------------------------------------------------------------------------------S-----------------------------------------------------------------------------------------------------------------------------------------------------------------------------------------------------------------------------------------------------------SSSSSSSSSSSSSSSSS----------------oo-----------------------------------------------------------------------------------------------------------------------------------------------------------------------o---------------------------------------------------------------------------------------------------------
-------------------------------------------------------------------------o------------------------------------------------------------------------------------------------------------------------------XXXX---------------------------------------------------------------------------------------------------------------------------------------------------------------------------------------------------------------------------------------------------------------------------------------------------------------------------------------------XX--------------------------------------o-------------------------------------------------------------------------------------------------------------------------------------------------------------------------------------------------------------------------------------------------------------------------------------------------------------------------------------------------------------------------------------------XX---------------------------------------------------------------------------------------------------------------------------------------------------------------------XXXX-------------------------------------o-------------------------------------------XX----------------------------------------------------------------------------------XXX--------------------------------------------------------------------------------------------------------
-----------------------------------------------------------------------------------------------------------------------------------------------------------------------------------------------------------------------------------------------------------------------------------------------------------------------------------------------------------------------------------------------------------------------------------------------------------------------------------------------------------------------------------------------------------------------------------------------------------------------------------------------------------------------------------------------------------------------------------------------------------------------------------------------------------------------------------------------------------------------------------------------------------------------------------------------------------------------------------------------------------------------------------------------------------------------------------------------------------------------------------------------------------------------------------------------------------------------------------------------------------------------------------------------E--------------------------------------------------------------------------------------------------------------------------------------------------------
-------------------------SSS----------------------SSSSSS--------------SSS--------------------------------------o-------------------------SSS---------------SS------------------------------------SQS------------------------SSSS--------------SSS----------------------------------------------------------------SSS-------------------------------------------------------S------------------------SSSS-------------------------------------------------------S------------------------SSSS---------------SS------------------------------------SSS------------------------SSSS--------------SSS--------------------------------------o------------------------SSSS--------------SSS----------------------------------------------------------------SSS--------------SSS------------------------------------SSS------------------------SSSS-----------------------------------------------------SSS------------------------SSSS--------------SSS---------------------------------------------------------------SSSS--------------SSS------------------------------------SSS------------------------SSSS-------------------------------------------------------S------------------------SSSS--------------SSS--------------------------------------S------------------------SSSS--------------SQS------------------------------------SQS------------------------SSSS-------------------------------------------------------S------------------------SSSS
--------------------oo-------------------------------------------------------------------------------------------------------------------------------------------------------------------------------------------------------------------------------------------------------------o-----------------------------------------------------------------------------------------------------------------------------------------------------------------------------------------------------------------------------------------------------------------------------------------------------------------------------------------------o--------------------------------------------------------------------------------------------------------------------------------------------------------------------------------------------------------------------------------------------------------------------------------------------------------------------------------------------------------------------------------------------------------------------------------------------------------------------------------------------------------------------------------------------------------------------------------------------------------------------------------------------------------------------------------------------------------------------------------------------------------------------------------------------------------------------
-------------------------------------------------------------------------------------------------------------------------------------------------------------------------------------------------------------------------------------------------------------------------------------------E-------------------------------------------------------------------------------------------------------------------------------------------------------------------S-----------------------------------------------------------------------------------S-----------------------------------------------------------------------------------------------------------------------------------------------------------------------------------------------------------------------------------------------------------------------------------------------------------------------------------------------S-----------------------------------------------------------------------------------------------------------------------------------------------------------------------------------------------------------------------------------------------------------S----------------------------------------------------------------------------------------------------------------------------------------------------------------------------------------------------------------------------------------------------------------------------------------
------------------E--S------------------------E-------------------------------------------------------E--S-----S------------------E--S---------------------------E--------E---------------E---------------------------E------------------------------E------------------------E--S-----S------------------E--S-----S----------------------------------------------E--S-----S------------------E-------------------------------------------------------E--S-----S------------------E--S----------------------------------------------------E--S-----S------------------E-------------------------------------------------------E--SS-----------------------E-------------------------------------------------------E---------------------------E--S----------------------------------------------------E--------S------------------E--S----------------------------------------------------E--S-----S------------------E-------------------------------------------------------E---------------------------E--S----------------------------------------------------E--------S------------------E-------------------------------------------------------E--------S------------------E-------------------------------------------------------E---------------------------E-------------------------------------------------------E--------S------------------E-------------------------------------------------------E---------------------------E--S------
-SS--------------<>-----E--------------------<>------S?S-----QQQ--Q---QQ-----E---QQQ----oo-----------<>------E-------------------<>-----E--S---Q----QQQ---------<>----QQ-<>--------------<>------E?S-------Q---------<>------E?S-Q-Q---Q--Q---------<>----QQ---ooo-----------<>--------------------------<>-----E--S--------------------------QQ-----------------<>--------------------------<>-----E--S--QQQQ--QQQ---------<>-----Q-----o-----------<>-----E--------------------<>-----E--S---QQ---QQQQ--------<>-----Q-----------------<>--------S-----------------<>-----E--S----QQQQ--QQ---Q----------QQ---ooo-----------<>----------Q---------------<>-----E--S-Q-Q------Q----------E----QQ---ooo-----------<>------E-S-----------------<>-----E--S---QQQQ--QQ----------E-----Q----o------------<>--------S-----------------<>-----E--S---Q----------------------QQ-----------------<>-----E--S-----------------<>-----E--S-Q-QQ---QQQ----------E----QQ---ooo-----------<>--------------------------<>-----E--S-Q-QQQ----Q----------------Q---oo------------<>------E-S-----------------<>-----E--S---QQ----QQ---------<>----QQ---ooo-----------<>------E?S-----------------<>-----E-?S---Q---Q--QQ--------<>---QQQ----o------------<>------E-------------------<>-----E--SQQ---Q-Q--Q---Q?S----------Q-----------------<>------E?S-------QQ--------<>-----E--S---Q------Q---------<>----QQ-----------------<>------E-------------------<>-----E--S
-----------------[]----<>--------------------[]-----------------------------<>-----------------------[]--------------------------[]----<>-----------------------[]-------[]--------------[]-----E--------------------[]-----------------------------[]-----------------------[]--------------------------[]----<>------------------------------------------E-----[]--------------------------[]----<>-----------------------[]-----------------E-----[]----<>--------------------[]----<>-----------------------[]-----------------------[]----<>--------------------[]----<>-----------------------<>-----------------------[]--------------------------[]----<>-----------------------<>-----------------------[]--------------------------[]----<>-----------------------<>-----------------------[]--------------------------[]----<>------------------------------------------E-----[]----<>--------------------[]----<>-----------------------<>-----------------------[]--------------------------[]----<>------------------------------------------------[]--------------------------[]----<>-----------------------[]-----------------------[]--------------------------[]-----------------------------[]-----------------------[]--------------------------[]----<>------------------------------------------------[]--------------------------[]----<>-----------------------[]-----------------------[]--------------------------[]----<>---
-----------------[]----[]--------------------[]-----------------------------[]-----------------------[]--------------------------[]----[]-----------------------[]-------[]--------------[]--------------------------[]-<>--------------------------[]-----------------------[]--------------------------[]----[]-----------------------<>----------------<>-----[]--------------------------[]----[]-----------------------[]----------------<>-----[]----[]--------------------[]----[]-----------------------[]-----------------------[]----[]--------------------[]----[]-----------------------[]-----------------------[]--------------------------[]----[]-----------------------[]-----------------------[]--------------------------[]----[]-----------------------[]-----------------------[]--------------------------[]----[]-----------------------<>----------------<>-----[]----[]--------------------[]----[]-----------------------[]-----------------------[]--------------------------[]----[]-----------------------<>-----------------------[]--------------------------[]----[]-----------------------[]-----------------------[]--------------------------[]-----------------------------[]-----------------------[]--------------------------[]----[]------------------------------------------------[]--------------------------[]----[]-----------------------[]-----------------------[]--------------------------[]----[]---
--------EEE------[]----[]------------EEE-----[]-----------------------EE----[]--E-E----------E-----E-[]--------------E--EEE---E--[]----[]----E------------EE----[]-EE-E--[]------EEE-----[]--------------------EE-E--[]-[]--------------------EE----[]--E-E------------------[]-----------------EEE------[]----[]-----------------EE----[]--E-E-------E-E-[]-----[]------------------EEE--E--[]----[]-----------------EE----[]--E-E-E---------[]-----[]----[]-----------EEEE--E--[]----[]----E----------E-EE----[]-EE-E---------E--------[]----[]------------E-E--E--[]----[]-----------------EE----[]-EE-E------------------[]------------------EEEE-E--[]----[]-----------------EE----[]--E-E------------------[]-----------------EEE---E--[]----[]---------------E-EE----[]-EE-E------------------[]-----------------EEEE--E--[]----[]-----------------EE----[]--E-E---------E-[]-----[]----[]------------EEE--E--[]----[]-----------------EE----[]--E-E---------E--------[]-----------------EEE---E--[]----[]---------------E-EE----[]--E-E----------E-------[]------------------E-E--E--[]----[]-----------------EE----[]--E-E------------------[]------------------EEE--E--[]-----------------------EE----[]--E-E---------E--------[]------------------E-E--E--[]----[]-----------------EE--------E-E----------E-------[]------------------E-EE-E--[]----[]-----------------EE----[]--E-E---------E--------[]-----------------EEEE--E--[]----[]---
-XXXXXXXXXXXXXXXXXXXXXXXXXXXXXXXXXXXXXXXXXXXXXXXXXXXXXXXXXXXXXXXXXXXXXXXXXXXXXXXXXXXXXXXXXXXXXXXXXXXXXXXXXXXXXXXXXXXXXXXXXXXXXXXXXXXXXXXXXXXXXXXXXXXXXXXXXXXXXXXXXXXXXXX-XXXXXXXXXXXXXXXXXXXXXXXXXXXXXX--XXXXXXXXXXXXXXXXXXXXXXXXXXXXXXXXXXXXXXXXXXXXXXXXXXXXXXXXXXXXXXXXXXXXXXXXXXXXXXXXXXXXXXXXXXXXXXXXXXXXXXXXXXXXXXXXXXXXXXXXXXXXXXXXXXXXXXXXXXXXXXXXXXXXXXXXXXXXXXXXXXXXXXXXXXXXXXXXXXXXXXXXXXXXXXXXXXXXXXXXXXXXXXXXXXXXXXXXXXXXXXXXXXXXXXXXXXXXXXXXXXXXXXXXXXXXXXXXXXXXXXXXXXXXXXXXXXXXXXXXXXXXXXXXXXXXXXXXXXXXXXXXXXXXXXXXXXXXXXXXXXXXXXXXXXXXXXXXXXXXXXXXXXXXXXXXXXXXXXXXXXXXXXXXXXXXXXXXXXXXXXXXXXXXXXXXXXXXXXXXXXXXXXXXXXXXXXXXXX--XXXXXXXXXXXXXXXXXXXXXXXXXXXXXXXXXXXXXXXXXXXXXXXXXXXXXXXXXXXXXXXXXXXXXXXXXXXXXXXXXXXXXXXXXXXXXXXXXXXXXXXXXXXXXXXXXXXXXXXXXXXXXXXXXXXXXXXXXXXXXXXXXXXXXXXXXXXXXXXXXXXXXXXXXXXXXXXXXXXXXXXXXXXXXXXXXXXXX---XXXXXXXXXXXXXXXXXXXXXXXXXXXXXXXXXXXXXXXXXXXXXXXXXXX-XXXXXXXXXXXXXXXXXXXXXXXXXXXXXXXXXXXXXXXXXXXXXXXXXXXXXXXXXXXXXXXXXXXXXXXXXXXXXXXXXXX-XXXXXXXXXXXXXXXXXXXXXXXXXXXXXXXXXXXXXXXXXXXXXXXXXXXXXXXXXXXXXXXXXXXXXXXXXXXXXXXXXXXXXXXXXXXXXXXXXXXXXXXXXXXXXXXXXXXXXXXXXXXXXXXXXXXXXXXXXXXXXXXXXXXXXXXXXXXXXXXXXXXXXXXXXXXXXXXXXXXXXXXXXXXXXXXXXXXXXXXXXXXXXXXXXXXXXXXXXXXXXXXXXXXXXXXXXXXXXXXXXXXXXXXXXXX-XXXXXXXXXXXXXXXXXXXXXXXXXXXXXXXXXXXXXXXXXXXXXXXXXXXXXXXXXXXXXXXXXXXXXXXXXXXXXXXXXXXXXXXXXXXXXXXXXXXXXXXXXXXXXXXXXE--XXXXXXXXXXXXXXXXXXXXXXXXXXXXXXXXXXXXXXXXXXXXXXXXXXXXXXXXXXXXXXXXXXXXXXXXXXX
