--------------------------------------------------------------------------------------------------------------------------------------------------------------------------------------------------------------------------------------------------------------------------------------------------------------------------------------------------------------------------------------------------------------------------------------------------------------------------------------------------------------------------------------------------------------------------------------------------------------------------------------------------------------------------------------------------------------------------------------------------------------------------------------------------------------------------------------------------------------------------------------------------------------------------------------------------------------------------------------------------------------------------------------------------------------------------------------------------------------------------------------------------------------------------------------------------------------------------------------------------------------------------------------------------------------------------------------------------------------------------------------------------------------------------------------------------------
--------------------------------------------------------------------------------------------------------------------------------------------------------------------------------------------------------------------------------------------------------------------------------------------------------------------------------------------------------------------------------------------------------------------------------------------------------------------------------------------------------------------------------------------------------------------------------------------------------------------------------------------------------------------------------------------------------------------------------------------------------------------------------------------------------------------------------------------------------------------------------------------------------------------------------------------------------------------------------------------------------------------------------------------------------------------------------------------------------------------------------------------------------------------------------------------------------------------------------------------------------------------------------------------------------------------------------------------------------------------------------------------------------------------------------------------------------
-------------------------------------------------------------------------------------------------------------------------------------------------------------------------------------------------------------------------------------------------------------------------------------------------------------------------------------------------------------------------------------------------------------oo----------------------------------------------------------------------------------------------------------------------------------------------------------------------oo-----------------------------------------------------------------------------------------------------------------------------------------------------------------------o-----------------------------------------------------------------------------------o----------------------------------------------------------------------------------------------------------------------------------------------------------------------oo----------------------------------------------------------------------------------oo-------------------------------------------------------------------------------------------------------------------------------------------------------------------------------------------------------------------------S--------------------------------oo-----------------------------------------------------------------------------
-------------------------------------------------------------------------------------------------------------------------------------------------------------------------------------------------------------------------------------------------------------------------------------------------------------------------------------------------------------------------------------------------------------XXX--------------------------------------------------------------------------------------------------------------------------------------------------------------------XXXX-------------------------------------o--------------------------------------------------------------------------------------------------------------------------------X--------------------------------------o-------------------------------------------XXX---------------------------------------------------------------------------------XXX-------------------------------------o------------------------------------------XXXX--------------------------------------------------------------------------------XXXX---------------------------------------------------------------------------------------------------------------------------------------------------------------------------------------------------------------------------------------------------------XXX----------------------------------------------------------------------------
----------------------------------------------------------------------------------------------------------------------------------------------------------------------------------------------------------------------------------------------------------------------------------------------------------------------------------------------------------------------------------------------------------------------------------------------------------------------------------------------------------------------------------------------------------------------------------------------------------------------------------------------------------------------------------------------------------------------------------------------------------------------------------------------------E----------------------------------------------------------------------------------E----------------------------------------------------------------------------------------------------------------------------------------------------------------------------------------------------------------------------------------------------------------------------------------------------------------------------------------------------------------------------------------------------------------------------------------------------------------------------------------------------------------------------------------------------------------
---------------------------S------------------------SSSS-----------Q-QQQS-------------------------------------QQ-------------------------SSS---------Q----SSS--------------------------------------------------------------------------------------------SSS--------------SSS-------------------------------------QS------------------------SSSS-----------------------------------------------------SSS------------------------SSQS--------------------------------------------------------------------------------SSSS--------------SSS------------------------------------S-S------------------------SSSS--------------SSS--------------------------------------S------------------------SSSS--------------SSS------------------------------------SSS------------------------SSSS--------------SSS------------------------------------SQS------------------------SSSS--------------SSS------------------------------------SSS------------------------SSSS--------------SSS------------------------------------SSS------------------------SSSS--------------SSS--------------------------------------S------------------------SSSS--------------SSS----------------------------------------------------------------SSS-------------------------------------------------------S------------------------SSSS-----------------------------------------------------SSS----------------------S-SSSS-----QQ---------S---------------------------------------
-------------------------------------------------------------------------------------------------------------------------------------------------------------------------------------------------------------------------ooo-----------------------------------------------------------------------------------------------------------------------------------------------------------------------------------------------------------------------------------------------------------------------------------------------------------------------------------------------------------------------------------------------------------------------------------------------------------------------------------------------------------------------------------------------------------------------------------------------------------------------------------------------------------------------------------------------------------------------------------------------------------------------------------------------------------------------------------------------------------------------------------------------------------------------------------------------------------------------------------------------------------------------------------------------------------------------------------------------------------------------------------------------------------------------------------------------------------------------o----
-------------------------------------------------------------------------------------------------------------------------------------------------------------------------------------------------------------------------------------------------------------------------------------------------------------------------------------------------------------------------------------------------------S-----------------------------------------------------------------------------------------------------------------------------------------------------------------------S---------------------------------------------------------------------------------------------------------------------------------------------------------------------------------------------------------------------------------------------------------------------------------------------------------------------------------------------------------------------------------------------------------------------------------------------------------------------------------------------------------------------------------------------------------------------------------------------------------------E--------------------------------------------------------------------------------------------------------------------------------------------------------------------------------------------------------------------------------------------------------
------------------E--S------------------------E------------------------------E----------------------------------------------------E--S-----S---------------------E---------------------------E----------------------------S----S------------------E--S-----S----------------------------------------------E---------------------------E--S----------------------------------------------------E--S-----S------------------E-------------------------------------------------------E---------------------------E--S----------------------------------------------------E--S-----S------------------E--S----------------------------------------------------E--------S------------------E--------S----------------------------------------------E---------------------------E--S---------------------------E------------------------E---------------------------E-------------------------------------------------------E--------S------------------E-------------------------------------------------------E--------S------------------E-------------------------------------------------------E--------S------------------E--S----------------------------------------------------E---------------------------E--S-----S----------------------------------------------E--S------------------------E--S----------------------------------------------------E--o-----S------------------E--o---------------------------E------------------------E---------
-----------------<>-----E--------------------<>-----E--S-------Q--QQQQ------<>---QQQ-QQQ-------------<>------E?S-----------------<>-----E--S--Q---QQQ-Q----Q----<>----QQ---QQQQQ-Q----------<>----QQ----oo---------------------------E-----------<>-----E--S-Q--------Q----------E----QQ-----------------<>------E-------------------<>-----E--S-Q-QQ----------------------Q-----------------<>-----E--S-QQ----Q---------<>------E?S---QQQQ--Q----------<>---QQQ----oo-----------<>------E-------------------<>-----E--S----QQQQ--QQ---------E----QQ----o------------<>--------S-----------------<>-----E--S---QQQQQQQQ----------E-----Q-----------------<>------E-S-----------------<>-----E--S-Q-----Q--Q---------------QQ-----------------<>------E?S-----------------<>-----E--S-------Q--Q---------<>-----Q-----------------<>------E?S-----------------<>-----E--S-Q---Q-Q--Q---Q?S----E----QQ-----------------<>------E-S-----------------<>-----E--S-Q-Q---Q--QQ---Q----------QQ-----------------<>------E-S-----------------<>-----E--S---QQQQ--QQ----------E----QQ----o------------<>------E-------------------<>-----E--S-QQQQQ----Q----------------Q----o------------<>--------------------------<>-----E--SQ--QQQQ----Q--------------QQ----o------------<>------E?S-----------------<>-----E--S----------Q---------<>----QQ-QQ--------------<>------E?S-------Q---------<>------E?S---QQQQQQQ----------<>----QQ-----o-----------<>---------
-----------------[]----<>--------------------[]----<>-----------------------[]-----------------------[]--E-----------------------[]----<>-----------------------[]--------------------------[]-----------------------<>-------------<>-----------[]----<>-----------------------<>-----------------------[]--------------------------[]----<>------------------------------------------E-----[]----<>--------------------[]-----------------------------[]-----------------------[]--------------------------[]----<>-----------------------<>-----------------------[]-----E--------------------[]----<>-----------------------<>-----------------------[]--------------------------[]----<>------------------------E-----------------------[]--------------------------[]----<>-----------------------[]-----------------------[]--------------------------[]----<>-----------------------<>-----------------------[]-----E--------------------[]----<>------------------------------------------------[]--------------------------[]----<>-----------------------<>-----------------------[]--------------------------[]----<>------------------------------------------------[]--------------------------[]----<>------------------------------------------------[]--------------------------[]----<>-----------------------[]-----------------------[]--------------------------[]-----------------------------[]---------E-------------[]---------
-----------------[]----[]----<>--------------[]----[]-----------------------[]-----------------------[]-<>-----------------------[]----[]-----------------------[]--------------------------[]--------<>-------------[]-------------[]-----------[]----[]-----------------------[]-----------------------[]-<>-----------------------[]----[]-----------------------------------------<>-----[]----[]--------------------[]-----------------------------[]-----------------------[]--------------------------[]----[]-----------------------[]-----------------------[]--------------------------[]----[]-----------------------[]-----------------------[]--------------------------[]----[]-----------------------<>-----------------------[]--------------------------[]----[]-----------------------[]-------<>--------------[]--------------------------[]----[]-----------------------[]-----------------------[]--------------------------[]----[]------------------------------------------------[]--------------------------[]----[]-----------------------[]-----------------------[]--------------------------[]----[]-----------------------<>-----------------------[]--------------------------[]----[]------------------------------------------------[]--------------------------[]----[]-----------------------[]-----------------------[]--------------------------[]-----------------------------[]--------<>-------------[]---------
---------EE------[]----[]----[]------EEE--E--[]----[]--------------E--EE----[]--E-E------------EE-EE-[]-[]-----------E--EEE------[]----[]-----------------EE----[]-EE-E---------------EE----[]--E-E---[]-------------[]-------------[]--EEE------[]----[]-----------------EE----[]--E-E------EE-EE--E-EE-[]-[]--------------EEEE--E--[]----[]-----------------EE--------E-E---------E-[]-----[]----[]--------------E--E--[]-----------------------EE----[]--E-E------------------[]-----------------EEE-E-E--[]----[]-----------------EE----[]--E-E-------E-E--------[]------------------EEEE-E--[]----[]----E----------E-EE----[]-EE-E----------E-------[]-----------------EEEEE-E--[]----[]-----------------EE----[]--E-E----------E--E----[]------------------EEE-----[]----[]----E-E----------EE----[]-EE-E--[]------E-E-----[]------------------E-EE-E--[]----[]-----------------EE----[]--E-E------------------[]-----------------EEEE--E--[]----[]-----------------EE--------E-E-----------E------[]-----------------EE-EE-E--[]----[]-----------------EE----[]--E-E------------------[]------------------EEE--E--[]----[]-----------------EE----[]--E-E----------------E-[]-----------------EEE------[]----[]-----------------EE--------E-E----------E-------[]------------------EEE--E--[]----[]-----------------EE----[]--E-E---------EE-EE----[]------------------E-EE-E--[]-----------------------EE----[]--E-E---[]-------------[]---------
XXXXXXXXXXXXXXXXXXXXXXXXXXXXXXX--XXXXXXXXXXXXXXXXXXXXXXXXXXX-XXXXXXXXXXXXXXXXXXXXXXXXXX----XXXXXXXXXXXXXXXXXXXXXXXXXXXXXXXXXXXXXXXXXXXXXXXXXXXXXXXXXXXXXXXXXXXXXXXXXXXXXXXXXXXXX-XXXXXXXXXXXXXXXXXXXXXXXXXXXXXXXXXXXXXXXXXXXXXXXXXXXXXXXXXXXXXXXXXXXXXXXXXXXXXXXXXXXXXXXXXXXXXXXXXXXXXXXXXXXXXXXXXXXXXXXXXXXXXX-XX-XXXXXXXXXXXXXXXXXXXXXXXXXXXXXXXXXXXXXXXXXXXXXXXXXXXXXXXXXXXXXXXXXXXXXXXXXXXXXXXXXXXXXXXXX-XXXXXXXXXXXXXXXXXXXXXXXXXXXXXXXXXXXXXXXXXXXXXXXXXXXXXXXXXXXXXXXXXXXXXXXXXXXXXXXXXXXXXXXXXXXXXXXXXXXXXXXXXXXXXXXXXXXXXXXXXXXXXXXXXXXXXXXXXXXXXXXXXXXXXXXXXXXXXXXXXXXXXX--XXXXXXXXXXXXXXXXXXXXXXXXXXXXXXXXXXXXXXXXXXXXXXXXXXXXXXXXXXXXXXXXXXXXXXXXXXXXXXXXXXXXXXXXXXXXXXXXXXXXXXXXXXXXXXXXXXXXXXXXXXXXXXXXXXXXXXXXXXXXXXXXXXXXXXXXXXXXXXXXXXXXXX--XXXXXXXXXXXXXXXXXXXXXXXXXXXXXXXXXXXXXXXXXXXXXXXXXXX-XXXXXXXXXXXXXXXXXXXXXXXXXXXXXXX-XXXXXXXXXXXXXXXXXXXXXXXXXXXXXXXXXXXXXXXXXXXXXXXXXXXXXXXXXXXXXXXXXXXXXXXXXXXXXXXXXXXXXXXXXXXXXXXXXXXXXXXXXXXXXXXXXXXXXXXXXXXXXXXXXXXXXXXXXXXXXXXXXXXXXXXXXXXXXXXXXXXXXXXXXXXXXXXXXXXXXXXXXXXXXXXXXXXXXXXXXXXXXXXXXXXXXXXXXXXXXXXXXXXXXXXXXXXXXXXXXXXXXXXXXX--XXXXXXXXXXXXXXXXXXXXXXXXXXXXXXXXXXXXXXXXXXXXXXXXXXXXXXXXXXXXXXXXXXXXXXXXXXXXX-XXXXXXXXXXXXXXXXXXXXXXXXXXXXXXXXXXXXXXXXXXXXXXXXXXXXXXXXXXXXXXXXXXXXXXXXXXXXXXXXXXXXXXXXXXXXXXXXXXXXXXXXXXXXXXXXXXXXXXXXXXXXXXXXXXXXXXXXXXXXXXXXXXXXXXXXXXXXXXXXXXXXXXX-XXXXX-XXXXXXXXXXXXXXXXXXXXXXXXXXXXXXX-XXXXXXXXXXXXXXXXXXXXXXXXXXXXXXXXXXXXXXXXXXXXXXX
