--------------------------------------------------------------------------------------------------------------------------------------------------------------------------------------------------------------------------------------------------------------------------------------------------------------------------------------------------------------------------------------------------------------------------------------------------------------------------------------------------------------------------------------------------------------------------------------------------------------------------------------------------------------------------------------------------------------------------------------------------------------------------------------------------------------------------------------------------------------------------------------------------------------------------------------------------------------------------------------------------------------------------------------------------------------------------------------------------------------------------------------------------------------------------------------------------------------------------------------------------------------------------------------------------------------------------------------------------------------------------------------------------------------------------------------------------------
--------------------------------------------------------------------------------------------------------------------------------------------------------------------------------------------------------------------------------------------------------------------------------------------------------------------------------------------------------------------------------------------------------------------------------------------------------------------------------------------------------------------------------------------------------------------------------------------------------------------------------------------------------------------------------------------------------------------------------------------------------------------------------------------------------------------------------------------------------------------------------------------------------------------------------------------------------------------------------------------------------------------------------------------------------------------------------------------------------------------------------------------------------------------------------------------------------------------------------------------------------------------------------------------------------------------------------------------------------------------------------------------------------------------------------------------------------
--------------------------------------------------------------------------------------------------------------------------------------------------------------------------------------------------------------------------------------------------------------------------------------------------------------------------------------------------------------------------------ooo----------------------------------------------------------------------------------------------------------------------------------------------------------------------------------------------------------------------------------------------------------------------------------------------------------------------------------------------------------------------------------------------------------------------------------oo----------------------------------------------------------------------------------oo---------------------------------------------------------------------------------------------------------------------------------------------------------------------------------------------------------------------------------------------------------------------------------------------------------------------------------------------------------------------------------------------------------------------------------------------------------------------------------------------------------------------------------------------
-------------------------------------------------------------------------o-----------------------------------------------------------------------------------------------------------------------------------------------------------------------------------------------------------------------------------------------------------o------------------------------------------XXXX-------------------------------------------------------------------------------------------------------------------------------------------------------------------------------------------------------------------------------------------------------------------------------------------------------------------------------------------------------------------------------------o------------------------------------------XXXX--------------------------------------------------------------------------------XXXX-------------------------------------------------------------------------------------------------------------------------------------------------------------------------------------------------------------------------------------------------------------------------------------------------------------------------------------------------------------------------------------------------------------------------------------------------------------------------o------------------------------------------------------------------
-----------------------------------------------------------------------------------------------------------------------------------------------------------------------------------------------------------------------------------------------------------------------------------------------------------------------------------------------------------------------------------------------------------------------------------------------------------------------------------------------------------------------------------------------------------------------------------------------------------------------------------------------------------------------------------------------------------------------------------------------------------------------------------------------------------------------------------------------------------------------------------------------------------------------------------------------------------------------------------------------------------------------------------------------------------------------------------------------------------------------------------------------------------------------------------------------------------------------------------------------------------------------------------------------------------------------------------------------------------------------------------E--------------------------------------------------------------------
-------------------------SSS------------------------SSSS--------------SSS---------------------------------------------------------------SSSS--------------SSS--------------------------------------S------------------------SSSS--------------SSS------------------------------------SSS-------------------------SQS--------------SSS--------------------------------------S-----------------------SSSSS-------------------------------------------------------S-------------------------SSS--------------------------------------------------------------------------------SSSS-------------------------------------------------------S-------------------------SQS--------------------------------------------------------------------------------SSSS--------------SSS------------------------------------SSS------------------------SSSS--------------SSS------------------------------------SSS------------------------SSSS--------------SSS--------------------------------------S-------------------------SSS--------------SSS------------------------------------S-S------------------------SSQS--------------S-----------------------------------------------------------------SSSS--------------S--------------------------------------S-S------------------------SSSS--------------SSS--------------------------------------S------------------------SSSS--------------SQS------------------------------------SSS------------------------SSSS
---------------------o-----------------------------------------------------------------------------------------------------------------------------------------------------------------------------------------------------------------------------------------------------------------------------------------------------------------------------------------------o-o--------------------------------------------------------------------------------------------------------------------------------------------------------------------------------------------------------------------------------------------------------------------------------------------------------------------------------------------------------------------------------------------------------------------------------------------------------------------------------------------------------------------------------------------------------------------------------------------------------------------------------------------------------------------------------------------------------------------------------------------------------------------------------------------------------------------------------------------------------------------------------------------------------------------------------------------------------------------------------------------------------------------------------------------------------------------------------
---------------------------------------------------------------------------------------------------------------------------------------------------------------------------------------------------------------------------------------------------------------------------------------------------------------------------------------------------------------------------S-----------------------------------------------------------------------------------S----------------------------------------------------------------------------------------------------------------------------------------------------------------------------------------------------------------------------------------------------------------------------------------------------------------------------------------------------------------------------------------------------------------------------------------------------------------------------------------------------------------------------------------------------------------------------------------------------------------------------------------------------------------------------------------------------------------------------------------------------------------------------------------------------------------------------------------------------------------------------------------------------------------------------------------------------------------------------------------
------------------E--S-----?------------------E-------------------------------------------------------E---------------------------E-------------------------------------------------------E---------------------------E--S----------------------------------------------------E--S-----S------------------E--E---------------------------E------------------------E--S-----S------------------E-------------------------------------------------------E--S-----S------------------E--------S----------------------------------------------E---------------------------E--S----------------------------------------------------E--S-----S------------------E-------------------------------------------------------E--S------------------------E--S----------------------------------------------------E--S-----S------------------E--S---------------------------E------------------------E---------------------------E------------------------------E------------------------E---------------------------E--------S----------------------------------------------E--S-----S------------------E--o----------------------------------------------------E--------S------------------E-------------------------------------------------------E--S-----S------------------E-------------------------------------------------------E--------S------------------E--S----------------------------------------------------E--o-----S------------------E--S------
-----------------<>-----E--------------------<>------S?S--QQQQQQ-QQQ---------------Q----o------------<>--------------------------<>-----E--S-Q-Q------Q----------------Q-----------------<>--------------------------<>-----E--S-Q--------Q----------------------------------<>-----E--S-------Q---------<>-<>---S?S---QQ---QQQ---------<>----QQ----oo-----------<>--------------------------<>-----E--S---QQ---QQQ----------E----QQ----oo-----------<>--------------------------<>-----E--S---QQ---QQQ----------E----QQ----oo-----------<>--------------------------<>-----E--S---QQ----------------------Q-----------------<>------E-------------------<>-----E??S---QQ---SQ-----------E----QQ-----------------<>--------------------------<>-----E--S-Q-----Q--QQ---------E----QQ-----------------<>-----E--------------------<>-----E--S---Q--QQ--Q---------<>---QQQ-----------------<>-----E--S-QQ--------------<>-----E--S-QQQQ---QQQ---------<>----QQ---ooo-----------<>--------------------------<>-----E--S---QQQ---------?-----------Q----o------------<>------E-S-----------------<>------E?S-QQQ----Q------?-----------o---ooo-----------<>--------S-QQ--------------<>-----E--SQQ---Q---------------------Q----o------------<>-----E--------------------<>-----E--S-Q-QQ---QQQ----?S----------Q---oo------------<>------E-S-----------------<>-----E--S-QQ-QQQQ--Q-Q-QQS----------Q-QQ--------------<>------E?S-----------------<>-----E--S
-----------E-----[]----<>-----E--------------[]-----------------------------<>-----------------------[]--------------------------[]----<>-----------------------<>-----------------------[]--------------------------[]----<>------------------------------------------------[]----<>--------------------[]-[]--------------------------[]-----------------------[]-----E--------------------[]----<>-----------------------<>-----------------E-----[]-----E--------------------[]----<>-----------------------<>-----------------------[]--------------------------[]----<>------------------------------------------------[]--------------------------[]----<>-----------------------<>---------E-------E-----[]--------------------------[]----<>-----------------------<>-----------------------[]----<>--------------------[]----<>-----------------------[]-----------------------[]----<>--------------------[]----<>-----------------------[]-----------------------[]--------------------------[]----<>------------------------------------------------[]-----E--------------------[]-----E------------------------------------------------[]--------------------------[]----<>------------------------------------------------[]----<>--------------------[]----<>------------------------------------------------[]--------------------------[]----<>------------------------------------------------[]--------------------------[]----<>---
-----------------[]----[]----<>--------------[]-----------------------------[]-----------------------[]--------------------------[]----[]-----------------------[]-----------------------[]--------------------------[]----[]------------------------------------------------[]----[]--------------------[]-[]--------------------------[]-----------------------[]--------------------------[]----[]-----------------------[]----------------<>-----[]--------------------------[]----[]-----------------------[]-----------------------[]--------------------------[]----[]------------------------------------------------[]--------------------------[]----[]-----------------------[]--------<>------<>-----[]--------------------------[]----[]-----------------------[]-----------------------[]----[]--------------------[]----[]-----------------------[]-----------------------[]----[]--------------------[]----[]-----------------------[]-----------------------[]--------------------------[]----[]------------------------------------------------[]--------------------------[]-----------------------------<>-----------------------[]--------------------------[]----[]------------------------------------------------[]----[]--------------------[]----[]------------------------------------------------[]--------------------------[]----[]------------------------------------------------[]--------------------------[]----[]---
--------E-E------[]----[]----[]------E-E-----[]---------EE------------EE----[]-EE-E---------E--------[]-----------------EEEE--E--[]----[]-----------------EE----[]--E-E------EE-E---E-EE-[]-----------------EEEE-----[]----[]-----------------EE--------E-E---------EEEE-----[]----[]--------------EE-E--[]-[]-------E------------EE----[]-EE-E------------------[]-----------------EEEEE-E--[]----[]-----------------EE----[]--E-E-----------[]-----[]-----------------EEEEE-E--[]----[]-----------------EE----[]--E-E------------------[]------------------EEE-----[]----[]-----------------EE--------E-E---------E--------[]------------------EEE-----[]----[]-----------------EE----[]--E-E---[]------[]-----[]-----------------EEE-E-E--[]----[]----E------------EE----[]--E-E-------------E-E--[]----[]-----------EE-EE-E--[]----[]-----------------EE----[]--E-E------------------[]----XX------------EEEE-E--[]----[]-----------------EE----[]--E-E------------------[]-----------------EEEEE-E--[]----[]-----------------EE-------EE-E----------E-------[]-----------------EE--E-E--[]-----------------------EE----[]-EE-E------------------[]------------------EEEE-E--[]----[]-----------------EE--------E-E---------E--------[]----[]-----------EEEE--E--[]----[]-----------------EE--------E-E------------------[]-----------------EEE-E-E--[]----[]---EE----------E-EE-------EE-E----------E-E-----[]-----------------EE-E--E--[]----[]---
XXXXXXXXXXXXXXXXXXXXXXXXXXXX-XXXXXXXXXXXXXXXXXXXXXXXXXXXXXXXXXXXXXXXXXXXXXXXXXXXXXXXXXXXXXXXXXXXXXXXXXXXXXXXXXXXXXXXXXXXXXXXXXXXXXXXXXXXXXXXXXXXXXXXXXXXXXXXXXXXXXXXXXXXXXXXXXXXXXXXXXXXXXXXXXX-XX-XXXXXXXXXXXXXXXXXXXXXXXXXXXXXXXXX-XXXXXXXXXXXXXXXXXXXXXXXXXXXXXXXXXXXXXXXXXXXXXXXXXXXXXXXXXXXXXXXXXXXXXXXXXXXXXXXXXXXXXXXXXXXXXXXXXXXXXXXXXXXXXXXXXXXXXXXXXXXXXXXXXXXXXXXXXXXXXXXXXXXXXXXXXXXXXXXXXXXXXXXXXXX-XXXXXXXXXXXXXXXXXXXXXXXXXXXXXXXXXXXXXXXXXXXXXXXXXXXXXXXXXXXXXXXXXXXXXXXXXXXXXXXXXX--XXXXXXXXXXXXXXXXXXXXXXXXXXXXXXXXXXXXXXXXXXXXXXXXXXXXXXXXXXXXXXXXXXXXXXXXXXXXXXXXXXXXXXXXXXXXXXXXXXXXXXXXXXXXXXXXXXXXXXXXXXXXXXXXXXXXXXXXXXXXXXXXXXXXXXXXXXXXXXXXXXXXXX--XXXXXXXXXXXXXXXXXXXXXXXXXXXXXXXXXXXXXXXXXXXXXXXXXXXXXXXXXXXXXXXXXXXXXXXXXXXXXXXXXXXXXXXXXXXXXXXXXXXXXXXXXXXXXXXXXXXXXXXXXXXXXXXXXXXXXXXXXXXXXXXXXXXXXXXXXXXXXXXXXXXXXXXXXXXXXXXXXXXXXXXXXXXXXXXXXXXXXXXXXXXXXXXXXXXXXXXXXX--XXXXXXXXXXXXXXXXXXXXXXXXXXXXXXXXXXXXXXXXXXXXXXXXXXXXXXXXXXXXXXXXXXXXXXXXXXXXXXXXXX-XXXXXXXXXXXXXXXXXXXXXXXXXXXXXXXXXXXXXXXXXXXXXXXXXXXXXXXXXXXXXXXXXXXXXXXXXXXXXXXXXXX--XXXXXXXXXXXXXXXXXXXXXXXXXXXXXXXXXXXXXXXXXXXXXXXXXXXXXXXXXXXXXXXXXXXXXXXXXXXXXXXXXX-XXXXXXXXXXXXXXXXXXXXXXXXXXXXXXXXXXXXXXXXXXXXXXXXXXXXXXXXXXXXXXXXXXXXXXXXXXXXXXXXXXXXXXXXXXXXXXXXXXXXXXXXXXXXXXXXXXXXXXXXXXXXXXXXXXXXXXXXXXXXXXXXXXXXXXXXXXXXXXXXXXXXXXXXXXXXXXXXXXXXXXXXXXXXXXXXXXXXXXXXXXXXXXXXXXXXXXXXXXXXXXX--XXXXXXXXXXXXXXXXXXXXXXXXXXXXXXXXXXXXXXXXXXXXXXXXXXX
