--------------------------------------------------------------------------------------------------------------------------------------------------------------------------------------------------------------------------------------------------------------------------------------------------------------------------------------------------------------------------------------------------------------------------------------------------------------------------------------------------------------------------------------------------------------------------------------------------------------------------------------------------------------------------------------------------------------------------------------------------------------------------------------------------------------------------------------------------------------------------------------------------------------------------------------------------------------------------------------------------------------------------------------------------------------------------------------------------------------------------------------------------------------------------------------------------------------------------------------------------------------------------------------------------------------------------------------------------------------------------------------------------------------------------------------------------------
--------------------------------------------------------------------------------------------------------------------------------------------------------------------------------------------------------------------------------------------------------------------------------------------------------------------------------------------------------------------------------------------------------------------------------------------------------------------------------------------------------------------------------------------------------------------------------------------------------------------------------------------------------------------------------------------------------------------------------------------------------------------------------------------------------------------------------------------------------------------------------------------------------------------------------------------------------------------------------------------------------------------------------------------------------------------------------------------------------------------------------------------------------------------------------------------------------------------------------------------------------------------------------------------------------------------------------------------------------------------------------------------------------------------------------------------------------
---------------------------------------------------------------------------------------------------------------------------------------------------------------------------------------------------------------------------------------------------------------------------------------------------------------------SSSSSSSSSSSSSS-SSSSSSSSSSSS---------------------------------------------------ooo----------------------------------------------------------------------------------------------------------------------------------------------------------------------------------------------------------------------------------------------------------------------------------------------oo----------------o-------------------------------------------------------------------------------------------------------------------------oo---------------------------------------------------------------------------------------------------------------------------------------------------------------------------------------------------------------------------------------------------------------------------------------------------------------------------------------------------------------------------------------------------------------------------------------------------------------o-------------------------------------------------------oo-----------------------------------------------------------------------------
---------------------------------XX------------------------------------------------------------------------------------------------------------------------------------------------------------------------------------------------------------------------------------------------------------------------------------SSSSSSSSSSSS---------------------------------------------------------------------------------------------------------------------------------------------------------------------------------------------------------------------------------------------------------------------------------------------------------------------------------------------------------------XXXXXX----------------------------------------------------------------------------------------------------------------------------------------XXXX----------------------------------------------------------------------------------------------------------------------------------------------------o-------------------------------------------------------------------------------------------------------------------------------------------------------------------------------------------------------------------------------------------------------------------------------------------------------XXXX---------------Q------------------------------------XXXX--------------------------XX------------------------------------------------
------------------------------------------------------------------------------------oo--------------------------o---------------------------oo--------oo--oo-------------------------------------------------------------------------------------------------------------------oo--oo----------------------------------SSSSSSSSSSSS?--------------------------------------------------------Eoo-------oo----------------------------------------------------------------------------------------------------------------------o---oo--------------------------------------------------------------------------------------------------------------------X---o-----------------------------------------------------------------------------------------------------------------------oo------------oo----------------------------------------------------------o-----------------------------------------------------------------------------------------------------------------------------------------------------oo-----------------------------------------------------------------------------------------------------------------------------------------------------------------------------------------------------------------------------------------------------------------------------------------------------Eooo--------------------------oo---------------------------------------------------------------------------------------------
------------E----------------------------o----------------------------------------------------XXXX----SSS---?----------XXXX---------XXoo----X-----------------SSS---XXX-o-------------------------------------------S-------------------------------------------------------------------------------------------------SSSSSSSSSSSSSSSSSS---------------------------Q------------X----------XXXXX----XXXX--------------SQ---SQQQQ--------o---------------------------------------------------------------------------------------------------------------------------------------o--------?-------------------------------o---------------------------X-XX--XXX------------------------------------------XXXooo--XXo----QS----------------------------------------------------------------------XX-----SSSS------S--------------------------------------X-----XXXX----------------------------S----------------------------------------------------Q---------S------------------SS------------E--------------------------oo---XXXXo----SSS-----------------------------------------------------------QQQQ----SSSS-----------QQQ-------------------------------------------?--E------------------Q-Q-------------QQ----------------------------------------------------------------------------------------------------------XXXX----oo---SS---------------XXX--------Q---------------------------------------------------S------Q-Q----------------------
-----------XXXXX--------E----------------------------------------------------------------------------------------------------------------------------E-------------------------------------------------------------------------------------------------------------------------------------------------o---E--------------------------------------E---o---------------------------------------------------------------------------------------------------------------------------------o---------------------------------------------------------X----------------o-------------------------------------------------------oo----E--E------------------XX-------------------------------------------o------------------------------------o----------------------------------------------E----E--------------------------------------------------E----E--------------E---------------------------------------------------o---o----------------------------------------------oo------------------XX-X--o---o---------------------------------------------------------------------------------------------------------------------------------------------E----------------------------------------------------------------------------------------------------------------------------------------------------------------------------------------------------o---E-----------------------o---o-----XX----------------------------------------------------
------------------XXXXXXXX-------------------------------------------------------------XXXXXXX--------------------------------------------------XXXXXXX---------------------E-------------------------------------------------------------------------------------------------------------------------XXX-XXX-XX-----------------E--------------XXXXXXXX-------------------------------------------------XXXXX------------------------------------------------------------------XXXXXXXXXX------------------------------------------------XXXXX---oo--------------XXX-----------------------------------------------------------XXXXXXXX---------------<>-------X-------------------------------XXXXXX----------------------------------XXX-------------------------------?-XX-XX------XXXXXXXX-----------------------------------------------XXXXXXXXX---------XXXXXXXX------------------o-----o--------XXX---------XXXXX-XXX-X--------------------------------------------------------------------XXX-XXX---------------------------------------------------------------------------------------------------------------------------------------XXXXXXXXXX------------------------------------------------------------------------------------------XXXXXXXXX-X---XXX------------------------------------------------------------------------------------XXXXXXXXX------------------?XXX-XXX---XX-------o---------------------------------------------
---S--------------------------------------------------------------o-------------E--o---------------------------------------------------------------------------------------<>---------------------------------------------------------------------------------E--------------------------ooo---------------------------------?-----------------------------------------------------------------------------------------------------------------------------------------------------------------------------------------X---oo---------------------------------------------------------------------------------oo--------------------------ooo----------[]-----------------------------------E-------------------------------------------------------------------------------------------------------------E---------------------------------------------------------------------------------------------------------------------------E-----------------------oo---------------------------------------------------X-----------------------------------------------------------------------------------------------------------------oo----------------------------S-------------------------------------------------------------------------------X-----------------------------------------------------------------------------------------------------------------------------------------------------XXX--------------------------------------------
o-----E---------------------------------------------E--------------------S-----<>---XXX-----------XXXX---XXXXX-----------XXXXX---XXXX--EXXXXXXXXX-----ooo------------------[]--------------------------------------S------E----------------------------------<>------S---------------------------S----------------------SSSSS??SSSSSSSS---------Q------------Q---QQQ---S-----------------XXX------------QS-----------Q------SSSQS----XXXXXXXXX------------------o------------Q--Q-----------o---------------Q---------XX-----------E----------E--------X---------------------------X---SSS----------E-----E-----------ooo---XX-------------------XXXX--XXXXXXX------o-------------------E--<>---X------------XXX---XXXX--XX----------------------------Xo------oo----Q--S---------XXXXX--------oo-------XXXXXX--o------------------------------------oooo----X---X-------------------Q--SS---S----XX---------o------S----------------<>----QQQ-------Q---------------XXXo--XXXX-----------------------------------XXXX-------X---XXXX---XXXXXXX-o--------S----E-----E-----E-QQ-----------------------QQ?---------------o---------------o---------------------------------S---------------------Q-Q------------QQ------------------------------E---XXo-------------------------------------------------EE------E-------XXX-------XX-----X-----------------------------------ooo---Q--S----S-S------------------------XXXXXXXX---Q--QQ-----<>-------------
-----<>---------------------------------------E----<>-------XX-----------------[]---------------------------------------------------XXXXXXXX------------E------------------[]-------------------------------E------------<>----------------------------------[]-------------------------E--X------XX-?--------------------SSS--SSSSSSS------SS---------------------------------o--------------------------------------------------------------------------------------E-------------------X-S------------------------XXX----------XXXXXo--XXXXXXXX---XXX--------------------X------X---------------<>----<>---------------------------------------------------------------EE-----------<>--[]-----Eo-------------------------------XXX-----------------X--------XXX--------------XXX-------------------------------------------------------X------------E-------------------X---------------------XX-------------------------E-------[]-------------------------------------------------------XXXXXXXX-----------XXX--------------------------------E--------<>----<>----<>------------------------------------------------------------------XXX-?----------------E---E--------------------------------------------------------XXXXXX?-------<>--XXX-----------------------------------------XXX--XXXXXXXX---<>--------------E--------------o--------------------------------E-----------------------------------------------------------[]-------------
-----[]--------------------------------------<>----[]-----XXXX-----------------[]-------XXXX-----X----o-------XX---o-----------------------------XXXXXXXXXX---------X-XX---[]----<>-----------E------------<>------------[]----------------------------------[]----------------------------------------------------------SSSS-?SSSSSS---S---SS--------------------------------XXXXX------------------------------X-----SS-----------------------------XXXX---------------------------------XS-----------------------XXXX----------------------------XXoX------------------XXX------X---------------[]----[]------XX---XXXX-----XXXXXXXXX---------------------XXXX------->--------------[]--[]-----XXXXXX---------------XXXX----------------------------X------XXX?X-----------E-X-XX----XXXX---XXXX---o------------------------------------X---XXXXXXXXXXX---------XXXXX----X-----------------E---XX-----XXXXXX----------------X-----[]-------------------------------XXXX--------------------------------------XXXX-----X------------------XXXX---<>--------[]----[]----[]------------------------------------------XXQX---------------------------------------S----<>----------------------------------------------------------------------[]-XXXX-----XXXXXX----------------------------------------------[]--------------------------------------------XX---XXXX---XXXXXXX-----------------------------------------------------------[]-------------
-----[]-E------------------------------E-EE--[]----[]----XXXXX--------E--E-----[]-----XX-------------XXX----------XXXXXX----------------------XXX--------------------------[]----[]-----E------------EE----[]------------[]----------------------------------[]----------------------------------------------E------EE-----SSooSSSSSSooSS--E--------------------EE-E---------------------------------------------X-----------------------------------------------------------E--E----EE---XXS---------------E-E----XXXXX-----------------------------XXX----------E-EE---XXXX------X---------------[]----[]-------------------------------XXXXXX----------------------X[]-----------E--[]--[]-------------------------------------------------------E--X-----------------------X-XXX--X--------------XXX---------------------------------X-X--------------------------------X------E-E------------XX---------------------------------[]---------E-E--E-----XXXXXXXX--------------------------------------------XXXXXXXXXXX-------------------------[]--------[]----[]----[]---------------E-EE-----------------------------------------------------------------XS-E--[]-E--------------------------------------------------------------------[]-XXXX---------------------------------------------------------XX------------------------------------E---------------------------------E---------------------------------------------------[]-------------
XXXXXXXXXX--XXXXXXXX--------XXX-------XXXXXXXXXXXXXXXXXXXXXXXX-XXXXXXXXXXXXXXXXXXXX-------------------------------------------------------------------------------------XXXXXXXXXXXXXXXXXX-XXXXX--XXXXXXXXXXXXXXXX---XXXXXXXXXX-XXXXXXXXXXX--XXXXXXXXX----XX-XXXXXXXXXX---XXX----XX---XXXXXXXXXX-----XXXXXXXXXXX-X--XXXXXXXXXXXXXXXXXXXXXXXXXXXX-----XXX----XXXXXXXXXX-X--------------------------------XXXXXXXXX----XXXXXXXXXXXXX------------------------------XXXXXXXXXXXXXXXXXXXXXXXX-XXXXXXXXXXX----XXXXXXXXXXXXXXX-XXX---XX--------------------XXXXXXX---XXXXXXXXXXXXXXX---XXXXXXXXXXXXXXXXXXXXXXXXXXXXXXX-------------------------XX--------------------------XXXXXXXXXX---XXXXXXXXXXXXX-X----------------------------XXXXXXX---XXXX------XXXXXXXXXXXXXXX-----XXXXXXXXXXXXXXXX----------------------------XXXXXXXXXX---XXXXXX--XXXXXX-X---------------------------XXXXX-XXXXXXXXXXXXXXXXXXXXXXXXX---------XXX-----XX------XXXXXXXXXXXXXXXXXXXXXXXXXXXXXX--------------------------XXXXXXE-----------XXXXXXXXXX----------------------------XXXXXXXXXXXXXXXXXXXXXXXXXXXXXXX----XXXXXXXXXXXXXXXX--XXX-XXXXXXXXXX----------XXXXXXXX-XXXXXX----XXXXXX----XXXXXXXXXXXXXXXXX--XXXXXXX----XXXXXXXXXXXXX---------X--XXXXXXXX-XXXXX---------XXXXXXXXXXX--XX-----------------------XXXX---XXXXXXX----XXXX-----XX-XXX----EXS----XXXXXXXX---XXXXXXXXXXXX-XXXXX-------------XXX--------XXXXXXXXXXXX---XXXXX------------XXXXXXX----XXXXXXXXXXXXXXXXXXXXXXXXXXXXXX
