--------------------------------------------------------------------------------------------------------------------------------------------------------------------------------------------------------------------------------------------------------------------------------------------------------------------------------------------------------------------------------------------------------------------------------------------------------------------------------------------------------------------------------------------------------------------------------------------------------------------------------------------------------------------------------------------------------------------------------------------------------------------------------------------------------------------------------------------------------------------------------------------------------------------------------------------------------------------------------------------------------------------------------------------------------------------------------------------------------------------------------------------------------------------------------------------------------------------------------------------------------------------------------------------------------------------------------------------------------------------------------------------------------------------------------------------------------
--------------------------------------------------------------------------------------------------------------------------------------------------------------------------------------------------------------------------------------------------------------------------------------------------------------------------------------------------------------------------------------------------------------------------------------------------------------------------------------------------------------------------------------------------------------------------------------------------------------------------------------------------------------------------------------------------------------------------------------------------------------------------------------------------------------------------------------------------------------------------------------------------------------------------------------------------------------------------------------------------------------------------------------------------------------------------------------------------------------------------------------------------------------------------------------------------------------------------------------------------------------------------------------------------------------------------------------------------------------------------------------------------------------------------------------------------------
-----o-----------------------------------------------------------------------------------o---------------------------------------------------------------------------------------------------------------------------------------------------------------------------------------------------------------------------------------------------------------------------------------------------------------------------------------------------------------------------------------------------------------------------------------------------------------------------------------------------------------------------------------------------------------------------------------------------------------------------------------------------------------------------------------------------------------------------------------------------------------------------------------------------------------------------------------------------------------------------------------------------oo---------------------------------------------------------------------------------------------------------------------------------------------------------------------------------------------------------------------------------------------------------------------------------------------------------------------------------------------------------------------------------------------------------------------------------------------------------
----XXXX-------------------E-----------------------------X----------------------E-------XXX----------------Q-----------------------------------------------------------------------------------------------------------------------------------------------------------------------------------------------------------------------------------------------------------------------------------------------------------------------------------------------------------------------------------------------------------------------------------------------------------------------------------------------------------------------------------------------------------------------------------------------------------Q--------------------------------------------------------------------------------------------------------------------------------------------------------------o--------------------------------------------------------------------------XX-------------------------XXXX--------------------------------------------------------------------------------------------------------------------------------------------------------------------------------------------------------------------------------------------------------------------------------------------------------------------------------------------------------o-----------------------------------------------------------------------------------------------
---------------------------------------------------------------------------------XXX--------------------------------------------------------XXX---------------------------------------------------------------------------------------------------------------------------------------------------o-----------------------------------------------------------------------------------------------------------------------------------------------------------------------------------------------------------------------o----------------------------------------Eo-------------------------------------------------------oo------------------------------------------------oo--oo-------------------------------------------------------------------------------------------------------------------------------------------------------------------------E-oo------------------------------------------------------------------------------------------------------------------------------------------------------------------E-------------------------------------------------------------------------------------------------------------------------------------------------------------------------E-------------------------------------------------------?-------------------------------------------------------E----------oo-------------o----------------------------------------ooo-------oo--oo----------------------------------------
-----------------SSSS---SSS--------------------------------------------------------------E--E-------------------QQQQ----------SQQ--SQSQS-----------------------------------------------------------------SSS---------------------------------------------------Q-Q-------------Q---------------------------------------------------------------------------------------------------------------------------------------E------------------------------SSSS--?--------E--E------------------------SQQ------------SSSS-----XXX---------------------------------------XXXX------SS-------------oo---X---------------------------XXXS----------------------------------------------------------XXX--------------------------SS--------oo-------E--E----oo-----------------------------------------------------QQQ------------------------------------------------E----------------oo---------XX----oo--------------------------------------------------------------------?---------X--------o---------------------------------?-------SQS--SQQQ-----S--------------------------------------------------SSSSS-------------------------------------------------------------------------------------------------o---SSSS---?---SSS-----------E-----------------oo----XXX----SSoS---?------------------------------------------------XXS--------------------------SSSS------Q--Q-QQQQQQQ----------------X----------------SSSS-----------------------------------
---------------------------------------------------------------------------E--o------------Q--XXX--o---E-----XXX-----------------------------------------------------------------------------------------------------------------------------ooo-----------------------------------------------------------------------------------------------------------------------------------------------------------------------XXo--------------E------------------------------E--X----------------------------------------S----------o---o-----------------------------E-----------------------------ooo-------------------------------------------------------------------X-----------------------------------------------------------------------XXXX-------------------------------------------------------------------------------------------------------------------------------------------X------------------------------------------------------E--------------------XXXX----------------------------------E--o--------------------------------------------------------------------------------------------------------------------------------------------------------------------------------------------------------------------<>----------------XXX--------------------------------------------E------------------------------------------E---o----------------------------------XXX---------E----E----------------------------------------------
--XXXXXX----------------------------------------------------------------XXXXXXXX---o-----XXX------XXXXXXXXX----------------------------------------------------------------XX---------------------------------------------------------------------------o--------------------------------------------------------------------------------------------------------------------------------------------------E--------------------------XXXXXXXX----------------------------------XXXXXXXXX----------------------XX--S---------XXX-XXX---------------------------<>-----------------------------------------XX-----------------------------------------------------------XXXXXXX---XX---------------------------------------------------------------------------------------------------XX-XXX--o--------------------------------------------------------------------------------------------------------------------------------------XXXXXX----XXXXXXXXXXX------------------------X------------------------XXXXXXX-X-----o-------------------------------------------------------------------------------------------------------------------------XXX-------------------------------------------------------------------------------[]-----------------------------------------------------------XXXXXXXX--------------------------XX-X--XXXXXXXXX-XXX-XXX----------------------------------------XXXXXXXX-X-------------------------------------------
---------------------------------------------------oo---------------------------------------------------------------------------------------------------------------------XX----------------------------------------------------S---------------------------------------------------------ooo-------------------------------------------------E-------------------------------------------------------------o--------------------------------------------------------------------------------------------------X---S-------------------------------------------[]----------------------------------------------------------------------------------------------------------------------------------------------------------------oXXX-------------------------------------------------------------------------------------E---------------------oo----------------------------XXX--------------------oo----------------------------------------------------------------------------------ooo-------------------------------------------------------------------------------------o------------E--S----------------------------------o--------------------------------------------------------------------------------------S---------[]-----------E-----------------------------------------------------------oo----------------------------------------------X-----------------------------------------------------------------------------------------
--------------------XXXX---------------------------------------------------------------------------------Q------QQQ----Q-----QQ?S----QQS--------------E----------------E--X----------------------------ESSQ-------------------------------------X----S------Q--QQQ-------------------------------XXXX-----X----XXX-X-QQQ---------------------<>-----------------------------o------------------------------------S------------------XX-------oooo-------XXXX-----------------------------------EQQQQ---------X-XX--SSS----------------E------------------------XXX----E-----E----------------XXXXXX-----------XXX----XXXXXXXXXX-XXXXX------------XX-----XXX-----------------------------XXXX------------------------XXXX--------------XXXX------XXX---XX---------------------XXXXXX----------------------Q?--------------<>----------------X----------XXXX------------------------XXXXX----XXXX--------o---XXXX-----------------o-----------------------------E----E--QQQ-----------------------------------------------SSS------Qoo----SQS-----o---------------Q-Q---E----------------------<>-----E------------------------------------------------------------------------------------------------------XXX-XXXXXXXXX------E---ESS[]-----E----<>-XXX----------XXX----XXXX----o-----E--------------------X---------XXXXXXXXXXXXXX-----XXX------------o------------------QQQQ-----------------XXXX---------o--------XX---------------------------------
--------------------------------------------------------------EE--XXXXX?---XX-?----------------------------------------------------------------?----XXXXX?-------------X--XX----------------------------------------------------------XXXX-----------------------------X----------------E-------------------XX-------------------------------[]----------XXXX-----------------------------------------------------------------------------------E---------------------XXX?----------------------------------XXXXX-------XXXX-------XXXXXX-?-------------------------E<>----<>------------------------------------------------------------------------------XXXXXXX-------------------------------------------------------------------------------------------------XXXXXX-XXXXXXX----------------------------------------[]---------------XX------------------------E--------------------------------------------------------------------XXXX?---------------<>--------------------------------------------------------E---------------------------XX----XXX---------<>----------------------[]----<>---------------------------------------XXXXX?--------E-------XXXXXX-?---------------------------------------------------<>--<>--[]----<>----[]----------------------------------<>-------------------XX--------------------------------------------------------S--------------------------X------------E-------------------------------------------
---------E------------E----X------------------------------------------------------------------------------------------------------------------------------------------XX--XX--------------------------------------------------------------------------E----X----------XX---------------------------------------------------------------------[]----------XX------------------------------------------X---------------------------------XXXXX-XXXXX------------XX-------------------------------------------XXXXX---------------------------------------------------<>[]----[]----------------------XXXXXX------o-XXX----------o------------------------------------------XXXX-X---------------o------<>------------------------------------------------------------------------------------------------------------------[]--------------XXX-----------------------<>-------------------o-----------------------------------------------------------------XX-[]------------------------------------------------------------------------------------X-----------------[]----------------------[]----[]----------------------------------------------------<>------------------------------------XXXXX--------------------S----[]--[]--[]----[]---X[]-----XXXX----------------XXXX-----[]--<>-----------E--XXX--------------------------------XXXXX--XXX-X------------S--------------------------X---XXXXXXXXXXXX---------XXXX----------------------<>----
--------------------------XX------------------------------------------------------------------------EE--------E-------------------------------------------------------XX--X--------------------------------------------------E-----------------------------X---------XXX---------------------------------------------------------------------[]------------------------------------------------E-----X-----------------------------------------------------------------------------------------------------XXXXX-----------------------------------E--------EE-----[][]----[]---------------------------------XXX------------XXX-------------------------------------------------------------XXX-----[]---------EE----------------ooo------------------------------------------------------------------------------------[]-------------XXXX-------o---------------[]---------oooo---------------------------------------------------------------------------[]--------E-EE-EE---------------------------------------------------------------------X-----------------[]------------------EE--[]----[]---E--E--E------------------E-----------------------[]-------------------------------------------------------------S----[]-E[]-E[]----[]--XX[]--XXX-----------------------------[]-E[]-----E---------XX--XXXXX-------------------------------------------------S---------------------EE---X--------------------------------------------------[]----
XXX------X--XXX--XXXXXXX-XXX--XXX-----XXXX-----XXX----XXXXXXXXXXXX-----XXX----XXXXX-XXX---------XXXXXXXXXXXXXXXXXXXXXXXXXXXXXXXXXXXXXXXX-------XXXX-------XXXX----XXXXXXXXX--XXXX----X---XXXXX---XXX-XXX----XXXXXXXX--------XXXX---XXX------XXX------XXX--XXXXXXXXXXXXXXXXXX--XXXXXXXXX-XXXXXXXXXX------------------XXXXXX---XXXXXXX-XXXXXXXXXXX-XXXXXX-------------XX---XXXXXXXXXXXXXXX-XXXXXX-X-XX-X--XXXXXXXXXXXXXXXXXXX-----XXXXXX--------------------------XXXXXX---XXXXXXXXXXXXXXX--XXXXXXXXXX--XXXXXXXXXXXXXXXXXX-----XXXXXX----------XXXXXXXXXXXXXXXXXXXXXXXXXXXXXXXXXXXXXXXXX----X-----------------X---------------------------XXXXXXX-XXXXXXX-----------------------------------------XXXXXXXXXXX--XXXXXXX--------XX----XXXX------XX--------XXXXX--XXXXXX-----------------XXX----------XXXXXXXXX----XXXXXXXXXXXXX--X---XXXXXXXXXXXXXX----XXX------XXX--X-XXXXX-------XXX------------------XXXXXXXX-----XXXXXX---------XXXXXXX--------------XXXX----XXXXXXXXXXXXXXXXXXXXXXX-XXXXXXX--XX----XXXXXXXXXX---XXXXXXXXXXX--XXXXXXXXXXXXXXXo--XXXXXXXX----XXXXXXXXXXXXXXXXXXXX----XXXXXXXXXXXXXXXXXXXXXXXXXXXXXXXXXXXXXXX--XXXXXXX---XXXX-----XXXXXX-XXXXXXXXXXXX---------XX-XXXXXXXX--XXXX---------------------------XXXXXXXXXXXXXXXXXXXXXXXXXXXX----------------------------XXXXXXXXXXXXXXXXXXXXXXXXXXXXXX--------------------------XXX-------------------------XXXXXXXXXXXXXXXX----XXXXXXXXX---------------------------XXXXXXXXXXX--XXXXXXXXXXXXXXX
