--------------------------------------------------------------------------------------------------------------------------------------------------------------------------------------------------------------------------------------------------------------------------------------------------------------------------------------------------------------------------------------------------------------------------------------------------------------------------------------------------------------------------------------------------------------------------------------------------------------------------------------------------------------------------------------------------------------------------------------------------------------------------------------------------------------------------------------------------------------------------------------------------------------------------------------------------------------------------------------------------------------------------------------------------------------------------------------------------------------------------------------------------------------------------------------------------------------------------------------------------------------------------------------------------------------------------------------------------------------------------------------------------------------------------------------------------------
--------------------------------------------------------------------------------------------------------------------------------------------------------------------------------------------------------------------------------------------------------------------------------------------------------------------------------------------------------------------------------------------------------------------------------------------------------------------------------------------------------------------------------------------------------------------------------------------------------------------------------------------------------------------------------------------------------------------------------------------------------------------------------------------------------------------------------------------------------------------------------------------------------------------------------------------------------------------------------------------------------------------------------------------------------------------------------------------------------------------------------------------------------------------------------------------------------------------------------------------------------------------------------------------------------------------------------------------------------------------------------------------------------------------------------------------------------
-------------------------------------------------------------------------------------------------------------------------------------------------oo--------------------------------------------------------------------------------------------------------------------------------------------------------------------------------------------------------------------------------------------------------------------------------------------------------------------------------------------------------------------------------------------------------------------------------------------------------------------------------------------------------------------------------------------------o-------------------------------------------------------------------------------------------------------------------------------------------------------------------------------------------------------------------------------o---------------------------------------------------------------------------------------------------E--------------------------------------------------------------------------------------------------------------------------------------------------------------------------------------------------------------------------------------------------------------------------------------------------------------------------------------------------------------------------------------------------------------
-------------------------------------------o----------------------------o-----------------------------------------------------------------------XXXX-----------------------------------------------------------------------------------------------------------------------------------------------------------------------------------------------------------------------------------------------Q--------------------------------------------------------------------------------------------------------------------------------------------------------------------------------------------------------------------------------------------------------------------------------------------------X------------------------------------------------------------------------------X-------------oo----E--------------------------------------------------------------------------------------------------------------------------XXXX-------------------------------------------------------------------------------------------------E--E--------------------------------------------------------------------------------------------XXX------------------------------------------------------------------------------------------------------------------------------------------------------------------------------------------------------------------------------------------------------------------------------------------------------------
--------------------------------------------------------oooooo----oo--oo-----------------------------------------------------------------------------------------------------------------------------o--------------------------------------------------------------------------------------------------------------------Eoo---E--E---oo----------------------------------------------------o----------------------------------------------------------------------------------------------oo-------------------------------------------E--------------------------------------XXXX-------------------------------------------------------------------------------------------------oooo------------------------------------------------------------------------------------------------E--------------XXX---------------------------------------------------------------------------------------------------------------------ooo-------------------------------------------o---------------------------------------------------------XXXXXXXX--------------------------------------------------------------------------------------------------------------------------------------------oo----------------------------------------------------------------------------------------------------------------------------------------------------------------------------------------------------------------------------------------------------------
----------------------------------o---------Xoo----oo---XXXXXX------------SSS---XXX--------------XXX----S------------------SSSSS-----SSSSS--------------------Q-------------------------------------XXX------------------S-------------------------Q----------------------------SSS------------S-------------------------XXXX------E-----------------------------SQ---------------------E----XXX----o---XX--------------------------o-------------------------------QSQS-----QQQ---QQQQQ---------------------SSSS-----------------------XXX-----?SSSXX---------XX-------oo--------------------------------------------------------------------------------SS-S-SSSSS-------SSS-----X-XXXX------------------------E------SSS-------------------S---------Q------QQQQQ------------------------E----------------------------?--E-----------------------------------------------------------------------X--------------------------------------------SSSS---?------XXX-----------XXX-------------SS-------------SS--------------------E----------------------------------SQQ---------------------SQSS----------------------E------------XX-----------------SSS------QS--------------------------X---oo--XXX------Xo----oo--------Q----------------------oo----------------------------------------------------------------------------------------------------Q------------XXXo---XXX----oo---------------------------Q-----------------------------------SS
---------------------------------------------XXX-----------------------------------------------------------------------------------------------------E--------E-o---o---------------------------------------------------------------------------------------------------------------------------------------------------------------XXXX--------------------------E-o-----------------XXX-X----------------------E--SSS-------------------------------------o-----------------------------------------------------------------------------oooo---------XXX---E----------------------------------------------------------------------------------------------------------------------------------------------------------------E----E-------------------------------------------------------XXXX--------E--o---XX-----------XXXXo---o-----------------------------E-----------------------------------------------------------------------------------------------------------------------------------XXS-------------------------<>-------------------------------------------------------------E---------------------XXXXX----------------------------------------------------------------------X----------------------------------------------------------------------------------------------------------------------------------------------------------o---o---------------------------------------------------o---o-------------------------------
--------------------------------------------------------------XXX---X---XXX--------------------------------------------------------------------XXXXXXXX-------XXXXXXXX-------------------------------------XXXX--------------------------------------------------------------X--------------X----------------------------------------------------------X----------XXXX-Xoo-------------------------------------XXXX-XXX-XXX--XX---------------------X-XXXXXXXX----------------------------------XXXXXXX--------------o------------------------------------XXXXX-------------------------------------------------------------------------------------------------------------------------------------------------------------XXXXXXXXXXXX------XXX------------------------------------------------XXXXXXXXXXX------------------XXX-XXX--X------------------------XXXX--------------------------------------------------------------XXXXXXXX-----------------------------------------------------------------E---------------------[]----------------------------------------------XXX----------XXXX---o-------------------------------------XX-------------------------------------o-------------------------------------------------------------------------XX----------------o-----------------------------------------------o----------------------------XXXXXXX-X--------------------------------------------XXXXXXXXXX----------------------XX--o---
-------------------o-------------o--------------------------------------------------------------------------------------------------------E--------------------------------XX---------------------------------------------------------------------------------ooo------------X--------------X-------------------------o----------------------XX-------------------------------E----------------------------------------------------------------------------------------------------------------------------------------------o------Q-----E------------------------------XXX----------------------------------oo------------------------------------------------------------------------------------------------------------------------------------------------------------------------------------------------------E---------------------------------------------------XX---oo-------------ooo---------------------XXX----------------------------------------------------------o----------------------XXXX-------------------[]----------------------------------------------------------------------ooo-----------------oooo------------------------XX-----------------------------------------------------------------------------------------------------------------------------------------SSS--------------------------------------------------------------------------------XXX--------------------------------------------------------------
----------E--E---------------XXX------XXXXX----XXX---XXXXXXX-----------------XXX---------------XX--XXXXXXXXXX----------------------------<>---------oo--------------------XXX---------------------------------------XXX---------Q--SQS-------------------------------------XXXXXX--XXXX---X-X------------XX-----------------XXXXX----------------------------Q--S----S?S-----<>---E--SXXX------XXXX----X--XXXX------o---------------o---------------Q-----------Q---SSS------Q----QQ--QQQ------------------XXXX--XXXX---XXX---------XXX--<>-----E-----XXX------ooo---------------------------------------------------Q-------<>--------X----X----------------S---------------E-----XXXXXXX------XX-----------XX--<>-XXX--XXX------------------------------o----QQQQQQQ-----Q-----------------------------------------<>----QQ-----------------E---------------------------XX---------------------------XXXXXXXX--------------------------------XXX--XXXX----XXXX---------------------------XXXXX-----------------------------S---[]-----ES-------------------Q-----------------------------XXXX--XXX-------------X--------------------------------XX-------------------------Q--QSQ-------XXXXX------X--XXXXX--XXXXXXXX----Q--------------------------XXXX----o-o--------------------XXX-------S-------------------------Q--SSS----------------------Q--QS----------XXXXX-XXXX---XXX------------------------------------------------------XXS----S------
----------XXXXXX-------------------------------------------------------------------------------------------------------------------------[]------------------------------EX-X---------------------------------XXXXX-------------------------------------------------------XXXXXXX---------X-X--------XXXX---------XX---------------------------------------------------------[]--<>---------------------------------E-----o----------------------------------------E---------------------------------------------------------------------[]----<>-----------------E------------------------X-----------------------E---------[]---------------------------------------?-----<>-----------------------------------[]--------------------------------------------------------------------------XXXXX-?--XXXX?----------[]----------------------<>--------------------------XXX---------------------------------------------------------------------------------------------------------------------------------------->---E--------[]----<>-----------------------------------------------------------------------------------------------------------------------------------------------EXXX------------------------------------------------------------------------------------------------------E------E----------------------------------------------------------------------------------------------------------------X-------------------------E-XX
--------------------------------------------o----------------XXXX-----------------XX----XXXX---------------------------------------<>----[]------XXXXSX-------------XXXX--X-X-----------------------------XXXXXXXX------------------------------------------S------------XXXXXXXX---------X-X--------------------XXX----------------------XXX-------XXXX--X----------------X-[]--[]--------------------------XXXXXXXXXX--XXXXX--------------------------------------------------------------------X--E-----------------X---XXXXX---------[]----[]------o--XXXXXXXXX?--o--------X---------------------------------------------[]-----E---------------------------------------[]-----------------------------------[]------------XXXXXXXX------------------------------------------------------------------------------[]----------------------[]-------------------------XXXX-------------------------------------------------------XXXXX----------------XXXX------------------------------------------o-------------S--<>--------[]----[]--------------------------------------------------------------X----------------------------------XXXXX-------XXX---XXXX----------------------EXXXXX---o----------------------------------------------------------XXXXXXXX-------------------------------<>-----<>------------------------EE---X-------------------------------------------------------X-----XXX--X----------------X-----X-----------------<>--X
--------------------------EE-------oo------XXX-------------------------------------------------------XXX---------------------------[]----[]---------------------------------X---E----EE-E---------------------------------------------------------------EE-ES-----------XXXX-XXXX---------X-X--------------------X-------ooo-------------------------------------------------[]--[]---------------------XX-------------------------X----------------E--------------------------------------------------oooo-----------------------E------[]----[]-----XXXX-----------XXX-----------------------------------X--------------E--[]--------------------E--E-EE-E----------------[]-------------------------o---------[]-----------------------------------E--------------------------XX----------------------------------[]---------E------------[]--------------------------XXX----------E-E------------------------------------E-E--------------------------------------------------------X-XX------------------------S--[]---E----[]----[]------------------E-----------------------------------------------------------------------------------------------------E-E---------EE-E-----XXXXXX--XXXXXX--------------------------------E-EE-------E-E---------------------------XXX---------------E-[]-----[]----------------------------XX----------------------------------------------------------------------------------XX-----------------------[]-XX
---XXXXXXX------------XXXXXX-------XX-----------------------------------------------XXX-------------------------XXXXXXXX---XXXXXXXXXXXXXXXXXXXX----------XXXXXXXXX------XXXXXXXXXXXXXXXXXXXXXXXX-XXX-XX------------------XXXXX--XXXXXXXXXX--------XXXXXXXXXXXXX--XXXXXXXXXX--XXXXS------XXXXXXXXXXX----------XXXXXXX----XXXX------XXXX---------XXXX---------XXXXXXXXXX-------XXXXXXXXXXXXXXXXXX------XXX----------------------------XXXXXXXXXX-XXXXXXXXXXXXX-XX-XXXXXXXX-XXXXXXXXXXXXXXXX---XXX---------XXX-----------------------XXXXXXXXXXXXXXXXXX-------------------------------XXXX--XXX----XXXXXXXXXXXXXXXXXXXXXX-XXXXXXXXXXXX--XXXXXXX-XXXXXXXXXXXXXXXXXXXXXXXXXXXXXXXXXXXXXX-------------XX----X--------XXXXXXX--XXXXX----------------XXXXXXXXXXXXXXXXXXXXXXXXXXXX-XXXXXX-XXXXXXXXXXX-------XXX------XXX-XXXXXXXXXXXXXXXXXXXXXX---XXX-XXXXXXXXXX--XX------XXX----XXXXXXX---XXXXXXXXXXXX---XXXXX-------------X-X--XXXXXXXXXXX-------------------------X--------X---XXXXXXXXX----XX----------------------------XXXXXXXXXXXXXXXXXXXXXXXXXXXXXXX--XXX--XXXXXXXXX-------XXXXX---------XXX-------------XXX-XXXXX---XXXXXXXX-----XXX----------------------------XXXXXX-XXXXXXXXXXXXXXXXXXXXX----------------------------XXXXX---XXXXXXXXXXXXXXXXXXXX-----------------------------XXX----XXXXXXXXXXXXXXXXXXXXXXXXXXXXXXXXXXXXXXXXXXXX---XXXXXXXXXXX--XXXXXXXXX----XXX----------------------------XXXX--------XXX----XXXX----XXXXX------XXXXX--X-XXXXXXXXX
