--------------------------------------------------------------------------------------------------------------------------------------------------------------------------------------------------------------------------------------------------------------------------------------------------------------------------------------------------------------------------------------------------------------------------------------------------------------------------------------------------------------------------------------------------------------------------------------------------------------------------------------------------------------------------------------------------------------------------------------------------------------------------------------------------------------------------------------------------------------------------------------------------------------------------------------------------------------------------------------------------------------------------------------------------------------------------------------------------------------------------------------------------------------------------------------------------------------------------------------------------------------------------------------------------------------------------------------------------------------------------------------------------------------------------------------------------------
--------------------------------------------------------------------------------------------------------------------------------------------------------------------------------------------------------------------------------------------------------------------------------------------------------------------------------------------------------------------------------------------------------------------------------------------------------------------------------------------------------------------------------------------------------------------------------------------------------------------------------------------------------------------------------------------------------------------------------------------------------------------------------------------------------------------------------------------------------------------------------------------------------------------------------------------------------------------------------------------------------------------------------------------------------------------------------------------------------------------------------------------------------------------------------------------------------------------------------------------------------------------------------------------------------------------------------------------------------------------------------------------------------------------------------------------------------
---------------------------------------------------------------------------SSSSS---S-------------------SSS-------------------------SSSSS----------------------SSSSSSS--S----------------------------SSSS---------SSSSSSSSSSSSSSSS------------SSSSSSSSSSSSSSS-------------------SSS-------------------------S--------SSSSSSSSSSSSSSSSSSSSSSSSSSSS--------------------------------------------------------------------------------------------------------------------------------------------------------------------------------------------------------------------------------------------------------------------------------------------------------------------------------------------------------------------------------------------------------------------------------------------------------------------------------------------------------------------------------------------------------------------------------------------------------------------------------------------------------------------------------------------------------------------------------------------------------------------------------------------------------------------------------------------------------------------------------------------------------------------------------------------------------------------------------------------------------------------------------------------------------------------------------------------------------
--------------------------------------------------------------------------------------------------------------------------------------------------------------------------------------------------------------------------------------------------------------------------------------------------------------------------------------------------------------------------------------------------?-------------------------------------------------------------------------------------------------------------------------------------------------------------------------------------------------------------------------------------------------------------------------------------------------------------------------------------------------------------------------------------------------------------------------------------------------------------------------------------------------------------------------------------------------------------------------------------------------------------------------------------------------------------------?---------------------------------------------------------------------------------------------------------------------------------------------------------------------------------------------------------------------------------------------------------------------------------------------------------------------------------------------------------------------------------
---Eooo----------------------------------------------------------------------------------------------------------------------------------------------------------------------------------------------------------------------------------------------------------------------------------------------------------------------------------------------------------?------X--------------------?------X---o----------------?------X---o----------------?------X--------------------?------X--------------------?------X--------------------?------X--------------------?------X--------------------?------X-oo-----------------?------X--------------------?------X--------------------?------X--------------------?------X--------------------?------X---o----------------?------X---o----------------?------X---o----------------?------X---o----------------?------X---o----------------?------X---o----------------?------X--------------------?------X----------------------------------------------------------------------------?------X--------------------?------X---o----------------?------X---o----------------?------X---o----------------?------X---o----------------?----------o----------------?------X---o----------------?----------oo-------------------------------------------?---------------------------?----------o----------------?------X--------------------?------X---o----------------?------X---o----------------?------X---
---XXXX----------ooo--------------------------------------------------------------------------------------------------------------------------------------------------------------------------------------------------------------------------------------------------------------------------------------------------------------------------------oo--XXXXX----Xoo---XX-------ooo---XXX----oo----oo-------------XXXo---SS-S---?------------XXXXo---SS-S---?--------o---XXXXo---XS-----?--------o--XXXXXo---Xo----XX-------oo--XXXXXo---Xo----XX-------oo--XXXXXo---Xo----XX-------oo--XXXXXo---Xo----XX-------oo--XXXXXo---XS-----?-------oo--XXXXXo---Xo----XX--------o---XXXXo---XS----o?-------oo--XXXXXo---Xo----XX--------o--XXXXXo---Xo----o?--------o---XXXXo---XS-S---?--------o---XXXXo---SS-S---?--------o---XXXXo---SS-S--o?-------oo----XXXo---SS-S---?-------------XXXo---SS-S---?------------XXXXo---SS-S--o?-------oo--XXXXXo---Xo----XX------------SS-------------------------------------------------ooo--XXXX----Xoo---XX--------oo---XXX----oo----XX-------------XXXo---SSSS---?-------------XXXo---XXSS---?-------------XXXo---SS-S---?-------------XXXo---SSSS---?-------------XXXX----SSS---?-------------XXXXX---SSS---?-------------XXXo---SSSS---?-------------XXXX----SSS---?-------------XXXXX--XSSS---?-------------XXXX---SSSS---?-------------XXXX---SS-S---?-------------XXXo---SS-S---?-------------XXXo---SSSS---?---
----------------------------------------------------------------------------------------------------------------------------------------------------------------------------------------------------------------------------------------------------------------------------------------------------------------------------------------------------X----------------------------------------------------XXXXX-----------------------XXXXX-------------------------XXX-------------------------XXX-------------------------XXX-------------------------XXX-------------------------XXX-------------------------XXX-------------------------XXX-------------------------XXX-------------------------XXX-------------------------XXX------------------------XXXX-------------------------XXX-------------------------XXX-------------------------XXX-----------------------XXXXX------------------------XXXX-------------------------XXX---------------------------------------------------------------------------------------------------------------X-------------------------XXX------------------------XXXX-------------------------XXX-----------------------XXXXX------------------------XXXX------------------------XXXX-----------------------XXXXX------------------------XXXX------------------------XXXX-------------------------XXX------------------------XXXX-------------------------XXX------------------------XXXX----------------------
-------------o-------------------------------------------------------------------E---------------------------E---------------------------E---------------------------E---------------------------E---------------------------E---------------------------E----------------------------------------------------------------------------------------------------------------------------------------------------------------------------------------------------------------------------------------------------------------------------------------------------------------------------------------------------------------------------------------------------------------------------------------------------------------------------------------------------------------------------------------------------------------------------------------------------------------------------------------------------------------------------------------------------------------------------------------------------------------------------------------------------------------------------------------------------------------------------------------------------------------------------------------------------------------------------------------------------------------------------------------------------------------------------------------------------------------------------------------------------------------------------------------------
-------------------------------------------E-----E---E--------------------S--E--<>--------------------S--E--<>-----------------E--S--E--<>--------------------S--E--<>-----------------E--S--E--<>-----------------E--S--E--<>--------------------S--E--<>-----------------------E---E-----------------E--S--E--<>-----------------------E-------------------------XXX-----------------------------------------------------------------------------------------------------------------------------------------------------------------------------------------------------------------------------------------------------------------------------------------------------------------------------------------------------------------------------------------------------------------------------------------------------------------------------------------------------------------------------------------------------------------------------------------------------------E---E-----------------------E---E---------------------XXX--------------------------------------------------------------------------------------------------------------------------------------------------------------------------------------------------------------------------------------------------------------------------------------------------------------------------------------------------------------------------------------------------------------
XXX----XX----XXX----------XX---------QS---<>----<>--<>-----------------E----<>--[]-----------------E----<>--[]----------------<>----<>--[]-----------------E----<>--[]----------------<>----<>--[]----------------<>----<>--[]-----------------E----<>--[]-----------------E----<>--<>----------------<>----<>--[]----------------------<>---E--XXX---XXXX--XXXX----XXXXXXXXXXXX--------XXXX----XXXXXXXXXXXX--------XXXXX---XXXXXXXXXXXX--------XXXXX---XXXXXXXXXXXX--------XXXXX---XXXXXXXXXXXX--------XXXXX---XXXXXXXXXXXX--------XXXXX---XXXXXXXXXXXX--------XXXXX---XXXXXXXXXXXX--------XXXXX---XXXXXXXXXXXX--------XXXXX---XXXXXXXXXXX---------XXXXX---XXXXXXXXXXXX--------XXXXX---XXXXXXXXXXXX--------XXXXX---XXXXXXXXXXXX--------XXXXX---XXXXXXXXXXXX---------XXXX---XXXXXXXXXXXX--------XXXXX---XXXXXXXXXXXX--------XXXXX---XXXXXXXXXXXX---------XXXX---XXXXXXXXXXXX--------XXXXX---XXXXXXXXXXXX---------XXXX---XXXXXXXXXXXX--------XXXXX---XXXXXXXX---------E----------<>--<>----------------------<>--<>--XXX---XXXX--XXXX----XXX--XXXXXXX-----X-XXXXX----XXXXXXXXXXXX---------XXXX---XXXXXXXXXXX----------XXXX---XXXXXX-XXXXX--------XXXXX---XXXXXXXXXXX----------XXXX---XXXXXXXXXXX----------XXXX---XXXXXX--XXX----------XXXX---XXXXXX-XXXX---------XXXXX---XXXXXX--XXX----------XXXX---XXXXXX--XXX----------XXXX---XXXXXX--XXX----------XXXX---XXXXXXXXXXX----------XXXX---XXXXXXXXXXXX--------XXXXX---XXXXXXXXXXX----------XXXX---XXXXXX-X
---o--------------E-----------------------[]----[]--[]----------------<>----[]--[]----------------<>----[]--[]----------------[]----[]--[]-----------E----<>----[]--[]----------------[]----[]--[]----------------[]----[]--[]----------------<>----[]--[]-----------E----<>----[]--[]----------------[]----[]--[]----------------------[]--<>---------------------------------------------------------------------------------------------------------------------------------------------------------------------------------------------------------------------------------------------------------------------------------------------------------------------------------------------------------------------------------------------------------------------------------------------------------------------------------------------------------------------------------------------------------------------------------X------------------------------------<>-----E----[]--[]----------------------[]--[]--------------------------------------------------------------------------------------------------------------------------------------------------------------------------------------------------------------------------------------------------------------------------------------------------------------------------------------------------------------------------------------------------------------------------------------
--XXXXXX---------<>-----------------------[]----[]--[]----------------[]----[]--[]----------------[]----[]--[]----------------[]----[]--[]----------------[]----[]--[]----------------[]----[]--[]----------------[]----[]--[]----------------[]----[]--[]----------<>----[]----[]--[]----------------[]----[]--[]----------------------[]--[]-------XX----------oo-------------XXXX---------oo-------------XXXX---------oo-------------XXXX---------oo-------------XXX----------oo-------------XXX----------oo-------------XXX----------oo-------------XXX----------oo--------------XX----------oo--------------XX----------oo-------------XXX----------oo-------------XXX----------oo-------------XXX----------oo-------------XXX----------oo-------------XXXX---------oo-------------XXXX---------oo-------------XXXX---------oo-------------XXXX---------oo-------------XXXX---------oo-------------XXXX----------o--------------XX----------oo-----------------[]----<>----[]--[]----------------------[]--[]-------------------oo-------------XXX----------oo-------------XXXX---------oo------------XXXXX----------o-------------XXXX---------oo-------------XXXX----------o-------------XXXX----------o-------------XXXX----------o-------------XXXX----------o------------XXXXX----------o------------XXXXX----------o------------XXXXX----------o------------XXXXX----------o-------------XXXX---------oo------------XXXXX----------o---------
-----------------[]---------------E-EE----[]-E--[]--[]-----E-EE-EE-E--[]-E--[]--[]-----E-EE-EE-E--[]-E--[]--[]-----E-EE-EE-E--[]-E--[]--[]-----E-EE-E--E--[]-E--[]--[]-----E-EE-EE-E--[]-E--[]--[]-----E-EE-EE-E--[]-E--[]--[]-----E-EE-EE-E--[]-E--[]--[]-----E-EE-[]-E--[]-E--[]--[]-----E-EE-EE-E--[]-E--[]--[]----------EE-E--EE----[]--[]--XXXXX-----------XXXX------------------------XXXX------------------XX----XXXX------------------XXX---XXXX-----------------XXXX---XXXX-----------------XXXX--XXXXX-----------X-----XXXX--XXXXX-----------------XXXX-XXXXXX----------XX-----XXXX--XXXXX----------XXX---XXXXXXXXXXXX-----------------XXXXXXXXXXX-----------------XXXX---XXXX-----------------XXXXXXXXXXX-----------------XXXX--XXXXX-----------------XXXX---XXXX-----------------XXXX---XXXX-----------------XXXX---XXXX------------------XXX---XXXX------------------XXX---XXXX------------------XXX---XXXX-----------X-----XXXXXXXXXXX-----------E-EE-[]----[]-E--[]--[]-------EE-EE-E--EE-E--[]--[]--XXXXX-----------XXXX------------------------XXXX------------------XX----XXXX------------------XXX---XXXX------------------XXX---XXXX------------------XXX---XXXX------------------XXX---XXXX------------------XXX---XXXX-----------------XXXX---XXXX------------------------XXXX------------------XX----XXXX------------------XX----XXXX------------------XXX---XXXX------------------XX----XXXX------------------XXX---XXXX--------
---------------XXXXXXXX------XXXXXXXXXXXXXXXXXX-XX--XX---XXXXXXXXXXXXXXXXX--XX--XX---XXXXXXXXXXXXXXXXX--XX--XX---XXXXXXXXXXXXXXXXX--XX--XX---XXXXXXXXXXXXXXXXX--XX--XX---XXXXXXXXXXXXXXXXX--XX--XX---XXXXXXXXXXXXXXXXX--XX--XX---XXXXXXXXXXXXXXXXX--XX--XX---XXXXXXXXXXXXXXXXX--XX--XX---XXXXXXXXXXXXXXXXX--XX--XX---XXXXXXXXXXXXXXXXXXXXX--XXXX-------------------------------------------------------------------------------------------------------------------------------------------------------------------------------------------------------------------------------------------------------------------------------------------------------------------------------------------------------------------------------------------------------------------------------------------------------------------------------------------------------------------------------------------------------------------------------------------------------------XXXXXXXXXXXXXXXXXX-XX--XXX--XXXXXXXXXXXXXXXXXX-XX--XX--------------------------------------------------------------------------------------------------------------------------------------------------------------------------------------------------------------------------------------------------------------------------------------------------------------------------------------------------------------------------------------------------------------------------------------
