--------------------------------------------------------------------------------------------------------------------------------------------------------------------------------------------------------------------------------------------------------------------------------------------------------------------------------------------------------------------------------------------------------------------------------------------------------------------------------------------------------------------------------------------------------------------------------------------------------------------------------------------------------------------------------------------------------------------------------------------------------------------------------------------------------------------------------------------------------------------------------------------------------------------------------------------------------------------------------------------------------------------------------------------------------------------------------------------------------------------------------------------------------------------------------------------------------------------------------------------------------------------------------------------------------------------------------------------------------------------------------------------------------------------------------------------------------
--------------------------------------------------------------------------------------------------------------------------------------------------------------------------------------------------------------------------------------------------------------------------------------------------------------------------------------------------------------------------------------------------------------------------------------------------------------------------------------------------------------------------------------------------------------------------------------------------------------------------------------------------------------------------------------------------------------------------------------------------------------------------------------------------------------------------------------------------------------------------------------------------------------------------------------------------------------------------------------------------------------------------------------------------------------------------------------------------------------------------------------------------------------------------------------------------------------------------------------------------------------------------------------------------------------------------------------------------------------------------------------------------------------------------------------------------------
----------------------------------------------SSSSSSS--SSSSS-SS----SSSSSSSSSSSSSSSSSSSS----------SSSSSSSSSSSS-SS-----------------------------------------------SSSSS---S--------------SSSSSSSSSSS-SS--------------SSSSSSSSSSS-SS-------------------SSS------------------------SSSSSSS--S-------------------SSS------------------------------------------------------------------------------------------------------------------------------------------------------------------------------------------------------------------------------------------------------------------------------------------------------------------------------------------------------------------------------------------------------------------------------------------------------------------------------------------------------------------------------------------------------------------------------------------------------------------------------------------------------------------------------------------------------------------------------------------------------------------------------------------------------------------------------------------------------------------------------------------------------------------------------------------------------------------------------------------------------------------------------------------------------------------------------------------------------------------------------------------
------------------------------------------------------------------------------------------------------------------------------------------------------------------------------------------------------------------------------------------------------------------------------------------------------------------------------------------------------------------------------------------------------------------------------------------------------------------------------------------------------------------------------------------------------------------------------------------------------------------------------------------------------------------------------------------------------------------------------------------------------------------------------------------------------------------------------------------------------------------------------------------------------------------------------------------------------------------------------------------------------------------------------------------?------------------------------------------------------------------------------------------------------------------------------------------------------------------------X------------------------------------------------------------------------------------------------------------------------------------------------------------------------------------------------------------------------------------
-----------------------------------------------------------------------------------------------------------------------------------------------------------------------------------------------------------------------------------------------------------------------------------------------------------------------------------------------------------------?------X-o-o----------------?----------o----------------?------X---o----------------?------X--------------------?------X--------------------?------X--------------------?------X--------------------?------X--------------------?------X--------------------?------X--------------------?------X--------------------?------X--------------------?------X--------------------?------X--------------------?------X---o----------------?------X---o----------------?------X--------------------?------X---o----------------?------X--------------------?------X----------------------------------------------------------------------------?------X--------------------?------X---o----------------?------X---o----------------?------X---o----------------?------X---o----------------?------X---o----------------?------X---o----------------?------X---o----------------?------X---o----------------?----------o----------------?----------o----------------?----------o----------------?----------o----------------?------X---o----------------?------X---o----------------?------X---
-------------------------------------------------------------------------------------------------------------------------------------------------------------------------------------------------------------------------------------------------------------------------------------------------------------------------------------oo----oo-------Xoo---XXX----ooo---XX-------------XXXXX---SSS---?------------XXXXo---SS-S--o?--------o----XXXo---SS-----?--------o---XXXXo---XS----o?-------oo--XXXXXo---XS-----?--------o--XXXXX----Xo----XX--------o--XXXXXo---Xo----XX-------oo--XXXXX----Xo----XX-------oo--XXXXXo---Xo----XX-------oo---XXXX----Xo----XX-------oo---XXXXo---XS----o?-------oo--XXXXXo---Xo----XX-------oo---XXXXo---Xo----oX--------o---XXXXo---XS-----?--------o----XXXo---SS----o?--------o----XXXo---SS-S---?--------o---XXXXo---XS-----?-------------XXXo---SS-S---?--------o---XXXXo---XS----o?-----------SSSSS-----------------------------------------------ooo---XXX----ooo---Xo-------Xoo---XXX----ooo---oX-------------XXXo---XSSS---?-------------XXXo---XSSS---?-------------XXXo---SSSS---?-------------XXXo---SSSS---?-------------XXXo---SSSS---?-------------XXXo---SSSS---?-------------XXXXX---SSS---?-------------XXXo----SSS---?-------------XXXo---SSSS---?-------------XXXXX--SSSS---?-------------XXXXX--XSSS---?-------------XXXX----SSS---?-------------XXXX----S-S---?-------------XXXo----S-S---?---
---------------------------------------------------------------------------------E--------------------------------------------------------------------------------------------------------------------------------------------------------------------------------------------------------------------------------------------------------------------------------------------XXXX------------------------XXXX-------------------------XXX-------------------------XXX-------------------------XXX-------------------------XXX-------------------------XXX-------------------------XXX-------------------------XXX-------------------------XXX-------------------------XXX-------------------------XXX-------------------------XXX-------------------------XXX-------------------------XXX-------------------------XXX-------------------------XXX-------------------------XXX-------------------------XXX-----------------------------------------------------------------------------------------------------------------------------------------XXX-------------------------XXX------------------------XXXX------------------------XXXX------------------------XXXX-------------------------XXX------------------------XXXX-----------------------XXXXX-----------------------XXXXX-----------------------XXXXX------------------------XXXX------------------------XXXX-----------------------XXXXX----------------------XXXXXX----------------------
-------------------------E---------------------------E--------------------------<>---------------------------E---------------------------E---------------------------E---------------------------E---------------------------E---------------------------E---------------------------E-----------------------------------------------------------------------------------------------------------------------------------------------------------------------------------------------------------------------------------------------------------------------------------------------------------------------------------------------------------------------------------------------------------------------------------------------------------------------------------------------------------------------------------------------------------------------------------------------------------------------------------------------------------------------------------------------E------------------------------------------------------------------------------------------------------------------------------------------------------------------------------------------------------------------------------------------------------------------------------------------------------------------------------------------------------------------------------------------------------------------------------------------------------------------
---------------E--S--E--<>--------------------S--E--<>--------------------S--E--[]-----------------E--S--E--<>-----------------E--S--E--<>-----------------E--S--E--<>-----------------E--S--E--<>--------------------S--E--<>-----------------------E--<>--------------------S--E--<>-----------------E--S--E--<>-------------------------------------------------XXX----------------------------------------------------------------------X---------------------------------------------------------------------------------------------------------------------------------------------------------------------------------------------------------------XX---------------------------------------------------------------------------------------------------------------------------------------------------------------------------------------------------------------------------------------------------------------------------------------E---E-----------------------E--<>------------------------------------------------------------------------------------------------------------------------------------------------------------------------------------------------------------------------------------------------------------------------------------------------------------------------------------------------------------------------------------------------------------------------------------------------------------------
--------------<>----<>--[]-----------------E----<>--[]-----------------E----<>--[]----------------<>----<>--[]-----------------E----<>--[]----------------<>----<>--[]----------------<>----<>--[]-----------------E----<>--[]-----------------E----<>--[]----------------<>----<>--[]----------------<>----<>--[]---------------XXX-<>-XXX--XXXXXXXX--XXX-XXXXX----XXX-XXXXXXX----------XXXX---XXXXXXXXXXX---------XXXXX---XXXXXXXXXXXX--------XXXXX---XXXXXXXXXXXX--------XXXXX---XXXXXXXXXXXX--------XXXXX---XXXXXXXXXXXX--------XXXX----XXXXXXXXXXXX--------XXXXX---XXXXXXXXXXX---------XXXXX---XXXXXXXXXXXX--------XXXXX---XXXXXXXXXXXX--------XXXX----XXXXXXXXXXXX--------XXXXX---XXXXXXXXXXX---------XXXXX---XXXXXXXXXXXX--------XXXXX---XXXXXXXXXXXX--------XXXXX---XXXXXXXXXXXX--------XXXXX---XXXXXXXXXXXX--------XXXXX---XXXXXXXXXXXX--------XXXXX---XXXXXXXXXXXX--------XXXXX---XXXXXXXXXXXX--------XXXXX---XXXXXXXX--------------------<>--<>----------------E-----<>--[]--XXXX---XXX--XXXX----XXXXXXXXXXXX--------XXXX----XXXXXXXXXXXX---------XXXX---XXXXXXXXXXX----------XXXX---XXXXXXXXXXX----------XXXX---XXXXXX-XXXXX---------XXXX---XXXXXXXXXXX----------XXXX---XXXXXXXXXXX----------XXXX---XXXXXXXXXXX----------XXXX---XXXXXX--XXX----------XXXX---XXXXXX-XXXXX---------XXXX---XXXXXXXXXXX----------XXXX---XXXXXX--XXX----------XXXX---XXXXXX--XXX----------XXXX---XXXXXX--XXX----------XXXX---XXXXXXXXXXX----------XXXX---XXXXXXXX
--------------[]----[]--[]----------------<>----[]--[]-----------E----<>----[]--[]----------------[]----[]--[]----------------<>----[]--[]----------------[]----[]--[]----------------[]----[]--[]-----------E----<>----[]--[]----------------<>----[]--[]----------------[]----[]--[]----------------[]----[]--[]-----o-------------[]----------------------------------------------------------------X---------------------------------------------------------------------------------------------------------------------------------------------------------------------------------------------------------------------------------------------------------------------------------------------------------------------------------------------------------------------------------------------------------------------------------------------------------------------------------------------------------------------------------------E----[]--[]-----------------E----[]--[]-----------------------------------------------------------------------------------------------------------------------------------------------------------------------------------------------------X------------------------XXXX---------------------------X---------------------------X-------------------------------------------------------X-------------------------------------------------------X--------------------------------------------------------
--------------[]----[]--[]----------------[]----[]--[]----------<>----[]----[]--[]----------------[]----[]--[]----------------[]----[]--[]----------------[]----[]--[]----------------[]----[]--[]----------<>----[]----[]--[]----------------[]----[]--[]----------------[]----[]--[]----------------[]----[]--[]----XXXXX----------[]--------------------------oo-------------XXXX----------o------------XXXXX---------oo-------------XXXX---------oo-------------XXX----------oo-------------XXX----------oo--------------XX----------oo--------------XX----------oo--------------XX----------oo--------------XX----------oo--------------XX----------oo-------------XXX----------oo-------------XXX----------oo-------------XXX----------oo-------------XXX----------oo-------------XXX----------oo-------------XXXX---------oo-------------XXXX---------oo-------------XXXX---------oo-------------XXX----------oo-----------------------<>----[]--[]----------------<>----[]--[]-------XX----------oo-------------XXX----------oo-------------XXXX---------oo-------------XXXX---------oo-------------XXXX---------oo-------------XXXX---------oo-------------XXXX----------o------------XXXXX----------o-------------XXXX----------o-------------XXXX----------o-------------XXXX----------o-------------XXXX----------o-------------XXXX----------o-------------XXXX----------o------------XXXXX----------o-------------XXXX----------o---------
-----EE-E-----[]-E--[]--[]-----E-EE-EE-E--[]-E--[]--[]-----E-EE-[]-E--[]-E--[]--[]-----E-EE-EE-E--[]-E--[]--[]-----E-EE-EE-E--[]-E--[]--[]-----E-EE-EE-E--[]-E--[]--[]-----E-EE-EE-E--[]-E--[]--[]-----E-EE-[]-E--[]-E--[]--[]-----E-EE-EE-E--[]-E--[]--[]-----E-EE-EE-E--[]-E--[]--[]-----E-EE-EE-E--[]-E--[]--[]-------------------[]------------X------------XXXX------------------XXX---XXXX------------------XXX---XXXX-----------------XXXX---XXXX-----------------XXXX---XXXX----------XX-----XXXX---XXXX----------XX-----XXXX-XXXXXX----------XXX----XXXX---XXXX-----------X-----XXXX--XXXXX-----------X-----XXXX-XXXXXX----------XXX----XXX----XXXX-----------------XXXX---XXXX-----------------XXXXXXXXXXX-----------------XXXX---XXXX-----------------XXXX---XXXX-----------------XXXX---XXXX-----------------XXXX---XXXX-----------------XXXX---XXXX-----------------XXXX---XXXX-----------------XXXX---XXXX-------------EE-EE-E--[]-E--[]--[]-------EE-EE----[]-E--[]--[]--XXXXX-----------XXXX------------------------XXXX------------------XXX---XXXX------------------XXX---XXXX------------------XXX---XXXX------------------XXX---XXXX------------------XXX---XXXX------------------XX----XXXX------------------XXX---XXXX------------------XXX---XXXX-------------------X----XXXX------------------XXX---XXXX------------------XXX---XXXX------------------XX----XXXX------------------XXX---XXXX------------------XX----XXXX--------
-XXXXXXXXXXXXXXXXXX-XX--XX---XXXXXXXXXXXXXXXXX--XX--XX---XXXXXXXXXXXXXXXXX--XX--XX---XXXXXXXXXXXXXXXXXX-XX--XX---XXXXXXXXXXXXXXXXX--XX--XX---XXXXXXXXXXXXXXXXX--XX--XX---XXXXXXXXXXXXXXXXX--XX--XX---XXXXXXXXXXXXXXXXX--XX--XX---XXXXXXXXXXXXXXXXX--XX--XX---XXXXXXXXXXXXXXXXX--XX--XX---XXXXXXXXXXXXXXXXX--XX--XX------------XXX--XXXXXX----------------------------------------------------------------------------------------------------------------------------------------------------------------------------------------------------------------------------------------------------------------------------------------------------------------------------------------------------------------------------------------------------------------------------------------------------------------------------------------------------------------------------------------------------------------------------------------XXXXXXXXXXXXXXXXX--XX--XX---XXXXXXXXXXXXXXXXXX-XX--XX------------------------------------------------------------------------------------------------------------------------------------------------------------------------------------------------------------------------------------------------------------------------------------------------------------------------------------------------------------------------------------------------------------------------------------------------------------------
