--------------------------------------------------------------------------------------------------------------------------------------------------------------------------------------------------------------------------------------------------------------------------------------------------------------------------------------------------------------------------------------------------------------------------------------------------------------------------------------------------------------------------------------------------------------------------------------------------------------------------------------------------------------------------------------------------------------------------------------------------------------------------------------------------------------------------------------------------------------------------------------------------------------------------------------------------------------------------------------------------------------------------------------------------------------------------------------------------------------------------------------------------------------------------------------------------------------------------------------------------------------------------------------------------------------------------------------------------------------------------------------------------------------------------------------------------------
--------------------------------------------------------------------------------------------------------------------------------------------------------------------------------------------------------------------------------------------------------------------------------------------------------------------------------------------------------------------------------------------------------------------------------------------------------------------------------------------------------------------------------------------------------------------------------------------------------------------------------------------------------------------------------------------------------------------------------------------------------------------------------------------------------------------------------------------------------------------------------------------------------------------------------------------------------------------------------------------------------------------------------------------------------------------------------------------------------------------------------------------------------------------------------------------------------------------------------------------------------------------------------------------------------------------------------------------------------------------------------------------------------------------------------------------------------
----------------------o-------------------------------------------------------------------------------------------------------------------------------------------------------------------------------------------------------------------------------------------------------------------------------------------------------------------------------------------------------------------------------------------------------------------------------------------------------------------------------------------------------------------------------------------------------------------------------oo----------------------------------------------------------------------------------------------------------------------------------------------------------------------------------------------------------------------------------------------------------------------------------------------------------------------------------------------------------------------------------------------------------------------------------o-------------------------------------------------------------------------------------------------------------------------------------------------------------------------------------------------------------------------------------------------------------------------------------------------------------------------------------------------------------------------------------------------------------
-------------------------------------------------------------------------------------------------------------------------------------------------------------------------------------------------------------------------------------------------------------------------------------------------------------------------------------------------------------------------------------------------------------------------------------------------------------------------------------------------------------------------------------------------------------------------------------------------------------------------------------------------------------------------------------------------------------------------------------------------------------------------------------------------------------------------------------------------------------------------------------------------------------------------------------------------------------------------------------------------------------------------------------------X--------------------------?---------------------------------------------------------------------------------------------------------------------------------------------------------------------------------------------------------------------------------------------------------------------------------------------------------------------------------------------------------------------------------
-----------------?------X--------------------?------X--------------------?------X--------------------?------X--------------------?------X---o----------------?------X---o----------------?------X---o----------------?------X---o----------------?------X--------------------?------X---o----------------?------X---o----------------?------X---o----------------?------X---o----------------?------X--------------------?------X---o-----------------------X---o----------------?------X--------------------?------X--------------------?------X--------------------?------X--------------------?------X--------------------?------X--------------------?------X--------------------?------X--------------------?------X--------------------?------X--------------------?------X--------------------?------X---o----------------?------X---o----------------?------X---o----------------?------X---o----------------?------X---o----------------?------X----------------------------------------------------------------------------?------X-------o------------?------X--------------------?------X--------------------?------X---o----------------?----------o----------------?------X---o----------------?------X---o----------------?----------o----------------?----------o----------------?------X---o----------------?----------o----------------?------X--------------------?------X---o----------------?----------o----------------?------X---
----ooo---XXX----ooo---oo--------oo---XXX----So----XX--------o---XXXXo---Xo----XX--------o--XXXXX----Xo----XX--------o--XXXXXo---XX-----?------------XXXXo---SS-S---?------------XXXXo---XS-S---?------------XXXXo---SS-S--o?-------oo----XXXo---SS-S---?--------o----XXXo---SS-S--o?--------o----XXXo---SS-S---?-------------XXXo---SSSS---?-------oo----XXXo---SS-S---?--------o----XXXo---SS-S---?------------XXXXo---XS-S--o?-------o---XXXXXo-------XXXX--------o----XXXo---SS-S---?--------o---XXXXo---SS-S--o?-------oo---XXXXo---Xo----XX-------oo--XXXXXo---XS-----X-------oo--XXXXXo---Xo----XX-------oo--XXXXXo---Xo----XX-------oo--XXXXXo---Xo----XX--------o--XXXXX----Xo----XX--------o---XXXXo---XX-----?--------o--XXXXXo---Xo----o?-------oo--XXXXXo---Xo----XX-----------XXXXXo---XS----o?--------o---XXXXo---SS-S--o?-------------XXXo---SS-S---?-------------XXXo---XS-----?------------XXXXo---SS-S---?--------o----XXXo---XS-----?------------SS-------------------------------------------------ooo---XXX----ooo---oo------XXoo---XXX----ooo---oo-------------XXXo---XSSS---?-------o----XXXXo---XS-S---?-------------XXXXX---SSS---?------------XXXXo---XS-----?-------------XXXo---XSSS---?-------------XXXo---SSSS---?-------------XXXo---SSSS---?-------------XXXX----SSS---?-------------XXXo---SSSS---?-------------XXXo---SSSS---?-------------XXXo---SS-S---?-------------XXXo---XXX----?-------------XXXo---SS-S---?---
-------------------------------XXX-------------------------XXX-------------------------XXX------------------------XXXX-------------------------XXX-----------------------XXXXX------------------------XXXX-------------------------XXX-------------------------XXX-------------------------XXX-------------------------XXX-------------------------XXX-------------------------XXX-------------------------XXX------------------------XXXX-------------------------XXX-------------------------XXX-------------------------XXX-------------------------XXX-------------------------XXX-------------------------XXX-------------------------XXX-------------------------XXX-------------------------XXX-------------------------XXX-------------------------XXX------------------------XXXX-------------------------XXX-------------------------XXX-------------------------XXX-----------------------XXXXX-------------------------XXX-----------------------------------------------------------------------------------------------------------------------------------------XXX-------------------------XXX-----------------------XXXXX------------------------XXXX----------------------XXXXXX-------------------------XXX------------------------XXXX-----------------------XXXXX------------------------XXXX-----------------------XXXXX-------------------------XXX------------------------XXXX------------------------XXXX----------------------
-----------------------------------------------------------------------------------------------------------------------------------------------------------------------------------------------------------------------------------------------------------------------------------------------------------------------------------------------------------------------------------------------------------------------------------------------------------------------------------------------------------------------------------------------------------------------------------------------------------------------------------------------------------------------------------------------------------------------------------------------------------------------------------------------------------------------------------------------------------------------------------------------------------------------------------------------------------------------------------------------------------------E--o---------------------------o-------------------------------------------------------------------------------------------------------------------------------------------------------------------------------------------------------------------------------------------------------------------------------------------------------------------------------------------------------------------------------------------------------
-------------------XXX--------------X--------------------------------------------------------------------------------------------------------------------------------------------------------------------------------------------------------------------------------------------------------------------------------------------------------------------------------------------------------------------------------------------------------------------------------------------------------------------------------------------------------------------------------------------------------------------------------------------------------------------------------------------------------------------------------------------------------------------------------------------------------------------------------------------------------------------------------------------------------------------------------------------------------------------------------------------E---E-----------------E-----E--<>--------------------------------------------------------------------------------------------------------------------------------------------------------------------------------------------------------------------------------------------------------------------------------------------------------------------------------------------------------------------------------------------------------------------------------------
XXX---XXXX--XXXX----XXX--XXXXXXX-------XXXXX----XXXXXXXXXXXX--------XXXXX---XXXXXXXXXXXX--------XXXX----XXXXXXXXXXXX--------XXXXX---XXXXXXXXXXXX---------XXXX---XXXXXXXXXXXX---------XXXX---XXXXXXXXXXXX--------XXXXX---XXXXXXXXXXXX--------XXXXX---XXXXXXXXXXXX--------XXXXX---XXXXXXXXXXXX--------XXXXX---XXXXXXXXXXXX---------XXXX---XXXXXXXXXXXX--------XXXXX---XXXXXXXXXXXX--------XXXXX---XXXXXXXXXXX----------XXXX---XXXXXXXXXXXX---------XXXX---XXXXXXXXXXXX--------XXXXX---XXXXXXXXXXXX--------XXXXX---XXXXXXXXXXXX--------XXXXX---XXXXXXXXXXXX--------XXXXX---XXXXXXXXXXX---------XXXX----XXXXXXXXXXX---------XXXXX---XXXXXXXXXXXX--------XXXXX---XXXXXXXXXXXX--------XXXXX---XXXXXXXXXXXX--------XXXXX---XXXXXXXXXXXX--------XXXXX---XXXXXXXXXXXX--------XXXXX---XXXXXXXXXXXX---------XXXX---XXXXXXXXXXXX--------XXXXX---XXXXXXXXXXXX--------XXXXX---XXXXXXXXXXXX--------XXXXX---XXXXXXXXXXXX---------XXXX---XXXXXXXXXXXX--------XXXXX---XXXXXXXX--------------------<>--<>----------------<>----<>--[]--XXX---XXXX--XXXX----XXX-XXXXXXXX---XX---XXXX----XXXXXXXXXXX----------XXXX---XXXXXXXXXXX----------XXXX---XXXXXXXXXXX----------XXXXX--XXXXXX--XXXX---------XXXX---XXXXXXXXXXX----------XXXX---XXXXXX--XXX----------XXXX---XXXXXX-XXXX----------XXXX---XXXXXXXXXXXX---------XXXX---XXXXXX--XXX---------XXXXX---XXXXXX-XXXX----------XXXX---XXXXXX-XXXX----------XXXX---XXXXXXXXXXX----------XXXX---XXXXX---XXX----------XXXX---XXXXXXXX
------------------------------------------------------------------------------------------------------------------------------------------------------------------------------------------------------------------------------------------------------------------------------------------------------------------------------------------------------------------------------------------------------------------------------------------------------------------------------------------------------------------------------------------------------------------------------------------------------------------------------------------------------------------------------------------------------------------------------------------------------------------------------------------------------------------------------------------------------------------------------------------------------------------------------------------------------------X------------E------[]--[]----------------[]----[]--[]-----------------------------------------------------------------------------------------------------------------------------------------XXXXX-------------------------------------------------------X---------------------------------------------------------------------------------------------------------------X---------------------------------------------------------------------------------XXX----------------------------
-----XX----------oo--------------XX----------oo-------------XXX----------oo--------------XX----------oo-------------XXX----------oo-------------XXXX---------oo-------------XXXX---------oo-------------XXXX---------oo-------------XXXX---------oo-------------XXXX---------oo-------------XXXX---------oo-------------XXXX---------oo-------------XXXX---------oo-------------XXXX---------oo------------XXXXX---------oo-------------XXX-----------o-------------XXXX---------oo-------------XXXX---------oo-------------XXX----------oo-------------XXX----------oo--------------XX----------oo-------------XXX----------oo-------------XXX----------oo-------------XXX----------oo-------------XXX----------oo-------------XXX----------oo-------------XXX----------oo------------XXXX----------oo-------------XXXX----------o-------------XXXX---------oo-------------XXXX---------oo-------------XXXX---------oo-------------XXXX---------oo---------X-------------------[]--[]----------------[]----[]--[]-----XXXX----------oo-------------XXX----------oo------------XXXXX---------oo------------XXXXX---------oo------------XXXXX----------o-------------XXXX---------oo-------------XXXX----------o-------------XXXX----------o-------------XXXX----------o-------------XXXX----------o------------XXXXX----------o-------------XXXX----------o------------XXXXX----------o-------------XXXX----------o------------XXXXX----------o---------
XXXXX------------XXX-----------------XXX----XXXX-----------------XXXX---XXXX-----------X-----XXXX--XXXXX-----------------XXXXXXXXXXX------------------XXX---XXXX-----------------XXXX---XXXX-----------------XXXX---XXXX-----------------XXXX---XXXX------------------XXX---XXXX-----------------XXXX---XXXX------------------XXX---XXXX------------------XXX---XXXX-----------------XXXX---XXXX------------------XXX---XXXX------------------XXXXXXXXXX-----------------XXXX---XXXX-----------------XXXX---XXXX-----------------XXXX---XXXX-----------X-----XXXXXXXXXXX-----------------XXXXXXXXXXX-----------------XXXXXXXXXXX-----------------XXXX--XXXXX-----------------XXXX--XXXXX-----------------XXXX--XXXXX-----------------XXXX--XXXXX-----------------XXXX--XXXXX-----------------XXXX---XXXX-----------------XXXX---XXXX-----------------XXXX---XXXX-----------------XXXX---XXXX------------------XXX---XXXX-----------------XXXX---XXXX--------X----EE-E--------E--[]--[]--------E-EE----[]-E--[]--[]--XXXX------------XXXX------------------------XXXX------------------XX----XXXX------------------XXX---XXXX------------------XXX---XXXX------------------XX----XXXX------------------XXX---XXXX------------------XXX---XXXX------------------------XXXX------------------XXX---XXXX------------------XXX---XXXX------------------XXX---XXXX------------------XX----XXXX------------------XXX---XXXX------------------XXX---XXXX--------
------------------------------------------------------------------------------------------------------------------------------------------------------------------------------------------------------------------------------------------------------------------------------------------------------------------------------------------------------------------------------------------------------------------------------------------------------------------------------------------------------------------------------------------------------------------------------------------------------------------------------------------------------------------------------------------------------------------------------------------------------------------------------------------------------------------------------------------------------------------------------------------------------------------------------------------------------------XXXXXXXXXXXXXXXXXX--XX--XX--XXXXXXXXXXXXXXXXXXX-XX--XX--------------------------------------------------------------------------------------------------------------------------------------------------------------------------------------------------------------------------------------------------------------------------------------------------------------------------------------------------------------------------------------------------------------------------------------
