--------------------------------------------------------------------------------------------------------------------------------------------------------------------------------------------------------------------------------------------------------------------------------------------------------------------------------------------------------------------------------------------------------------------------------------------------------------------------------------------------------------------------------------------------------------------------------------------------------------------------------------------------------------------------------------------------------------------------------------------------------------------------------------------------------------------------------------------------------------------------------------------------------------------------------------------------------------------------------------------------------------------------------------------------------------------------------------------------------------------------------------------------------------------------------------------------------------------------------------------------------------------------------------------------------------------------------------------------------------------------------------------------------------------------------------------------------
--------------------------------------------------------------------------------------------------------------------------------------------------------------------------------------------------------------------------------------------------------------------------------------------------------------------------------------------------------------------------------------------------------------------------------------------------------------------------------------------------------------------------------------------------------------------------------------------------------------------------------------------------------------------------------------------------------------------------------------------------------------------------------------------------------------------------------------------------------------------------------------------------------------------------------------------------------------------------------------------------------------------------------------------------------------------------------------------------------------------------------------------------------------------------------------------------------------------------------------------------------------------------------------------------------------------------------------------------------------------------------------------------------------------------------------------------------
SSSSSSSSSSSSSSSSSSSSSSSSSSSS-------------------------------------------------------------------------------------------------------S-S------S------------SSSSSSSSSSSS-SS-------------SSSSSSSSSSSS-SSS------------SSSSSSSSSSSS-SSSSSSSSSS---SSSSSSSSSSSSSSSSS--------------------------------------------------------------------------------------------------------------------------------------------------------------------------------------------------------------------------------------------------------------------------------------------------------------------------------------------------------------------------------------------------------------------------------------------------------------------------------------------------------------------------------------------------------------------------------------------------------------------------------------------------------------------------------------------------------------------------------------------------------------------------------------------------------------------------------------------------------------------------------------------------------------------------------------------------------------------------------------------------------------------------------------------------------------------------------------------------------------------------------------------------------------------------------------------
----------------------------------------------------------------------------------------------------------------------------------------------------------------------------------------------------------------------------------------------------------------------------------------------------------------------------------------------------------------------------------------------------------------------------------------------------------------------------------------------------------------------------------------------------------------------------------------------------------------------------------------------------------------------------------------------------------------------------------------------------------------------------------------------------------------------------------------------------------------------------------------------------------------------------------------------------------------------------------------------------------------------------------------------------------------------?---------------------------------------------------------------------------------------------------------------------------------------------------------------------------------------------------------------------------------------------------------------------------------------------------------------------------------------------------------------------------------
---------------------------------------------------------------------------------------------------------------------------------------------------------------------------------------------------------------------------------------------------------------Eoo---------------------------------------?------X---o----------------?------X--------------------?------X---o----------------?------X---o----------------?------X---o----------------?------X---o----------------?------X--------------------?------X--------------------?------X--------------------?------X--------------------?------X--------------------?------X--------------------?------X--------------------?------X--------------------?------X--------------------?------X--------------------?------X--------------------?------X--------------------?------X---o----------------?------X--------------------?------X---o----------------?------X--------------------?------X----------------------------------------------------------------------------?------X--------------------?------X--------------------?----------o----------------?------X---o----------------?----------o----------------?------X---o----------------?------X---o----------------?------X---o----------------?----------o----------------?----------o----------------?----------o----------------?----------o----------------?------X---o----------------?------X---o---------------------------
---------------------------------------------------------------------------------------------------------------------------------------------------------------------------------------------------------------------------------------------------------------XXXX---XXX----ooo---oo-------Xoo---XXX----ooo---oo-------------XXXo---SS----o?-------oo---XXXXo---XS----o?--------o---XXXXo---SS-S---?-------------XXXo---SS-S---?-------------XXXo---SSSS---?------------XXXXo---XS-----?-------oo---XXXXo---Xo----oX-------oo--XXXXXo---Xo----XX-------oo--XXXXXo---Xo----XX-------oo--XXXXXo---Xo----XX-------oo--XXXXXo---Xo-----?--------o--XXXXX----Xo----XX--------o--XXXXX----Xo-----X--------o--XXXXX----Xo----XX-------oo---XXXXo---Xo-----?--------o---XXXXo---XS-----?--------o---XXXXo---XS----o?--------o---XXXXo---XS-----?-------------XXXo----S-S---?------------XXXXo---SS-S--o?-------------XXXo---SS-S---?-------oo--XXXXX----Xo----XX-----------SSSSSS----------------------------------------------ooo---XXX----Xoo---oo--------oo---XXX----oo----XX-------------XXXXX---SSS---?-------------XXXo---SS-S---?-------------XXXXX---SSS---?-------------XXXo---SS-S---?-------------XXXo---SSSS---?-------------XXXo---SSSS---?-------------XXXXX---SSS---?-------------XXXXX---SSS---?-------------XXXX---XXSS---?-------------XXXXX---SSS---?-------------XXXX---XXS----?-------------XXXo---SSSS---?-------------XXXXX---S-S---?---
-----------------------------------------------------------------------------------------------------------------------------------------------------------------------------------------------------------------------------------------------------------------------------------------------------------------------XXX-------------------------XXX-------------------------XXX-----------------------XXXXX------------------------XXXX------------------------XXXX-------------------------XXX-------------------------XXX-------------------------XXX-------------------------XXX-------------------------XXX-------------------------XXX-------------------------XXX-------------------------XXX-------------------------XXX-------------------------XXX-------------------------XXX-------------------------XXX------------------------XXXX-------------------------XXX------------------------XXXX-------------------------XXX----------------------------------------------------------------------------------------------------------------------------------------XXXX-------------------------XXX------------------------XXXX-------------------------XXX-------------------------XXX------------------------XXXX------------------------XXXX------------------------XXXX------------------------XXXX------------------------XXXX------------------------XXXX-------------------------XXX------------------------XXXX----------------------
-------------------------E---------------------------E---------------------------E---------------------------E---------------------------E---------------------------E---------------------------E---------------------------E-----------------------------------------------------------------------------------------------------------------------------------------------------------------------------------------------------------------------------------------------------------------------------------------------------------------------------------------------------------------------------------------------------------------------------------------------------------------------------------------------------------------------------------------------------------------------------------------------------------------------------------------------------------------------------------------------------------------------------------------------------------------------------------E--------------------------------------------------------------------------------------------------------------------------------------------------------------------------------------------------------------------------------------------------------------------------------------------------------------------------XXXXX-------------------------------------------------------------------------------------------------------
---------------E--S--E--<>-----------------E--S--E--<>-----------------E--S--E--<>--------------------S--E--<>-----------------E--S--E--<>-----------------E--S--E--<>-----------------E--S--E--<>-----------------E--S--E--<>--------------------S--E---E-----------------------------------------------------------------------------------------------------------------------------------------------------------------------------------------------------------------------------------------------------------------------------------------------------------------------------------------------------------------------------------------------------------------------------------------------------------------------------------------------------------------------------------------------------------------------------------------------------------------------------------------------------------------------------------------------------------------------E---E-----------------E-----E--<>--------------------------------------------------------------------------------------------------------------------------------------------------------------------------------------------------------------------------------------------------------------------------------------------------------------------------------------------------------------------------------------------------------------------------------------
--------SQS---<>----<>--[]----------------<>----<>--[]----------------<>----<>--[]-----------------E----<>--[]----------------<>----<>--[]----------------<>----<>--[]----------------<>----<>--[]----------------<>----<>--[]-----------------E----<>--<>--XXX---XXXX--XXXX---XXXX-XXXXXXXXX--XXX-XXXXX----XXXXXXXXXXXX--------XXXXX---XXXXXXXXXXXX---------XXXX---XXXXXXXXXXXX--------XXXXX---XXXXXXXXXXXX--------XXXXX---XXXXXXXXXXXX---------XXXX---XXXXXXXXXXXX---------XXXX---XXXXXXXXXXXX--------XXXXX---XXXXXXXXXXXX----X---XXXX----XXXXXXXXXXXX--------XXXXX---XXXXXXXXXXXX--------XXXXX---XXXXXXXXXXX----------XXXX---XXXXXXXXXXXX--------XXXX----XXXXXXXXXXXX--------XXXXX---XXXXXXXXXXXX--------XXXX----XXXXXXXXXXXX--------XXXXX---XXXXXXXXXXXX--------XXXXX---XXXXXXXXXXXX--------XXXXX---XXXXXXXXXXXX--------XXXXX---XXXXXXXXXXXX---------XXXX---XXXXXXXXXXXX---------XXXX---XXXXXXXXXXXX--------XXXXX---XXXXXXXXXXXX--------XXXXX---XXXXXXXX---------E----------<>--<>----------------<>----<>--[]--XXX----XXX--XXXX----XXXX-XXXXXXX-----X-XXXXX----XXXXXXXXXXX----------XXXX---XXXXXX--XXXX--------XXXXX---XXXXXXXXXXX----------XXXX---XXXXXX--XXX---------XXXXX---XXXXXXXXXXXX---------XXXX---XXXXXXXXXXX----------XXXX---XXXXXXXXXXX----------XXXX---XXXXXX--XXX----------XXXX---XXXXXX--XXX----------XXXX---XXXX----XXX-----------XXX---XXXXXX--XXX----------XXXX---XXXXXX--XXX---------XXXXX---XXXXXXXXXXX----------XXXX---XXXXXX-X
--------------[]----[]--[]----------------[]----[]--[]----------------[]----[]--[]----------------<>----[]--[]----------------[]----[]--[]----------------[]----[]--[]----------------[]----[]--[]----------------[]----[]--[]----------------<>----[]--[]---------------------------------------------------------------------------------XXX-X-------------------------------------------------------------------------------------------------------------------------------------------X------------------------------------------------------------------------------------------------------------------------------------------------------------------------------------------------------------------------------------------------------------------------------------------------------------------------------------------------------------------------XXXX-------------------------------------------------------X------------------------------------<>----------[]--[]----------------[]----[]--[]---------------------------------------------------------------------------------------------------------------------------------------------------------------------------------------------------------------------------------------------------------------------------------------XXX-------------------------XXX----------------------------------------------------------------------------------------------------------------
--------------[]----[]--[]----------------[]----[]--[]----------------[]----[]--[]----------------[]----[]--[]----------------[]----[]--[]----------------[]----[]--[]----------------[]----[]--[]----------------[]----[]--[]----------------[]----[]--[]-----XXXX--------------------------------------oo-------------XXXX---------oo-------------XXX----------oo-------------XXXX---------oo-------------XXXX---------oo-------------XXXX----------o-------------XXXX---------oo-------------XXX----------oo--------------XX----------oo--------------XX----------oo--------------XX----------oo-------------XXX----------oo--------------XX----------oo--------------XX----------oo--------------XX----------oo-------------XXX----------oo-------------XXX----------oo-------------XXX----------oo-------------XXX----------oo-------------XXXX----------o-------------XXXX---------oo-------------XXXX----------o-------------XXX----------oo-----------------[]----<>----[]--[]----------------[]----[]--[]-------XX----------oo--------------XX----------oo------------XXXXX----------o-------------XXXX---------oo-------------XXXX----------o------------XXXXX----------o-------------XXXX---------oo------------XXXXX----------o------------XXXXX----------o-------------XXXX----------o-------------XXXX----------o-----XXX-----XXXX----------o-------XX---XXXXX----------o-------X----XXXXX----------o-------------XXXX----------o---------
------E-E-----[]-E--[]--[]-------EE-E--E--[]-E--[]--[]-----E-EE-EE-E--[]-E--[]--[]-----E-EE-EE-E--[]-E--[]--[]-----E-EE-EE-E--[]-E--[]--[]-----E-EE-EE-E--[]-E--[]--[]-----E-EE-EE-E--[]-E--[]--[]-----E-EE-EE-E--[]-E--[]--[]-----E-EE-EE-E--[]-E--[]--[]-------------------XX-----------XXX-----------XXXX------------------XX----XXXX-----------------XXXX---XXXX-----------------XXXX---XXXX------------------XXX---XXXX------------------XXX---XXXX------------------XXX---XXXX-----------------XXXX---XXXX-----------X-----XXXX-XXXXXX-----------------XXXXXXXXXXX-----------------XXXX-XXXXXX-----------------XXXX---XXXX-----------X-----XXXX--XXXXX-----------------XXXX--XXXXX----------XXX----XXXX--XXXXX-----------------XXXX---XXXX-----------------XXXX---XXXX-----------------XXXX---XXXX-----------------XXXX---XXXX------------------XXX---XXXX------------------XX----XXXX------------------XXX---XXXX-----------------XXXX--XXXXX-----------E-EE-[]-E--[]-E--[]--[]--------E-EE----[]-E--[]--[]--XXXXX-----------XXXX----------XXX----XX-----XXXX------------------XX----XXXX------------------XXX---XXXX------------------XXX---XXXX------------------XXX---XXXX------------------XXX---XXXX------------------XX----XXXX------------------XXX---XXXX------------------XX----XXXX------------------------XXXX------------------XX----XXXX-------------------X----XXXX------------------XXX---XXXX------------------XXX---XXXX--------
-XXXXXXXXXXXXXXXXXX-XX--XX---XXXXXXXXXXXXXXXXX--XX--XX---XXXXXXXXXXXXXXXXX--XX--XX---XXXXXXXXXXXXXXXXX--XX--XX---XXXXXXXXXXXXXXXXX--XX--XX---XXXXXXXXXXXXXXXXX--XX--XX---XXXXXXXXXXXXXXXXX--XX--XX---XXXXXXXXXXXXXXXXX--XX--XX---XXXXXXXXXXXXXXXXX--XX--XX---------------------------------------------------------------------------------------------------------------------------------------------------------------------------------------------------------------------------------------------------------------------------------------------------------------------------------------------------------------------------------------------------------------------------------------------------------------------------------------------------------------------------------------------------------------------------------------------------------------------------------------------------------------------------------------------------XXXXXXXXXXXXXXXXX--XX--XXX--XXXXXXXXXXXXXXXXXX-XX--XX--------------------------------------------------------------------------------------------------------------------------------------------------------------------------------------------------------------------------------------------------------------------------------------------------------------------------------------------------------------------------------------------------------------------------------------
