--------------------------------------------------------------------------------------------------------------------------------------------------------------------------------------------------------------------------------------------------------------------------------------------------------------------------------------------------------------------------------------------------------------------------------------------------------------------------------------------------------------------------------------------------------------------------------------------------------------------------------------------------------------------------------------------------------------------------------------------------------------------------------------------------------------------------------------------------------------------------------------------------------------------------------------------------------------------------------------------------------------------------------------------------------------------------------------------------------------------------------------------------------------------------------------------------------------------------------------------------------------------------------------------------------------------------------------------------------------------------------------------------------------------------------------------------------
--------------------------------------------------------------------------------------------------------------------------------------------------------------------------------------------------------------------------------------------------------------------------------------------------------------------------------------------------------------------------------------------------------------------------------------------------------------------------------------------------------------------------------------------------------------------------------------------------------------------------------------------------------------------------------------------------------------------------------------------------------------------------------------------------------------------------------------------------------------------------------------------------------------------------------------------------------------------------------------------------------------------------------------------------------------------------------------------------------------------------------------------------------------------------------------------------------------------------------------------------------------------------------------------------------------------------------------------------------------------------------------------------------------------------------------------------------
--------------------------------------------------------------------------SSSSSSS-SS-------------------SSSSS------------------SSSSSSSSSSS-SS-----------------------------------------------SSSSS-----------------------SSS------SSSSSSSSS-SSSSSSSSSSSSSSSSSSSSSSSSS----SSSSSS-SSSSSSS-SS--------------------------------------------------------------------------------------------------------------------------------------------------------------------------------------------------------------------------------------------------------------------------------------------------------------------------------------------------------------------------------------------------------------------------------------------------------------------------------------------------------------------------------------------------------------------------------------------------------------------------------------------------------------------------------------------------------------------------------------------------o----------------------------?S-------------------------------------------------------------------------------------------------------------------------------------------------------------------------------------------------------------------------------------------------------------------------------------------------------------------------------------------------------------------------------
------------------------------------------------------------------------------------------------------------------------------------------------------------------------------------------------------------------------------------------------------------------------------------------------------------------------------------------?-------------------------------------------------------------------------------------------------------------------------------------------------------------------------------------------------------------------------------------------------------------------------------------------------------------------------------------------------------------------------------------------------------------------------------------------------------------------------------------------------------------------------------------------------------------------------------------------------------------------------------------------------------------------------------------------------------------------------------------------------------------------------------------------------------------------------------------------------------------------------------------------------------------------------------------------------------------------------------------------------------------------------------------------------------------------------------------------------------------
---------------------------------------------------------------------------------------------------------------------------------------------------------------------------------------------------------------------------------------------------------------------------------------------------------?------X--------------------?------X--------------------?------X--------------------?------X---o----------------?------X---o----------------?------X---o----------------?------X--------------------?------X--------------------?------X--------------------?------X--------------------?------X--------------------?------X---o----------------?------X--------------------?------X--------------------?------X--------------------?------X--------------------?------X--------------------?------X--------------------?------X---o----------------?------X---o----------------?------X---o----------------?------X--------------------?------X----------------------------------------------------------------------------?------X--------------------?-----XX---o----------------?------X---o----------------?------X---o----------------?------X---o----------------?------X-------------------------------o----------------?------X---o----------------?------X---o----------------?------X---o----------------?------X---o----------------?------X---o----------------?------X---o----------------?------X---o----------------?------X---
--------------------------------------------------------------------------------------------------------------------------------------------------------------------------------------------------------------------------------------------------------------------------------------------ooo--XXXX----ooo---Xo--------oo---XXX----oo----oo--------o----XXXo---SS-S---?-------oo----XXXo---SS-S--o?-------------XXXo---SS-S---?--------o----XXXo---SS-S---?--------o---XXXXo---SS-S---?--------o---XXXXo---XS----XX-------oo--XXXXXo---Xo----XX--------o---XXXX----Xo----XX-------oo---XXXXo---XS-----?--------o--XXXXX----XX----XX-------oo--XXXXXo---XS-----?--------o--XXXXXo---Xo----o?-------oo--XXXXXo---XS-----X-------oo--XXXXXo---Xo----o?-------oo---XXXXo---XS----o?--------o---XXXXo---XS-----?------------XXXXo---XS----o?--------o----XXXo---SS-S---?---E--------XXXXo---SS-S--o?-------------XXXo---SS-S---?-------oo--XXXXXo---Xo----XX-----------SSS-------------------------------------------------ooo--XXXX----Xoo---oo------XXoo---XXX----ooo---oo-------------XXXo---SS-S---?-------------XXXo---SS-S---?-------------XXXo---XX-----?-------------XXXX---SSSS---?-------------XXXXX---SSS---?-------------XXXo---SSSS---?-------------XXXo---XSSS---?-------------XXXo----SSS---?-------------XXXo---SSSS---?-------------XXXXX---SSS---?-------------XXXo---SSSS---?-------------XXXX---XXS----?-------------XXXo---SSSS---?---
---------------------------------------------------------------------------------------------------------------------------------------------------------------------------------------------------------------------------------------------------------------------------------------------------------------------------------------------------XXX--------------------------XX-------------------------XXX-------------------------XXX-------------------------XXX-------------------------XXX-------------------------XXX-------------------------XXX-------------------------XXX-------------------------XXX-------------------------XXX-------------------------XXX-------------------------XXX-------------------------XXX-------------------------XXX-------------------------XXX-------------------------XXX-------------------------XXX----------------------XXXXXX-------------------------XXX-------------------------XXX-----------------------------------------------------------------------------------------------------------------------------------------XXX-------------------------XXX------------------------XXXX----------------------XXXXXX-----------------------XXXXX------------------------XXXX------------------------XXXX------------------------XXXX-----------------------XXXXX------------------------XXXX-------------------------XXX------------------------XXXX-----------------------XXXXX----------------------
-----------------------------------------------------E---------------------------E---------------------------E---------------------------E---------------------------E---------------------------E-------------------------------------------------------E----------------------------------------------------------o--------------------------------------------------------------------------------------------------------------------------------------------------------------------------------------------------------------------------------------------------------------------------------------------------------------------------------------------------------------------------------------------------------------------------------------------------------------------------------------------------------------------------------------------------------------------------------------------------------------------------------------------------------------------------------------------E------------------------------o-------------------------------------------------------------------------------------------------------------------------------------------------------------------------------------------------------------------------------------------------------------------------------------------------------------------------------------------------------------------------------------------------------
---------------------E---E-----------------E--S--E--<>-----------------E--S--E--<>-----------------E--S--E--<>--------------------S--E--<>-----------------------E--<>-----------------E--S--E--<>-----------------E--S--E--<>-----------------E--S--E--<>-----------------E-----E-------------------------XX-----------------------------------------------------------------------------------------------------------------------------------------------------------------------------------------------------------------------------------------------------------X--------------------------------------------------------------------------------------------------------------------------------------------------------------------------------------------------------------------------------------------------------------------------------------------------------------------------------------------------------------------------------------------E--E--------E---E-----------------------E--<>------------------------------E-------------------------------------------------------------------------------------------------------------------------------------------------------------------------------------------------------------------------------------------------------------------------------------------------------------------------------------------------------------------------------------------------------
--------------------<>--<>----------------<>----<>--[]----------------<>----<>--[]----------------<>----<>--[]-----------------E----<>--[]-----------------E----<>--[]----------------<>----<>--[]----------------<>----<>--[]----------------<>----<>--[]----------------<>----<>---E--XXX---XXXXXXXXXX----XXX--XXXXXXX--------XXXX----XXXXXXXXXXXX--------XXXXX---XXXXXXXXXXXX--------XXXXX---XXXXXXXXXXXX--------XXXXX---XXXXXXXXXXXX--------XXXXX---XXXXXXXXXXXX--------XXXXX---XXXXXXXXXXXX--------XXXXX---XXXXXXXXXXXX----X---XXXX----XXXXXXXXXXXX--------XXXX----XXXXXXXXXXXX--------XXXXX---XXXXXXXXXXXX--------XXXXX---XXXXXXXXXXXX--------XXXXX---XXXXXXXXXXXX--------XXXXX---XXXXXXXXXXXX--------XXXXX---XXXXXXXXXXXX--------XXXXX---XXXXXXXXXXXX--------XXXXX---XXXXXXXXXXXX--------XXXXX---XXXXXXXXXXXX--------XXXXX---XXXXXXXXXXXX--------XXXXX---XXXXXXXXXXXX---------XXXX---XXXXXXXXXXXX--------XXXXX---XXXXXXXXXXX---------XXXXX---XXXXXXXX--------<>-----E----<>--<>----------------E-----<>--[]--XXX---XXXX--XXXX----XXXXXXXXXXXX--XXXX--XXXX----XXXXXXXXXXXX---------XXXX---XXXXXXXXXXXX---------XXXX---XXXXXXXXXXX---------XXXXX---XXXXXX-XXXXX---------XXXX---XXXXXX--XXX----------XXXX---XXXXXXXXXXX---------XXXXX---XXXXXX-XXXX----------XXXX---XXXXXX-XXXX----------XXXX---XXXXXX--XXX----------XXXX---XXXXXX--XXX----------XXXX---XXXXXX--XXXX---------XXXX---XXXXXXXXXXX----------XXXX---XXXXXX--XXX----------XXXX---XXXXXX-X
------------------E-[]--[]----------------[]----[]--[]----------------[]----[]--[]----------------[]----[]--[]----------------<>----[]--[]----------------<>----[]--[]----------------[]----[]--[]----------------[]----[]--[]----------------[]----[]--[]----------------[]----[]--<>------------------------------------------------------------------------------------------------------------------------------------------------------------------------------------------------------------------------------------------------------------------------------------------------------------------------------------------------------------------------------------------------------------------------------------------------------------------------------------------------------------------------------------------------------------------------------------------------------------------------------------------------------------------------------[]----<>----[]--[]-----------------E----[]--[]-------------------------------------------------------------------------------------X-----------------------------------------------------------------------------------X------------------------XX-X---------------------------X-----------------------------------------------------------------------------------X-------------------------X-X-------------------------------------------------------------------------------XXXXX
-----------------<>-[]--[]----------------[]----[]--[]----------------[]----[]--[]----------------[]----[]--[]----------------[]----[]--[]----------------[]----[]--[]----------------[]----[]--[]----------------[]----[]--[]----------------[]----[]--[]----------------[]----[]--[]-------------------oo--------------XX----------oo-------------XXXX---------oo-------------XXXX---------oo-------------XXXX---------oo-------------XXXX---------oo-------------XXXX---------oo-------------XXX----------oo--------------XX----------oo--------------XX----------oo-------------XXX----------oo-------------XXX----------oo--------------XX----------oo-------------XXX----------oo-------------XXX----------oo-------------XXX----------oo-------------XXXX---------oo-------------XXX----------oo-------------XXXX---------oo-------------XXXX---------oo-------------XXXX----------o-------------XXXX---------oo--------------XX----------oo-----------------[]----[]----[]--[]----------------<>----[]--[]-------XX----------oo--------------------------oo-------------XXXX---------oo-------------XXXX---------oo------------XXXXX---------oo-------------XXXX----------o-------------XXXX----------o------------XXXXX----------o------------XXXXX----------o------------XXXXX----------o-------------XXXX----------o------------XXXXX----------o-------------XXXX---------oo-----------XXXXXX----------o------------XXXXX----------o---------
-----EE-EE-E--EE-[]-[]--[]-------EE-EE-E--[]-E--[]--[]-----E-EE-EE-E--[]-E--[]--[]-----E-EE-EE-E--[]-E--[]--[]-----E-EE-EE-E--[]-E--[]--[]-----E-EE-EE-E--[]-E--[]--[]-----E-EE-EE-E--[]-E--[]--[]-----E-EE-EE-E--[]-E--[]--[]-----E-EE-EE-E--[]-E--[]--[]--------E-EE----[]-X--[]--[]--XXXXX-----------XXXX----------XXX-----X-----XXXX-----------------XXXX---XXXX------------------XXX---XXXX-----------------XXXX---XXXX-----------------XXXX---XXXX-----------------XXXX---XXXX-----------------XXXX---XXXX----------XX-----XXXX-XXXXXX----------XXX----XXXX--XXXXX-----------------XXXX---XXXX-----------X-----XXXX--XXXXX----------XXX---XXXXX---XXXX-----------------XXXX---XXXX-----------------XXXXXXXXXXX-----------------XXXX---XXXX-----------------XXXX---XXXX-----------------XXXX---XXXX-----------------XXXX---XXXX-----------------XXXX---XXXX------------------XXX---XXXX-----------------XXXX---XXXX-----------------XXXXXXXXXXX-----------E-E--[]----[]-E--[]--[]-------EE-EE-E--[]-E--[]--[]--XXXXX-----------XXXX----------XXX-----------XXXX------------------XX----XXXX------------------XXX---XXXX------------------XXX---XXXX------------------XX----XXXX------------------XXX---XXXX------------------XXX---XXXX------------------XXX---XXXX------------------XXX---XXXX------------------XXX---XXXX------------------XXX---XXXX------------------XX----XXXX------------------XXX---XXXX------------------XXX---XXXX--------
-XXXXXXXXXXXXXXXXXXXXX--XX---XXXXXXXXXXXXXXXXX--XX--XX---XXXXXXXXXXXXXXXXX--XX--XX---XXXXXXXXXXXXXXXXX--XX--XX---XXXXXXXXXXXXXXXXX--XX--XX---XXXXXXXXXXXXXXXXX--XX--XX---XXXXXXXXXXXXXXXXX--XX--XX---XXXXXXXXXXXXXXXXX--XX--XX---XXXXXXXXXXXXXXXXXX-XX--XX---XXXXXXXXXXXXXXXXXXXXX--XX-----------------------------------------------------------------------------------------------------------------------------------------------------------------------------------------------------------------------------------------------------------------------------------------------------------------------------------------------------------------------------------------------------------------------------------------------------------------------------------------------------------------------------------------------------------------------------------------------------------------------------------------------------------------------XXXXXXXXXXXXXXXXXX-XX--XXX--XXXXXXXXXXXXXXXXXX-XX--XX--------------------------------------------------------------------------------------------------------------------------------------------------------------------------------------------------------------------------------------------------------------------------------------------------------------------------------------------------------------------------------------------------------------------------------------
