--------------------------------------------------------------------------------------------------------------------------------------------------------------------------------------------------------------------------------------------------------------------------------------------------------------------------------------------------------------------------------------------------------------------------------------------------------------------------------------------------------------------------------------------------------------------------------------------------------------------------------------------------------------------------------------------------------------------------------------------------------------------------------------------------------------------------------------------------------------------------------------------------------------------------------------------------------------------------------------------------------------------------------------------------------------------------------------------------------------------------------------------------------------------------------------------------------------------------------------------------------------------------------------------------------------------------------------------------------------------------------------------------------------------------------------------------------
--------------------------------------------------------------------------------------------------------------------------------------------------------------------------------------------------------------------------------------------------------------------------------------------------------------------------------------------------------------------------------------------------------------------------------------------------------------------------------------------------------------------------------------------------------------------------------------------------------------------------------------------------------------------------------------------------------------------------------------------------------------------------------------------------------------------------------------------------------------------------------------------------------------------------------------------------------------------------------------------------------------------------------------------------------------------------------------------------------------------------------------------------------------------------------------------------------------------------------------------------------------------------------------------------------------------------------------------------------------------------------------------------------------------------------------------------------
SSSSSSSSSSSSSSSSSSSSSSSSSSSS---------------------------------------------------------------------------S-S-------------------------S-S--------------------SS-SSSSSSSS-SS-------------------SSSSS------------------S--SSSSSSSS-SS-------------------SSSSS---SSSSS---------SSSSSSSSSSSS-SSSSSS-------SSSSSSSSSSSSSSSSS------------------------------------------------------------------------------------------------------------------------------------------------------------------------------------------------------------------------------------------------------------------------------------------------------------------------------------------------------------------------------------------------------------------------------------------------------------------------------------------------------------------------------------------------------------------------------------------------------------------------------------------------------------------------------------------------------------------------------------------------------------------------------------------------------------------------------------------------------------------------------------------------------------------------------------------------------------------------------------------------------------------------------------------------------------------------------------------------------------------------------------
----------------------------------------------------------------------------------------------------------------------------------------------------------------------------------------------------------------------------------------------------------------------------------------------------------------------------------------------------------------------?---------------------------------------------------------------------------------------------------------------------------------------------------------------------------------------------------------------------------------------------------------------------------------------------------------------------------------------------------------------------------------------------------------------------------------------------------------------------------------------------------------------------------------------------------------------------------------------------------------------------------------------------------------------------------------------------------------------------------------------------------------------------------------------------------------------------------------------------------------------------------------------------------------------------------------------------------------------------------------------------------------------------------------------------------------------------------------
-------------------------------------------------------------------------------------------------------------------------------------------------------------------------------------------------------------------------------------------------------------------------------------------------------------------------------------?------X--------------------?------X--------------------?------X---o----------------?------X---o----------------?------X--------------------?------X--------------------?------X--------------------?------X--------------------?------X--------------------?------X--------------------?------X--------------------?------X--------------------?------X--------------------?------X--------------------?------X---o----------------?------X--------------------?------X--------------------?------X--------------------?------X---o----------------?------X---o----------------?------X--------------------?------X----------------------------------------------------------------------------?------X--------------------?------X---o----------------?------X---o----------------?------X---o----------------?------X---o----------------?------X---o----------------?------X---o----------------?----------o----------------?------X---o----------------?------X---o----------------?----------o----------------?------X--------------------?------X---o----------------?------X--------------------?----------
------------------------------------------------------------------------------------------------------------------------------------------------------------------------------------------------------------------------------------------------------------------------------------------------------------------------ooo---XXX----Xoo---oo-------Xoo---XXX----ooo---oX--------o---XXXXo---SS-S--o?------------XXXXo---XS----o?-------oo---XXXXo---SS-S--o?--------o---XXXXo---XS-----?--------o--XXXXXo---Xo----XX--------o--XXXXXo---Xo----X?-------oo---XXXXo---XS-----X-------oo--XXXXXo---Xo----XX--------o---XXXX----Xo----XX-------oo--XXXXXo---Xo----XX--------o--XXXXX----XX----XX--------o--XXXXXo---Xo----XX--------o--XXXXXo---XS----o?--------o---XXXXo---XS-----?--------o---XXXXo---XS----o?--------o----XXXo---SS----o?--------o---XXXXo---SS----o?-------------XXXo---SS-S---?-------------XXXo---SS-S---?-------oo--XXXXXo---Xo----XX------------SS------------------------------------------------Xooo---XXX----ooo---oo-------ooo---XXX----Xo----o?-------------XXXo----SSS---?-------------XXXo----S-S---?------------XXXXo---SS-S--o?-------------XXXo---XS-----?-------------XXXo---SSSS---?-------------XXXo---XXSS---?-------------XXXo---SSSS---?-------oo----XXXo---SSSS---?-------------XXXXX--SSSS---?------------XXXXo---SS-S--o?------------XXXXo---SS-S---?-------------XXXo---SSSS---?-------------XXXo----SSS---?---
-------------------------------------------------------------------------------------------------------------------------------------------------------------------------------------------------------------------------------------------------------------------------------------------------------------------------------------------------------------------------------XXX------------------------XXXX-------------------------XXX-------------------------XXX-------------------------XXX-------------------------XXX-------------------------XXX-------------------------XXX-------------------------XXX-------------------------XXX-------------------------XXX------------------------XXXX-------------------------XXX-------------------------XXX-------------------------XXX-------------------------XXX-------------------------XXX-----------------------XXXXX-----------------------XXXXX-------------------------XXX-----------------------------------------------------------------------------------------------------------------------------------------XXX------------------------XXXX------------------------XXXX------------------------XXXX----------------------XXXXXX-----------------------XXXXX----------------------XXXXXX-------------------------XXX------------------------XXXX-------------------------XXX------------------------XXXX-------------------------XXX------------------------XXXX----------------------
-------------------------E---------------------------E---------------------------E---------------------------E---------------------------E---------------------------E---------------------------E---------------------------E---------------------------E---------------------------E----------------------------------------------------------o----------------------------------------------------------------------------------------------------------------------------------------------------------------------------------------------------------------------------------------------------------------------------------------------------------------------------------------------------------------------------------------------------------------------------------------------------------------------------------------------------------------------------------------------------------------------------------------------------------------------------------------------------------------E--o-----------------------------------------------------------------------------------------------------------------------------------------------------------------------------------------------------------------------------------------------------------------------------------------------------------------------------------------------------------------------------------------------------------------------------------
---------------E-----E--<>-----------------------E--<>-----------------E--S--E--<>--------------------S--E--<>--------------------S--E--<>-----------------E--S--E--<>--------------------S--E--<>-----------------E--S--E--<>--------------------S--E--<>--------------------S--E--<>-----------------E--S--E---E--------------------------------------------------X------------------------------------------------------------------------------------------------------------------------------------------------------------------------------------------------------------------------------------------------------------------------------------------------------------------------------------------------------------------------------------------------------------------------------------------------------------------------------------------------------------------------------------------------------------------------------------------------------------E---E-----------------------E--<>----------------------X---------------------------------------------------------------------------------------------------------------------------------------------------------------------------------------------------------------------------------------------------------------------------------------------------------------------------------------------------------------------------------------------------------------
--------SQS---<>----<>--[]-----------------E----<>--[]----------------<>----<>--[]-----------------E----<>--[]-----------------E----<>--[]----------------<>----<>--[]-----------------E----<>--[]----------------<>----<>--[]-----------------E----<>--[]-----------------E----<>--[]----------------<>----<>--<>--XXX----XXX--XXXX---XXXX--XXXXXXX---XXX-XXXXX----XXXXXXXXXXXX---------XXXX---XXXXXXXXXXXX--------XXXXX---XXXXXXXXXXXX---------XXXX---XXXXXXXXXXXX--------XXXXX---XXXXXXXXXXXX--------XXXXX---XXXXXXXXXXXX--------XXXXX---XXXXXXXXXXXX--------XXXXX---XXXXXXXXXXXX--------XXXXX---XXXXXXXXXXXX--------XXXX----XXXXXXXXXXXX--------XXXXX---XXXXXXXXXXXX--------XXXXX---XXXXXXXXXXX---------XXXXX---XXXXXXXXXXXX--------XXXXX---XXXXXXXXXXXX--------XXXXX---XXXXXXXXXXXX--------XXXXX---XXXXXXXXXXXX--------XXXXX---XXXXXXXXXXXX--------XXXXX---XXXXXXXXXXXX--------XXXXX---XXXXXXXXXXXX---------XXXX---XXXXXXXXXXXX----X---XXXX-----XXXXXXX---------E-----E----<>--<>----------------------<>--[]--XXX---XXXX--XXXX----XXX--XXXXXXX--------XXXX----XXXXXXXXXXX----------XXXX---XXXXXXXXXXX----------XXXX---XXXXXXXXXXXX---------XXXX---XXXXXXXXXXXX--------XXXXX---XXXXXX-XXXX----------XXXX---XXXXXXXXXXX----------XXXX---XXXXXX--XXX----------XXXX---XXXXXX--XXXX---------XXXX---XXXXXXXXXXX----------XXXX---XXXXXXXXXXXX---------XXXX---XXXXXXXXXXXX--------XXXXX---XXXXXXXXXXXX--------XXXXX---XXXXXXXXXXX----------XXXX---XXXXXX--
--------------[]----[]--[]----------------<>----[]--[]----------------[]----[]--[]----------------<>----[]--[]----------------<>----[]--[]----------------[]----[]--[]----------------<>----[]--[]----------------[]----[]--[]----------------<>----[]--[]----------------<>----[]--[]----------------[]----[]--[]--------------------------------------------------------------------------------------------------------------------------------------------------------------------------------------------------------------------------------------------------------------------------------------------------------------------------------------------------------------------------------------------------------------------------------------------------------------------------------------------------------------------------------------------------------------------------------------------------------------------------------------------------<>----<>----[]--[]----------------------[]--[]-------------------------------------------------------------------------------------------------------------------------------------------------------------------------------------------------------------------------------XXX--------------------------------------------------------------------------------XX-X---------------------------------------------------------------------------------X-X----------------------------
--------------[]----[]--[]----------------[]----[]--[]----------------[]----[]--[]----------------[]----[]--[]----------------[]----[]--[]----------------[]----[]--[]----------------[]----[]--[]----------------[]----[]--[]----------------[]----[]--[]----------------[]----[]--[]----------------[]----[]--[]-----XXXX----------oo--------------XX----------oo-------------XXXX---------oo-------------XXXX---------oo-------------XXXX---------oo-------------XXX----------oo--------------XX----------oo-------------XXX----------oo-------------XXX----------oo-------------XXX-----------o--------------XX----------oo-------------XXX----------oo-------------XXX----------oo-------------XXX----------oo-------------XXX----------oo-------------XXXX---------oo-------------XXX----------oo-------------XXXX---------oo-------------XXXX---------oo-------------XXXX---------oo-------------XXXX---------oo--------------X-----------oo-----------------[]----[]----[]--[]----------------<>----[]--[]-------------------oo-------------XXX----------oo-------------XXXX----------o------------XXXXX----------o-------------XXXX---------oo-------------XXXX---------oo------------XXXXX----------o-------------XXXX----------o-------------XXXX----------o-------------XXXX---------oo-------------XXXX----------o-------------XXXX---------oo-------------XXXX---------oo-------------XXXX---------oo------------XXXXX----------o---------
-----EE-E-----[]-E--[]--[]-----E-EE-EE-E--[]-E--[]--[]-----E-EE-EE-E--[]-E--[]--[]-----E-EE-EE-E--[]-E--[]--[]-----E-EE-EE-E--[]-E--[]--[]-----E-EE-EE-E--[]-E--[]--[]-----E-EE-EE-E--[]-E--[]--[]-----E-EE-EE-E--[]-E--[]--[]-----E-EE-EE-E--[]-E--[]--[]-----E-EE-EE-E--[]-E--[]--[]--------E-EE-E--[]-E--[]--[]----XXX-----------XXXX-----------X------------XXXX------------------XXX---XXXX-----------------XXXX---XXXX-----------------XXXX---XXXX-----------------XXXX---XXXX-----------------XXXXXXXXXXX-----------------XXXX--XXXXX-----------------XXXX---XXXX-----------------XXXXXXXXXXX-----------X-----XXXX--XXXXX-----------------XXXX-XXXXXX-----------------XXXX--XXXXX-----------------XXXXXXXXXXX-----------------XXXX--XXXXX-----------------XXXX---XXXX-----------------XXXX---XXXX------------------XXX---XXXX-----------------XXXX---XXXX------------------XXX---XXXX------------------XX----XXXX-----------------XXXXXXXXXXX-----------E-E--[]-E--[]-E--[]--[]-------EE-EE----[]-E--[]--[]--XXXXX-----------XXXX------------------------XXXX------------------XXX---XXXX------------------XXX---XXXX------------------XXX---XXXX------------------XXX---XXXX------------------XXX---XXXX------------------XXX---XXXX------------------XXX---XXXX------------------XX----XXXX------------------XXX---XXXX------------------XXX---XXXX------------------XXX---XXXX------------------XXX---XXXX------------------XX----XXXX--------
XXXXXXXXXXXXXXXXXXX-XX--XX---XXXXXXXXXXXXXXXXX--XX--XX---XXXXXXXXXXXXXXXXX--XX--XX---XXXXXXXXXXXXXXXXX--XX--XX---XXXXXXXXXXXXXXXXX--XX--XX---XXXXXXXXXXXXXXXXX--XX--XX---XXXXXXXXXXXXXXXXX--XX--XX---XXXXXXXXXXXXXXXXX--XX--XX---XXXXXXXXXXXXXXXXX--XX--XX---XXXXXXXXXXXXXXXXX--XX--XX---XXXXXXXXXXXXXXXXXX-XX--XX-------------------------------------------------------------------------------------------------------------------------------------------------------------------------------------------------------------------------------------------------------------------------------------------------------------------------------------------------------------------------------------------------------------------------------------------------------------------------------------------------------------------------------------------------------------------------------------------------------------------------------------------XXXXXXXXXXXXXXXXXX-XX--XXX--XXXXXXXXXXXXXXXXXX-XX--XX--------------------------------------------------------------------------------------------------------------------------------------------------------------------------------------------------------------------------------------------------------------------------------------------------------------------------------------------------------------------------------------------------------------------------------------
