--------------------------------------------------------------------------------------------------------------------------------------------------------------------------------------------------------------------------------------------------------------------------------------------------------------------------------------------------------------------------------------------------------------------------------------------------------------------------------------------------------------------------------------------------------------------------------------------------------------------------------------------------------------------------------------------------------------------------------------------------------------------------------------------------------------------------------------------------------------------------------------------------------------------------------------------------------------------------------------------------------------------------------------------------------------------------------------------------------------------------------------------------------------------------------------------------------------------------------------------------------------------------------------------------------------------------------------------------------------------------------------------------------------------------------------------------------
--------------------------------------------------------------------------------------------------------------------------------------------------------------------------------------------------------------------------------------------------------------------------------------------------------------------------------------------------------------------------------------------------------------------------------------------------------------------------------------------------------------------------------------------------------------------------------------------------------------------------------------------------------------------------------------------------------------------------------------------------------------------------------------------------------------------------------------------------------------------------------------------------------------------------------------------------------------------------------------------------------------------------------------------------------------------------------------------------------------------------------------------------------------------------------------------------------------------------------------------------------------------------------------------------------------------------------------------------------------------------------------------------------------------------------------------------------
--SSSSS----S-SS--------------------------------SSSSS-----------------------S-S-------------------------SSS------S------------SSSSSSSSSSSSSSS--------------SSSSSSSSSSS--SS--S---------SSSSSSSSSSSSSSS-------------------SSSSS----------------------------------------------------------------------------------------------------------------------------------------------------------------------------------------------------------------------------------------------------------------------------------------------------------------------------------------------------------------------------------------------------------------------------------------------------------------------------------------------------------------------------------------------------------------------------------------------------------------------------------------------------------------------------------------------oo----------------------------------------------------------------------------------------------------------------------------------------------------------------------------------------------------------------------------------------------------------------------------------------------------------------------------------------------------------------------------------------------------------------------------------------------------------------------------------------------------------------------------
---------------------------------------------------------------------------------------------------------------------------------------------------------------------------------------------------------------------------------------------------------------------------------------------------------------------------------------------------------------------------------------------------------------------------------------------------------------------------------------------------------------------------------------------------------------------------------------------------------------------------------------------------------------------------------------------------------------------------------------------------------------------------------------------------------------------------------------------------------------------------------------------------------------------------------------------------------------------------------------------------------------X--------------------------?-------------------------------------------------------------------------------------------------------------------------------------------------------------------------------------------------------------------------------------------------------------------------------------------------------------------------------------------------------------------------------------------------------------
---------------------------------------------------------------------------------------------------------------------------------------------------------------------------------------------------------------------------------------------------------------------------------------------------------?------X--------------------?------X---o----------------?----------o----------------?------X---o----------------?------X--------------------?------X--------------------?------X--------------------?------X--------------------?------X--------------------?------X--------------------?------X--------------------?------X--------------------?------X--------------------?------X--------------------?------X--------------------?------X---o----------------?------X---o----------------?------X---o----------------?------X---o----------------?------X--------------------?------X--------------------?------X----------------------------------------------------------------------------?------X--------------------?------X---o----------------?------X--------------------?------X---o----------------?------X---o----------------?------X--------------------?------X---o----------------?------X---o----------------?----------o----------------?------X--------------------?------X---o----------------?------X---o----------------?----------o----------------?------X--------------------?------X--------------------?------X---
--------------------------------------------------------------------------------------------------------------------------------------------------------------------------------------------------------------------------------------------------------------------------------------------ooo--XXXX----ooo---Xo-------ooo---XXX----ooo---oo-------------XXXo----S-S---?-------------XXXo---XSSS---?--------o----XXXo---XS-----?--------o---XXXXo---XS----o?--------o---XXXXo---Xo----XX--------o--XXXXXo---Xo----XX-------oo--XXXXX----Xo----XX-------oo--XXXXXo---Xo-----X--------o--XXXXX----Xo----XX-------oo--XXXXXo---Xo----XX-------oo--XXXXXo---XS-----?--------o--XXXXXo---Xo----XX--------o--XXXXX----Xo----XX--------o--XXXXXo---XS-----?--------o---XXXXo---XS-S---?-------------XXXo---SSSS---?-----------XXXXXo---SS-S---?-------------XXXo---XSSS---?--------o----XXXo---SS-S---?-------oo--XXXXXo---Xo----XX-----------SSSS-----------------------------------------SSS----ooo--XXXX----Xoo---oo-------Xoo---XXX----ooo---oo-------------XXXo---SS-S---?-------------XXXo---SSSS---?-------------XXXo---SS-S---?------------XXXXo---XS-S---?-------------XXXo----S-S---?------------XXXXo---SS-S---?-------------XXXo---XSSS---?-------------XXXo---SS-S---?-------------XXXo---XX----o?-------------XXXo----S-S---?-------------XXXo---SSSS---?------------XXXXo----S-S---?------------XXXXo---SS-S--o?------------XXXXo---SS-S--o?---
-------------------------------------------------------------------------------------------------------------------------------------------------------------------------------------------------------------------------------------------------------------------------------------------------------------------------------------------------XXXXX-----------------------XXXXX-------------------------XXX-------------------------XXX-------------------------XXX-------------------------XXX-------------------------XXX-------------------------XXX-------------------------XXX-------------------------XXX-------------------------XXX-------------------------XXX-------------------------XXX------------------------XXXX-------------------------XXX------------------------XXXX----------------------XXXXXX----------------------XXXXXX-------------------------XXX------------------------XXXX----------------------------------------------------------------------------------------------------------------------------------------XXXX-------------------------XXX-----------------------XXXXX----------------------XXXXXX-------------------------XXX-----------------------XXXXX------------------------XXXX------------------------XXXX--------------------------XX------------------------XXXX-----------------------XXXXX-----------------------XXXXX-------------------------XXX-------------------------XXX----------------------
-------------------------E---------------------------E---------------------------E---------------------------E---------------------------E---------------------------E---------------------------E---------------------------E---------------------------E----------------------------------------------------------o----------------------------------------------------------------------------------------------------------------------------------------------------------------------------------------------------------------------------------------------------------------------------------------------------------------------------------------------------------------------------------------------------------------------------------------------------------------------------------------------------------------------------------------------------------------------------------------------------------------------------------------------------------------E------------------------------o-----------------------------------------------------------------------------------------------------------------------------------------------------------------------------------------------------------------------------------------------------------------------------------------------------------------------------------------------------------------------------------------------------------------------------------
---------------E--S--E--<>--------------------S--E--<>-----------------E--S--E--<>-----------------E--S--E--<>-----------------E--S--E--<>-----------------E--S--E--<>--------------------S--E--<>-----------------E--S--E--<>-----------------E-----E--<>-----------------------E---E---------------------XX---------------------------XX------------------------------------------X-------------------------------------------------------------------------------------------------------------------------------------------------------------------------------------------------------------------------------------------------------------------------------------------------------------------------------------------------------------------------------------------------------X--------------------------------------------------------------------------------------------------------------------------------------------------------E---E-----------------------E--<>------------------------------------------------------------------------------------------------------------------------------------------------------------------------------------------------------------------------------------------------------------------------------------------------------------------------------------------------------------------------------------------------------------------------------------------------------------------
--------SQS---<>----<>--[]-----------------E----<>--[]----------------<>----<>--[]----------------<>----<>--[]----------------<>----<>--[]----------------<>----<>--[]-----------------E----<>--[]----------------<>----<>--[]----------------<>----<>--[]----------------E-----<>--<>--XXXX--XXXX--XXXX----XXX-XXXXXXXX---XX---XXXX----XXXXXXXXXXX----------XXXX---XXXXXXXXXXXX--------XXXXX---XXXXXX-XXXXX--------XXXXX---XXXXXXXXXXXX--------XXXXX---XXXXXXXXXXXX--------XXXXX---XXXXXXXXXXXX--------XXXXX---XXXXXXXXXXXX--------XXXXX---XXXXXXXXXXXX--------XXXXX---XXXXXXXXXXXX--------XXXXX---XXXXXXXXXXXX--------XXXXX---XXXXXXXXXXXX--------XXXXX---XXXXXXXXXXXX--------XXXXX---XXXXXXXXXXXX--------XXXX----XXXXXXXXXXXX--------XXXXX---XXXXXXXXXXXX--------XXXXX---XXXXXXXXXXXX--------XXXXX---XXXXXXXXXXX----------XXXX---XXXXXXXXXXXX---------XXXX---XXXXXX-XXXXX--------XXXXX---XXXXXXXXXXXX---------XXXX---XXXXXXXX---------------E----<>--<>----------------------<>--[]--XXX----XXX--XXXX---XXXX--XXXXXXX---XXX--XXXX----XXXXXXXXXXX---------XXXXX---XXXXXXXXXXX----------XXXX---XXXXXXXXXXX----------XXXX---XXXXXXXXXXXX--------XXXXX---XXXXXXXXXXX----------XXXX---XXXXXXXXXXX----------XXXX---XXXXXXXXXXX----------XXXX---XXXXXX--XXX----------XXXX---XXXXXXXXXXXX--------XXXXX---XXXXXXXXXXX----------XXXX---XXXXXXXXXXX----------XXXX---XXXXXX-XXXX----------XXXX---XXXXXXXXXXXX--------XXXXX---XXXXXXXXXXXX--------XXXXX---XXXXXXXX
--------------[]----[]--[]-----------E----<>----[]--[]----------------[]----[]--[]----------------[]----[]--[]----------------[]----[]--[]----------------[]----[]--[]-----------E----<>----[]--[]----------------[]----[]--[]----------------[]----[]--[]-----------------E----[]--[]-------------------------------------------------------------------------------------X--------------------------------------------------------------------------------------------------------------------------------------------------------------------------------------------------------------------------------------------------------------------------------------------------------------------------------------------------------------------------------------------------------------------------------XX-X------------------------------------------------------------------------------------------------------------------------------<>----[]--[]----------------------[]--[]----------------------------------------------------------------------------------------------------------------------------------------------------------------------------------------------------------------------------------------------------------XXXX-------------------------------------------------------------------------------------------------------------------------------------------X-------------------------X-X----------------------------
--------------[]----[]--[]----------<>----[]----[]--[]----------------[]----[]--[]----------------[]----[]--[]----------------[]----[]--[]----------------[]----[]--[]----------<>----[]----[]--[]----------------[]----[]--[]----------------[]----[]--[]----------------<>----[]--[]-------------------oo--------------XX----------oo-------------XXXX----------o-------------XXXX---------oo-------------XXXX---------oo-------------XXXX---------oo-------------XXX----------oo-------------XXX----------oo--------------XX----------oo-------------XXX----------oo--------------XX----------oo--------------XX----------oo-------------XXX----------oo-------------XXX----------oo-------------XXX----------oo-------------XXX----------oo-------------XXXX---------oo-------------XXXX---------oo------------XXXXX----------o-------------XXXX---------oo-------------XXXX---------oo-------------XXX----------oo-----------------------[]----[]--[]----------------------[]--[]-------XX----------oo--------------XX----------oo-------------XXXX----------o------------XXXXX---------oo-------------XXXX----------o-------------XXXX---------oo------------XXXXX----------o------------XXXXX----------o------------XXXXX----------o-------------XXXX---------oo------------XXXXX---------oo------------XXXXX----------o------------XXXXX----------o-------------XXXX----------o-------------XXXX---------oo-------------XXXX---------oo---------
-----EE-E-----[]-E--[]--[]-----E-EE-[]-E--[]-E--[]--[]-----E-EE-EE-E--[]-E--[]--[]-----E-EE-EE-E--[]-E--[]--[]-----E-EE-EE-E--[]-E--[]--[]-----E-EE-EE-E--[]-E--[]--[]-----E-EE-[]-E--[]-E--[]--[]-----E-EE-EE-E--[]-E--[]--[]-------EE-EE-E--[]-E--[]--[]-------EE-EE----[]-E--[]--[]--XXXXX-----------XXXX------------------------XXXX------------------XXX---XXXX-----------------XXXX---XXXX------------------XXX---XXXX-----------------XXXX---XXXX-----------------XXXX--XXXXX-----------------XXXXXXXXXXX----------XXX----XXXX--XXXXX-----------------XXXX--XXXXX-----------------XXXX--XXXXX----------XX-----XXXX--XXXXX-----------------XXXX---XXXX-----------------XXXX---XXXX-----------------XXXX--XXXXX-----------------XXXX---XXXX-----------------XXXX---XXXX-----------------XXXX---XXXX-----------------XXXXX--XXXX------------------XXX---XXXX------------------XXX---XXXX-----------------XXXXXXXXXXX-------------EE-EE-E--[]-E--[]--[]-------EE-EE-E--EE-E--[]--[]--XXXXX-----------XXXX------------------------XXXX------------------XXX---XXXX------------------XX----XXXX------------------XXX---XXXX-----------------XXXX---XXXX------------------XXX---XXXX------------------XXX---XXXX------------------XXX---XXXX------------------XXX---XXXX------------------XX----XXXX------------------XXX---XXXX------------------XXX---XXXX------------------XXX---XXXX------------------XXX---XXXX------------------XXX---XXXX--------
-XXXXXXXXXXXXXXXXXX-XX--XX---XXXXXXXXXXXXXXXXX--XX--XX---XXXXXXXXXXXXXXXXX--XX--XX---XXXXXXXXXXXXXXXXX--XX--XX---XXXXXXXXXXXXXXXXX--XX--XX---XXXXXXXXXXXXXXXXX--XX--XX---XXXXXXXXXXXXXXXXX--XX--XX---XXXXXXXXXXXXXXXXX--XX--XX--oXXXXXXXXXXXXXXXXX--XX--XX---XXXXXXXXXXXXXXXXXX-XX--XX-------------------------------------------------------------------------------------------------------------------------------------------------------------------------------------------------------------------------------------------------------------------------------------------------------------------------------------------------------------------------------------------------------------------------------------------------------------------------------------------------------------------------------------------------------------------------------------------------------------------------------------------XXXXXXXXXXXXXXXXXX-XX--XXX-XXXXXXXXXXXXXXXXXXX-XX--XX------------------------------------------------------------------------------------------------------------------------------------------------------------------------------------------------------------------------------------------------------------------------------------------------------------------------------------------------------------------------------------------------------------------------------------------------------------------
