--------------------------------------------------------------------------------------------------------------------------------------------------------------------------------------------------------------------------------------------------------------------------------------------------------------------------------------------------------------------------------------------------------------------------------------------------------------------------------------------------------------------------------------------------------------------------------------------------------------------------------------------------------------------------------------------------------------------------------------------------------------------------------------------------------------------------------------------------------------------------------------------------------------------------------------------------------------------------------------------------------------------------------------------------------------------------------------------------------------------------------------------------------------------------------------------------------------------------------------------------------------------------------------------------------------------------------------------------------------------------------------------------------------------------------------------------------
--------------------------------------------------------------------------------------------------------------------------------------------------------------------------------------------------------------------------------------------------------------------------------------------------------------------------------------------------------------------------------------------------------------------------------------------------------------------------------------------------------------------------------------------------------------------------------------------------------------------------------------------------------------------------------------------------------------------------------------------------------------------------------------------------------------------------------------------------------------------------------------------------------------------------------------------------------------------------------------------------------------------------------------------------------------------------------------------------------------------------------------------------------------------------------------------------------------------------------------------------------------------------------------------------------------------------------------------------------------------------------------------------------------------------------------------------------
----------------------oo------------------------------------------------------------------------------------------------------------------------------------------------------------------------------------------------------------------------------------------------------------------------------------------------------------------------------------------------------------------------------------------------------------------------------------------------------------------------------------------------------------------------------------------------------------------------------------------------------------------------------------------------------------------------------------------------------------------------------------------------------------------------------------------------------------------------------------------------------------------------------------------------------------------------------------------------------------------------------------------------------------------o-------------------------------------------------------------------------------------------------------------------------------------------------------------------------------------------------------------------------------------------------------------------------------------------------------------------------------------------------------------------------------------------------------------
-----------------------X--------------------------------------------------------------------------------------------------------------------------------------------------------------------------------------------------------------------------------------------------------------------------------------------------------------------------------------------------------------------------------------------------------------------------------------------------------------------------------------------------------------------------------------------------------------------------------------------------------------------------------------------------------------------------------------------------------------------------------------------------------------------------------------------------------------------------------------------------------------------------------------------------------------------------------------------------------------------------------------------------------------------------------------------------------------------------------------------------------------------------------------------------------------------------------------------------------------------------------------------------------------------------------------------------------------------------------------------------------------------------------------------------------------------------------
-----------------?------X--------------------?------X--------------------?------X--------------------?------X--------------------?------X--------------------?------X--------------------?------X--------------------?------X--------------------?------X--------------------?------X--------------------?------X---o----------------?------X---o----------------?------X---o----------------?------X---o----------------?------X---o----------------?------X---o----------------?------X--------------------?------X---o----------------?------X--------------------?------X--------------------?------X--------------------?------X--------------------?------X--------------------?------X--------------------?------X--------------------?------X--------------------?------X--------------------?------X--------------------?------X---o----------------?------X---o----------------?------X---o----------------?------X--------------------?------X----------------------------------------------------------------------------?------X---o----------------?------X--------------------?------X---o----------------?------X---o----------------?----------o----------------?------X--------------------?----------o----------------?------X---o----------------?------X---o----------------?----------o----------------?----------o----------------?------X---o----------------?------X---o----------------?----------o----------------?------X---
---ooo--XXXXX----Xoo---Xo-------ooo--XXXX----Xo----XX--------o--XXXXXo---Xo-----?--------o--XXXXX----Xo----XX--------o---XXXXo---XS----o?--------o---XXXXo---XS-----?-------oo--XXXXXo---XS----o?--------o---XXXXo---XS----o?--------o---XXXXo---SS-S--o?--------o----XXXo---XS-----?-------------XXXo---SS-S--o?--------o----XXXo---SS----o?-------------XXXo---SSSS---?-------------XXXo---SS-S---?-------------XXXo---SSSS---?-------------XXXo---SS-S---?--------o---XXXXo---SS-S---?--------o---XXXXo---XS-----?-------oo---XXXXo---XS----XX-------oo--XXXXX----Xo----XX-------oo--XXXXXo---Xo----XX--------o--XXXXXo---XS-----?-------oo--XXXXXo---Xo----XX--------o--XXXXX----Xo----X?--------o--XXXXXo---Xo----X?-------oo--XXXXXo---Xo----XX--------o--XXXXXo---XS----o?-------oo---XXXXo---SS-S---?--------o---XXXXo---XX-----?-------------XXXo---SSSS---?-------------XXXo---SS-S---?--------o---XXXXo---SS-S---?--------o---XXXXo---XS----o?-------o----XXXX----oo--XXoo-----------------------------S-----ooo--XXXX----ooo---oo-------------XXXo---SSSS---?-------------XXXo---SS-S---?-------------XXXo---SSSS---?-------------XXXXX---SSS---?-------------XXXXX---SSS---?-------------XXXXX--SSSS---?-------------XXXo---SS-S---?-------------XXXo---XSSS---?-------------XXXXX---SSS---?-------------XXXo---XXX----?-------------XXXo---XSSS---?-------------XXXo---SSSS---?-------------XXXo---SSSS---?-------------XXXo---XSSS---?---
--------------------------------XX-------------------------XXX-------------------------XXX-------------------------XXX-------------------------XXX-------------------------XXX-------------------------XXX-------------------------XXX-------------------------XXX-------------------------XXX-------------------------XXX-------------------------XXX-------------------------XXX-----------------------XXXXX------------------------XXXX-------------------------XXX-------------------------XXX-------------------------XXX-------------------------XXX-------------------------XXX------------------------XXXX-------------------------XXX-------------------------XXX-------------------------XXX-------------------------XXX------------------------XXXX-------------------------XXX-------------------------XXX-------------------------XXX-----------------------XXXXX-------------------------XXX-------------------------XXX-------------------------------------------------------------------------------------------------------------XXX------------------------XXXX-------------------------XXX----------------------XXXXXX-----------------------XXXXX------------------------XXXX-------------------------XXX------------------------XXXX-----------------------XXXXX------------------------XXXX-----------------------XXXXX----------------------XXXXXX-----------------------XXXXX------------------------XXXX----------------------
--------------------------------------------------------------------------------------------------------------------------------------------------------------------------------------------------------------------------------------------------------------------------------------------------------------------------------------------------------------------------------------------------------------------------------------------------------------------------------------------------------------------------------------------------------------------------------------------------------------------------------------------------------------------------------------------------------------------------------------------------------------------------------------------------------------------------------------------------------------------------------------------------------------------------------------------------------------------------------------------------------------------------------------------------------------------------------------------------------------------------------------------------------------------------------------------------------------------------------------------------------------------------------------------------------------------------------------------------------------------------------------------------------------------------------------------------------
--------------------X----------------------------------------------------------------------------------------------------------------------------------------------------------------------------------------------------------------------------------------------------------------------------------------------------------------------------------------------------------------------------------------------------------------------------------------------------------------------------------------------------------------------------------------------------------------------------------------------------------------------------------------------------------------------------------------------------------------------------------------------------------------------------------------------------------------------------------------------------------------------------------------------------------------------------------------------------------------------------------------E---E--------------------------------------------------------------------------------------------------------------------------------------------------------------------------------------------------------------------------------------------------------------------------------------------------------------------------------------------------------------------------------------------------------------------------------------
XXX---XXXX--XXXX----XXXXXXXXXXXX--------XXXX----XXXXXXXXXXXX--------XXXXX---XXXXXXXXXXXX--------XXXX----XXXXXXXXXXXX--------XXXXX---XXXXXXXXXXXX--------XXXXX---XXXXXXXXXXXX--------XXXXX---XXXXXXXXXXXX--------XXXXX---XXXXXXXXXXXX--------XXXXX---XXXXXXXXXXXX--------XXXXX---XXXXXXXXXXXX--------XXXXX---XXXXXXXXXXXX--------XXXXX---XXXXXXXXXXXX--------XXXXX---XXXXXXXXXXXX--------XXXXX---XXXXXXXXXXX----------XXXX---XXXXXXXXXXXX--------XXXXX---XXXXXXXXXXXX--------XXXXX---XXXXXXXXXXXX--------XXXXX---XXXXXXXXXXXX--------XXXXX---XXXXXXXXXXX---------XXXX----XXXXXXXXXXXX--------XXXXX---XXXXXXXXXXXX--------XXXXX---XXXXXXXXXXXX--------XXXXX---XXXXXXXXXXXX--------XXXXX---XXXXXXXXXXXX--------XXXXX---XXXXXXXXXXXX--------XXXX----XXXXXXXXXXXX--------XXXXX---XXXXXXXXXXXX--------XXXXX---XXXXXXXXXXXX--------XXXXX---XXXXXXXXXXXX--------XXXXX---XXXXXXXXXXXX--------XXXXX---XXXXXXXXXXXX--------XXXXX---XXXXXXXXXXXX--------XXXXX---XXXXXXXXXX----------XXXX---XXXXXXXXX--------------------<>--<>--XXX----XXX--XXXX----XXX--XXXXXXX---------XXXX---XXXXXXXXXXX---------XXXXX---XXXXXXXXXXX----------XXXX---XXXXXXXXXXX----------XXXX---XXXXXXXXXXX----------XXXX---XXXXXX--XXX----------XXXX---XXXXXX--XXX---------XXXXX---XXXXXXXXXXX----------XXXX---XXXXXXXXXXX----------XXXX---XXXXXX--XXX----------XXXX---XXXX----XXX----------XXXX---XXXXXX--XXX----------XXXX---XXXXXX--XXX----------XXXX---XXXXXX--XXX----------XXXX---XXXXXX--
-----------------------------------------------------------------------------------------------------------------------------------------------------------------------------------------------------------------------------------------------------------------------------------------------------------------------------------------------------------------------------------------------------------------------------------X---------------------------------------------------------------------------------------------------------------------------------------------------------------------------------------------------------------------------------------------------------------------------------------------------------------------------------------------------------------------------------------------------------------------------------------------------------------------------------------------------------------------------o------------------------------------------E-[]--[]---------------------------------------------------------------------------------------------------------------------------------------------X-------------------------------------------------------X--------------------------------------------------------------------------------XXXX-------------------------XXX-----------------------------------------------------XXX-------------------------XXX----------------------------
---o-XX----------oo--------------XX----------oo-------------XXX----------oo-------------XXX----------oo-------------XXX----------oo-------------XXX----------oo-------------XXX----------oo-------------XXX----------oo-------------XXXX---------oo-------------XXX----------oo------------XXXXX---------oo-------------XXXX---------oo-------------XXXX---------oo-------------XXXX---------oo-------------XXXX----------o-------------XXXX---------oo-------------XXXX---------oo-------------XXX----------oo-------------XXX----------oo--------------XX----------oo-------------XXX----------oo-------------XXX----------oo-------------XXX----------oo-------------XXX----------oo-------------XXX----------oo-------------XXX----------oo-------------XXX----------oo-------------XXXX---------oo-------------XXX----------oo-------------XXXX---------oo-------------XXXX---------oo-------------XXXX---------oo-------------XXX----------oo-----------XXXXX----------oo--------------------------<>-[]--[]-------XX----------oo-------------XXXX---------oo-------------XXXX---------oo------------XXXXX----------o-------------XXXX----------o-------------XXXX----------o------------XXXXX----------o------------XXXXX----------o------------XXXXX---------oo-------------XXXX----------o------------XXXXX----------o-----XXX----XXXXX----------o-------------XXXX----------o------------XXXXX----------o-------X----XXXXX----------o---------
XXXXX-----------XXXX----------XXX----XXX----XXXX-----------------XXXX-XXXXXX-----------------XXXX--XXXXX-----------------XXXX---XXXX-----------------XXXX---XXXX-----------------XXXX---XXXX-----------------XXXX---XXXX-----------------XXXX---XXXX-----------------XXXX---XXXX------------------XXX---XXXX-----------------XXXX---XXXX------------------XXX---XXXX------------------XXX---XXXX------------------XXX---XXXX-----------------XXXX---XXXX-----------------XXXX---XXXX-----------------XXXX---XXXX-----------------XXXX---XXXX-----------------XXXXXXXXXXX-----------------XXXX--XXXXX-----------------XXXX--XXXXX-----------------XXXX-XXXXXX-----------------XXXX--XXXXX-----------------XXXX--XXXXX-----------------XXXX--XXXXX-----------------XXXXXXXXXXX-----------------XXXX---XXXX-----------------XXXX---XXXX------------------XXX---XXXX------------------XXX---XXXX-----------------XXXX---XXXX-----------------XXXX---XXXX------------------------XXXX-------------EE-EE-E--EE-[]-[]--[]--XXXXX-----------XXXX------------------XX----XXXX------------------XX----XXXX------------------XX----XXXX------------------XXX---XXXX------------------XXX---XXXX------------------XXX---XXXX------------------XXX---XXXX------------------XXX---XXXX------------------XXX---XXXX------------------------XXXX------------------XXX---XXXX------------------XXX---XXXX------------------XXX---XXXX------------------XXX---XXXX--------
----------------------------------------------------------------------------------------------------------------------------------------------------------------------------------------------------------------------------------------------------------------------------------------------------------------------------------------------------------------------------------------------------------------------------------------------------------------------------------------------------------------------------------------------------------------------------------------------------------------------------------------------------------------------------------------------------------------------------------------------------------------------------------------------------------------------------------------------------------------------------------------------------------------------------------------------------------------------------------------XXXXXXXXXXXXXXXXXXXXXX--XX--------------------------------------------------------------------------------------------------------------------------------------------------------------------------------------------------------------------------------------------------------------------------------------------------------------------------------------------------------------------------------------------------------------------------------------
