--------------------------------------------------------------------------------------------------------------------------------------------------------------------------------------------------------------------------------------------------------------------------------------------------------------------------------------------------------------------------------------------------------------------------------------------------------------------------------------------------------------------------------------------------------------------------------------------------------------------------------------------------------------------------------------------------------------------------------------------------------------------------------------------------------------------------------------------------------------------------------------------------------------------------------------------------------------------------------------------------------------------------------------------------------------------------------------------------------------------------------------------------------------------------------------------------------------------------------------------------------------------------------------------------------------------------------------------------------------------------------------------------------------------------------------------------------
--------------------------------------------------------------------------------------------------------------------------------------------------------------------------------------------------------------------------------------------------------------------------------------------------------------------------------------------------------------------------------------------------------------------------------------------------------------------------------------------------------------------------------------------------------------------------------------------------------------------------------------------------------------------------------------------------------------------------------------------------------------------------------------------------------------------------------------------------------------------------------------------------------------------------------------------------------------------------------------------------------------------------------------------------------------------------------------------------------------------------------------------------------------------------------------------------------------------------------------------------------------------------------------------------------------------------------------------------------------------------------------------------------------------------------------------------------
---------------------------------------------------------------------------S-S-------------------------SSSSS------------------SSSSSSSSSSS-SS-----------------------------------------------SSSSS---------------------------------------------------S-S-------------------------SSSSS-----------------------SSS--------------------------------------------------------oo--------------------------------------------------------------------------------------------------------------oo--------------------------------------------------------------------------------------------------------------o-------------------------------------------------------------------------------------------------------------------------------------------------------------------------------------------------------------------------------------------------------------------------------------------------------------------------------------------------------------------------------------------------------o-----------------------------------------------------------------------------------------------------------------------------------------------------------------------------------------------------------------------------------------------------------------------------------------------------------------------------------------------------------------------------------------------------------------------------------------
-----------------------------------------------------------------------------------------------------------------------------------------------------------------------------------------------------------------------------------------------------------------------------------------------------------------------------------------------------------------------X------------------------------------------------------------------------------------------------------------------------------------------------------------------------------------------------------------------------------------------------------------------------------------------------------------------------------------------------------------------------------------------------------------------------------------------------------------------------------------------------------------------------------------------------------------------------------------------------------------------------------------------------------------------?-------------------------------------------------------------------------------------------------------------------------------------------------------------------------------------------------------------------------------------------------------------------------------------------------------------------------------------------------------------------------------------------------------------
-----------------------------------------------------------------------------------------------------------------------------------------------------------------------------------------------------------------------------------------------------------------------------------------------------------------------E-----------------------------------------?------X------------------------------------------------?------X--------------------?------X--------------------?---------------------------?------X--------------------?------X--------------------?------X--------------------?------X--------------------?------X--------------------?------X--------------------?------X--------------------?------X--------------------?------X---oo---------------?----------o----------------?------X---o----------------?------X---o----------------?------X---o----------------?------X--------------------?------X----------------------------------------------------------------------------?------X--------------------?------X---o----------------?------X--------------------?------X--------------------?------X---o----------------?------X---o----------------?------X---o----------------?------X--------------------?------X--------------------?------X--------------------?------X--------------------?------X---o----------------?------X--------------------?------X--------------------?------X--------------------?------X---
-----------------------------------------------------------------------------------------------------------------------------------------------------------------------------------------------------------------------------------------------------------------------------------------------------------------------XXXX---XXX----ooo---oo------Xooo---XXo----ooo---oo-------------XXXo----------X------------XXXXo---XS----o?--------o---XXXXo---XS----o?-------oo--XXXXXo---XS----oo-------oo--XXXXX----Xo----XX-------oo--XXXXXo---XX-----X-------oo--XXXXXo---Xo----XX-------oo--XXXXXo---Xo----XX--------o--XXXXX----Xo----XX--------o---XXXX----XX-----?--------o--XXXXXo---XX-----?-------oo--XXXXXo---Xo----o?-------oo---XXXXo---XS----o?-------------XXXo---XSSS---?-----------XXXXXo---SS-S--o?-------------XXXo---SS-S---?-------------XXXo---SS-S---?-------------XXXo---XS-S---?-------oo--XXXXXo---Xo----XX-----------SSSSSS----------------------------------------------ooo---XXX----ooo---oo-------ooo---XXX----oo----oo-------------XXXo---SSSS---?------------XXXXo---SS-S---?-------------XXXo---SSSS---?-------------XXXo----S-S---?-------------XXXo---SSSS---?-------------XXXo----SSS---?-------oo----XXXo---SS-S---?------------XXXXo---SS-S--o?-------------XXXo---XS-----?------------XXXXo---XS-S--o?-------------XXXo---SS-S---?-------oo---XXXXo---XS-----?--------o----XXXo---So----o?-------------XXXo---SS-S--o?---
------------------------------------------------------------------------------------------------------------------------------------------------------------------------------------------------------------------------------------------------------------------------------------------------------------------------------------------------------------------------------XXXX-------------------------XXX-------------------------XXX-------------------------XXX-------------------------XXX-------------------------XXX-------------------------XXX-------------------------XXX-------------------------XXX-------------------------XXX-------------------------XXX-------------------------XXX-------------------------XXX------------------------XXXX----------------------XXXXXX------------------------XXXX-------------------------XXX------------------------XXXX-------------------------XXX----------------------------------------------------------------------------------------------------------------------------------------XXXX------------------------XXXX-------------------------XXX------------------------XXXX----------------------XXXXXX------------------------XXXX-------------------------XXX-------------------------XXX------------------------XXXX-------------------------XXX-------------------------XXX-------------------------XXX-------------------------XXX-------------------------XXX----------------------
-----------------------------------------------------E---------------------------E---------------------------E---------------------------E-------------------------------------------------------E---------------------------E---------------------------E---------------------------E---------------------------E---------------<>---------------------------------------------------------------------------------------------------------------------------------------------------------------------------------------------------------------------------------------------------------------------------------------------------------------------------------------------------------------------------------------------------------------------------------------------------------------------------------------------------------------------------------------------------------------------------------------------------------------------------------------------------------------------------------------------------------------------------------------------------------------------------------------------------------------------------------------------------------------------------------------------------------------------------------------------------------------------------------------------------------------------------------------------------------------------------------------------------------------------
---------------E-----E---E-----------------E--S--E--<>--------------------S--E--<>-----------------E--S--E--<>-----------------E--S--E--<>--------------------S--E---E-----------------E--S--E--<>--------------------S--E--<>--------------------S--E--<>-----------------E--S--E--<>-----------------E-----E--<>---------------[]--------------------------------XXX------------------------------------------------------------------------------------------------------------------------------------------XX---------------------------------------------------------------------------------------------------------------------------------------------------------------------------------------------------------------------------------------------XX------------------------------------------------------------------------------------------------------------------------------------------------------------------------------------E---E-----------------------E---E------------------------------------------------------------------------------------------------------------------------------------------------------------------------------------------------------------------------------------------------------------------------------------------------------------------------------------------------------------------------------------------------------------------------------------------------------------------
--------SSS---<>----<>--<>----------------<>----<>--[]-----------------E----<>--[]----------------<>----<>--[]----------------<>----<>--[]-----Q-Q---------E----<>--<>----------------<>----<>--[]-----------------E----<>--[]-----------------E----<>--[]----------------<>----<>--[]----------------<>----<>--[]--XXX----XX---SXXX----XXX-XXXXXXX---XXX---XXXX----XXX-XXXXXXXX---------XXXX---XXXXXXXXXXXX--------XXXXX---XXXXXXXXXXXX--------XXXXX---XXXXXXXXXXXX--------XXXXX---XXXXXXXXXXXX---XX---XXXX-----XXXXXXXXXX---------XXXXX---XXXXXXXXXXXX--------XXXXX---XXXXXXXXXXX---------XXXXX---XXXXXXXXXXXX--------XXXXX---XXXXXXXXXXXX--------XXXXX---XXXXXXXXXXXX--------XXXXX---XXXXXXXXXXXX--------XXXXX---XXXXXXXXXXXX--------XXXXX---XXXXXXXXXXXX--------XXXXX---XXXXXX-XXXX----------XXXX---XXXXXXXXXXXX---------XXXX---XXXXXXXXXXXX--------XXXXX---XXXXXXXXXXXX--------XXXXX---XXXXXXXXXXXX--------XXXX----XXXXXXXX---------E----------<>--<>----------------------<>--<>--XXX---XXXX--XXXX----XXX--XXXXXXX---XXX--XXXX----XXXXXXXXXXXX--------XXXXX---XXXXXX-XXXX----------XXXX---XXXXXXXXXXX----------XXXX---XXXXXXXXXXX----------XXXX---XXXXXXXXXXXX---------XXXX---XXXXXXXXXXX----------XXXX---XXXXXX--XXXX--------XXXXX---XXXXXXXXXXXX---------XXXX---XXXXXXXXXXX----------XXXX---XXXXXXXXXXX----------XXXX---XXXXXXXXXXXX---------XXXX---XXXXXXXXXXXX--------XXXXX---XXXXXXXXXXXX--------XXXXX---XXXXXXXXXXX----------XXXX---XXXXXXXX
--------------[]--E-[]--[]----------------[]----[]--[]----------------<>----[]--[]----------------[]----[]--[]----------------[]----[]--[]----------------<>----[]--[]----------------[]----[]--[]----------------<>----[]--[]----------------<>----[]--[]----------------[]----[]--[]----------------[]----[]--[]-----o---------------------------o---------------------------------------------XXXXXXX------------------------------------------------------------------------------------------------------------------------------------------------------------------------------------------------------------------------------------------------------------------------------------------------------------------------------------------------------------------------XXXX----------------------------------------------------------------------------------------------------------------------------------------------------<>----------[]--[]----------------------[]--[]-------------------------------------------------------------------------------------X---------------------------------------------------------------------------------------------------------------X---------------------------X----------------------------------------------------------------------------------------------------------------------------------------------------------------------------------------------------------------------------XXXX
--------------[]-<>-[]--[]----------------[]----[]--[]----------------[]----[]--[]----------------[]----[]--[]----------------[]----[]--[]----------------[]----[]--[]----------------[]----[]--[]----------------[]----[]--[]----------------[]----[]--[]----------------[]----[]--[]----------------[]----[]--[]----XXXXX-----------------------XXXXX----------oo-------------XXXX----------o------------XXXXX---------oo-------------XXX----------oo--------------XX----------oo--------------XX----------oo-------------XXX----------oo--------------XX----------oo-------------XXX----------oo--------------XX----------oo-------------XXX----------oo-------------XXX----------oo-------------XXX----------oo-------------XXX----------oo-------------XXXX---------oo-------------XXXX----------o-------------XXXX---------oo-------------XXXX----------o-------------XXXX---------oo--------------X------------o-----------------[]----------[]--[]----------------------[]--[]-----XXXX----------oo--------------XX----------oo-------------XXXX---------oo------------XXXXX----------o------------XXXXX---------oo-------------XXXX----------o-------------XXXX----------o-------------XXXX----------o-------------XXXX---------oo-------------XXXX---------oo------------XXXXX---------oo------------XXXXX---------oo-------------XXXX---------oo-------------XXXX---------oo-------------XXXX---------oo------------XXXXX----------o---------
--------------[]-[]-[]--[]-------EE-E--E--[]-E--[]--[]-----E-EE-EE-E--[]-E--[]--[]-----E-EE-EE-E--[]-E--[]--[]-----E-EE-EE-E--[]-E--[]--[]-----E-EE-E--E--[]-E--[]--[]-----E-EE-EE-E--[]-E--[]--[]-----E-EE-EE-E--[]-E--[]--[]-----E-EE-EE-E--[]-E--[]--[]-----E-EE-EE-E--[]-E--[]--[]-----E-EE-EE-E--[]-E--[]--[]----------------------------------------------XXXX------------------------XXXX------------------XX----XXXX-----------------XXXX---XXXX-----------X-----XXXX--XXXXX----------XXX----XXXX--XXXXX-----------------XXXX--XXXXX----------XX-----XXXX--XXXXX-----------------XXXX-XXXXXX-----------X-----XXXX--XXXXX-----------------XXXX---XXXX-----------X-----XXXX---XXXX-----------------XXXX--XXXXX-----------------XXXX---XXXX-----------------XXXX---XXXX------------------XXX---XXXX------------------XXX---XXXX------------------XXX---XXXX------------------XXX---XXXX-----------------XXXXXXXXXXX-----------E-EE-[]-------E--[]--[]-------EE-EE----EE-E--[]--[]--X-XX------------XXXX------------------------XXXX------------------XXX---XXXX------------------XXX---XXXX------------------XXX---XXXX------------------XXX---XXXX------------------XXX---XXXX------------------XX----XXXX------------------XXX---XXXX------------------XXX---XXXX------------------XXX---XXXX------------------XXX---XXXX------------------XXX---XXXX------------------XXX---XXXX------------------XX----XXXX------------------XXX---XXXX--------
-XXXXX-XXXXXXXXXXXXXXX--XX---XXXXXXXXXXXXXXXXX--XX--XX---XXXXXXXXXXXXXXXXX--XX--XX---XXXXXXXXXXXXXXXXX--XX--XX---XXXXXXXXXXXXXXXXX--XX--XX---XXXXXXXXXXXXXXXXX--XX--XX---XXXXXXXXXXXXXXXXX--XX--XX---XXXXXXXXXXXXXXXXX--XX--XX---XXXXXXXXXXXXXXXXX--XX--XX---XXXXXXXXXXXXXXXXX--XX--XX---XXXXXXXXXXXXXXXXX--XX--XX------------------XXX------------------------------------------------------------------------------------------------------------------------------------------------------------------------------------------------------------------------------------------------------------------------------------------------------------------------------------------------------------------------------------------------------------------------------------------------------------------------------------------------------------------------------------------------------------------------------------------XXXXXXXXXXXXXXXXX--XX--XX---XXXXXXXXXXXXXXXXXX-XX--XX------------------------------------------------------------------------------------------------------------------------------------------------------------------------------------------------------------------------------------------------------------------------------------------------------------------------------------------------------------------------------------------------------------------------------------------------------------------
