--------------------------------------------------------------------------------------------------------------------------------------------------------------------------------------------------------------------------------------------------------------------------------------------------------------------------------------------------------------------------------------------------------------------------------------------------------------------------------------------------------------------------------------------------------------------------------------------------------------------------------------------------------------------------------------------------------------------------------------------------------------------------------------------------------------------------------------------------------------------------------------------------------------------------------------------------------------------------------------------------------------------------------------------------------------------------------------------------------------------------------------------------------------------------------------------------------------------------------------------------------------------------------------------------------------------------------------------------------------------------------------------------------------------------------------------------------
--------------------------------------------------------------------------------------------------------------------------------------------------------------------------------------------------------------------------------------------------------------------------------------------------------------------------------------------------------------------------------------------------------------------------------------------------------------------------------------------------------------------------------------------------------------------------------------------------------------------------------------------------------------------------------------------------------------------------------------------------------------------------------------------------------------------------------------------------------------------------------------------------------------------------------------------------------------------------------------------------------------------------------------------------------------------------------------------------------------------------------------------------------------------------------------------------------------------------------------------------------------------------------------------------------------------------------------------------------------------------------------------------------------------------------------------------------
-----------------------------------------------S-S-------------------------S-S------------------------------------------------SS-SSSSSSSS--S----------------------------S------------SSSSSSSSSSSSSSS----------------------------SSSS---------SSSSSSSSSSSSSSS-------------------SSSSS----S-SS---------SSSSSSSSSSSS-SS--------------------------------------------------o-------------------------------------------------------------------------------------------------------------------------------------------------------------------------------------------------------------------------------------------------------------------------------------------------------------------------------------------------------------------------------------------------------oo--------------------------------------------------------------------------------------------------------------------------------------------------------------------------------------------------------------------------------------------------------------------------------------o---------------------------------------------------------------------------------------------------------------------------------------------------------------------------------------------------------------------------------------------------------------------------------------------------------------------------------------------------------------------------------
--------------------------------------------------------------------------------------------------------------------------------------------------------------------------------------------------------------------------------------------------------------------------------------------------------------------------------------------------------------------------------------------------------------------------------------------------------------------------------------------------------------------------------------------------------------------------------------------------------------------------------------------------------------------------------------------------------------------------------------------------------------------------------------------------------------------------------------------------------------------------------------------------------------------------------------------------------------------------------------------------------------------------------------------------------------------------------------------------------------------------------------------------------------------------------------------------------------------------------------------------------------------------------------------------------------------------------------------------------------------------------------------------------------------------------------------------------
---Eooo-----------------------------------------------------------------------------------------------------------------------------------------------------------------------------------------------------------------------------------------------------------------------------------------------------------------ooo--------------------------------------?------X---o----------------?------X--------------------?------X---o----------------?------X---o----------------?------X--------------------?------X--------------------?------X-?o-----------------?------X---o----------------?------X--------------------?------X--------------------?------X--------------------?------X--------------------?------X--------------------?------X--------------------?---------------------------?------X---o----------------?----------o----------------?------X--------------------?------X---o----------------?------X--------------------?------X---o----------------?------X--------------------?------X---o----------------?------X---o----------------?------X--------------------?------X---o----------------?------X---o----------------?------X--------------------?------X---o----------------?------X---o----------------?----------o----------------?------X---oo---------------?------X---o----------------?----------o----------------?------X--------------------?------X---o----------------?------X---o----------------?------X---
---XXXXX---------------------------------------------------------------------------------------------------------------------------------------------------------------------------------------------------------------------------------------------------------------------------------------------------------------XXXX----------oo--XQoo-------ooo--XXXX----Xo----oo-------------XXXo---SSSS---?--------o---XXXXo---XS-S---?-------------XXXo---SSSS---?--------o----XXXo---XSSS---?--------o--XXXXXo---XS----o?-------oo--XXXXXo---Xo----XX-------oo--XXXXXo---XX-----X--------o--XXXXXo---XS-----?-------oo--XXXXXo---XX-----?-------oo--XXXXX----Xo----XX-------oo---XXXXo---Xo----o?--------o---XXXX----Xo----XX-------oo---XXXXo---Xo----o?-------oo--XXXXXo---Xo----oo--------o---XXXXo---XX-----?-------------XXXo---XXS----?--------o----XXXo---SS-S---?--------o---XXXXo---XS----o?-------oo---XXXXo---SS-S---?-------oo--XXXXXo---Xo----XX-------oo--XXXXXo---XS-----X--------o---XXXXo---XS-----?------------XXXXo---SS-S--o?------------XXXXo----S-S---?-------------XXXo---SS-S--o?-------------XXXo---SS-S---?-------------XXXo---XS-S---?--------o---XXXXo---XS----o?-------------XXXo---SSSS---?-------------XXXXX---SSS---?-------o-----XXXo---SSSS---?-------------XXXo---SSSS---?-------------XXXX---XSSS---?-------------XXXo---SSSS---?-------------XXXX----SSS---?-------------XXXo---SS-S---?-------------XXXo---SSSS---?---
-------------------------------------------------------------------------------------------------------------------------------------------------------------------------------------------------------------------------------------------------------------------------------------------------------------------------------------------------------------------------------XXX-------------------------XXX-------------------------XXX------------------------XXXX------------------------XXXX-------------------------XXX-------------------------XXX-------------------------XXX-------------------------XXX-------------------------XXX-------------------------XXX-------------------------XXX-------------------------XXX-------------------------XXX-------------------------XXX-------------------------XXX-------------------------XXX-------------------------XXX-------------------------XXX-------------------------XXX-------------------------XXX-------------------------XXX-------------------------XXX------------------------XXXX-------------------------XXX-----------------------XXXXX-------------------------XXX-------------------------XXX-------------------------XXX------------------------XXXX-------------------------XXX-------------------------XXX------------------------XXXX-----------------------XXXXX------------------------XXXX----------------------XXXXXX-----------------------XXXXX----------------------
-----------------------------------------------------E---------------------------E---------------------------E---------------------------E---------------------------E---------------------------E---------------------------E---------------------------E---------------------------E---------------------------E--------------------------------------------------------------------------------------------------------------------------------------------------------------------------------------------------------------------------------------------------------------------------------------------------------------------------------------------------------------------------------------------------------------------------------------------------------------------------------------------------------------------------------------------------------------------------------------------------------------------------------------------------------------------------------------------------------------------------------------------------------------------------------------------------------------------------------------------------------------------------------------------------------------------------------------------------------------------------------------------------------------------------------------------------------------------------------------------------------------------------------------
-------------------------------------------E-----E--<>-----------------E--S--E--<>--------------------S--E--<>-----------------E--S--E--<>-----------------E--S--E--<>-----------------E--S--E--<>--------------------S--E--<>-----------------E--S--E--<>-----------------E--S--E--<>-----------------E--S--E--<>--------------------------------------------------------------------------------------------------------------------------X---------------------------X-------------------------------------------------------------------XXX---------------------------------------------------------------------------------------------------------------------------------------------------------------------------------------------------------------------------------------------------------------------------------------------------------------------------------------------------------------------------------------------------------------------------------------------------------------------------------------------------------------------------------------------------------------------------------------------------------------------------------------------------------------------------------------------------------------------------------------------------------------------------------------------------------------------------------------------------------------------------------------------------------
X----XXXX------------o----XX--------------<>----<>--[]----------------<>----<>--[]-----------------E----<>--[]----------------<>----<>--[]-----------------E----<>--[]----------------<>----<>--[]-----------------E----<>--[]----------------<>----<>--[]----------------<>----<>--[]----------------<>----<>--[]--XXX----XX---XXXX---XXXX-XXXXXXX----XXX--XXXX----XXXXXXXXXXXX--------XXXXX---XXXXXXXXXXXX--------XXXXX---XXXXXXXXXXXX--------XXXXX---XXXXXXXXXXXX--------XXXXX---XXXXXXXXXXXX--------XXXXX---XXXXXXXXXXXX--------XXXXX----XXXXXXXXXXX--------XXXXX---XXXXXXXXXXXX--------XXXXX---XXXXXXXXXXXX--------XXXXX---XXXXXXXXXXXX--------XXXXX---XXXXXXXXXXXX--------XXXXX---XXXXXXXXXXXX--------XXXX----XXXXXXXXXXXX--------XXXXX---XXXXXXXXXXXX---------XXXX---XXXXXXXXXXXX--------XXXXX---XXXXXXXXXXXX---------XXXX---XXXXX---XXXX--------XXXXX---XXXXXXXXXXXX--------XXXXX---XXXXXXXXXXXX--------XXXXX---XXXXXXXXXXX----------XXXX---XXXXXXXXXXX---------XXXXX---XXXXXXXXXXXX--------XXXXX---XXXXXXXXXXXX---------XXXX---XXXXXXXXXXX----------XXXX---XXXXXXXXXXX---------XXXXX---XXXXXXXXXXXX--------XXXXX---XXXXXXXXXXXX--------XXXXX---XXXXXXXXXXXX--------XXXXX---XXXXXXXXXXX----------XXXX---XXXXXXXXXXX----------XXXX---XXXXXX--XXXX---------XXXX---XXXXXXXXXXXX--------XXXXX---XXXXXXXXXXX----------XXXX---XXXXXX--XXX----------XXXX---XXXXXX--XXX----------XXXX---XXXXXXXXXXXX--------XXXXX---XXXXXXXXXXXX---------XXXX---XXXXXX--
------------------E-----------------------[]----[]--[]----------------[]----[]--[]----------------<>----[]--[]----------------[]----[]--[]----------------<>----[]--[]----------------[]----[]--[]----------------<>----[]--[]----------------[]----[]--[]----------------[]----[]--[]----------------[]----[]--[]----------------------------------------------------------------------------------------------------------------------------------------------------------------------------------------------------------------------------------------------------------------------------------------------------------------------------------------------------------------------------------------------------------------------------------------------------------------------------------------------------------------------XXXX------------------------------------------------------------------------------------------------------------------------------------------------------------------------------------------------XXXX--------------------------------------------------------------------------------------------------------------------------------------------------------------------------------------------------------------------------------------------------------------------------------------XX-------------------------X-X-----------------------------------------------------------------------------------X
--XXXXX----------<>-----------------------[]----[]--[]----------------[]----[]--[]----------------[]----[]--[]----------------[]----[]--[]----------------[]----[]--[]----------------[]----[]--[]----------------[]----[]--[]----------------[]----[]--[]----------------[]----[]--[]----------------[]----[]--[]----XXXXX--------------------------XX----------oo-------------XXXX---------oo-------------XXXX---------oo-------------XXXX---------oo-------------XXX----------oo-------------XXX----------oo--------------XX----------oo-------------XXX----------oo-------------XXX----------oo-------------XXX----------oo--------------XX----------oo-------------XXX----------oo-------------XXX----------oo-------------XXX----------oo-------------XXX----------oo-------------XXX----------oo-------------XXXX---------oo-------------XXXX---------oo-------------XXX----------oo-------------XXXX---------oo--------------XX----------oo-------------XXX----------oo-------------XXXX---------oo-------------XXXX---------oo-------------XXXX----------o------------XXXXX---------oo------------XXXXX----------o-------------XXXX---------oo------------XXXXX---------oo------------XXXXX---------oo------------XXXXX----------o-------------XXXX---------oo-------------XXXX---------oo-------------XXXX----------o-------X-----XXXX----------o------------XXXXX----------o-------------XXXX---------oo-------------XXXX----------o---------
---------------E-[]--------------EE-EE-E--[]-E--[]--[]-----E-EE-EE-E--[]-E--[]--[]-----E-EE-EE-E--[]-E--[]--[]-----E-EE-EE-E--[]-E--[]--[]-----E-EE-EE-E--[]-E--[]--[]-----E-EE-EE-E--[]-E--[]--[]-----E-EE-EE-E--[]-E--[]--[]-----E-EE-EE-E--[]-E--[]--[]-----E-EE-EE-E--[]-E--[]--[]-----E-EE-EE-E--[]-E--[]--[]--------------------------------XX------------XXXX------------------XXX---XXXX-----------------XXXX---XXXX-----------------XXXX---XXXX-----------------XXXX---XXXX-----------------XXXX--XXXXX----------XXX---XXXXX---XXXX-----------------XXXX--XXXXX----------XX-----XXXX--XXXXX-----------------XXXX-XXXXXX----------XX-----XXXX--XXXXX-----------------XXXX---XXXX-----------------XXXX---XXXX-----------------XXXX---XXXX-----------------XXXX---XXXX-----------------XXXX---XXXX------------------XXX---XXXX-----------------XXXX---XXXX-----------------XXXX---XXXX-----------------XXXX---XXXX-----------------XXXXXXXXXXX-----------------XXXXXXXXXXX------------------XXX---XXXX------------------XXX---XXXX------------------XXX---XXXX------------------XXX---XXXX------------------XXX---XXXX------------------XXX---XXXX------------------XXX---XXXX------------------XX----XXXX------------------XXX---XXXX------------------XX----XXXX------------------XXX---XXXX------------------XXX---XXXX------------------XXX---XXXX------------------XX----XXXX------------------XXX---XXXX------------------XXX---XXXX--------
------------XXXXXXXXXXX-X----XXXXXXXXXXXXXXXXXX-XX--XX---XXXXXXXXXXXXXXXXX--XX--XX---XXXXXXXXXXXXXXXXX--XX--XX---XXXXXXXXXXXXXXXXX--XX--XX---XXXXXXXXXXXXXXXXX--XX--XX---XXXXXXXXXXXXXXXXX--XX--XX---XXXXXXXXXXXXXXXXX--XX--XX---XXXXXXXXXXXXXXXXX--XX--XX---XXXXXXXXXXXXXXXXX--XX--XX---XXXXXXXXXXXXXXXXX--XX--XX-----------------XXXX-----------------------------------------------------------------------------------------------------------------------------------------------------------------------------------------------------------------------------------------------------------------------------------------------------------------------------------------------------------------------------------------------------------------------------------------------------------------------------------------------------------------------------------------------------------------------------------------------------------------------------------------------------------------------------------------------------------------------------------------------------------------------------------------------------------------------------------------------------------------------------------------------------------------------------------------------------------------------------------------------------------------------------------------------------------------------------------------------------------------
