--------------------------------------------------------------------------------------------------------------------------------------------------------------------------------------------------------------------------------------------------------------------------------------------------------------------------------------------------------------------------------------------------------------------------------------------------------------------------------------------------------------------------------------------------------------------------------------------------------------------------------------------------------------------------------------------------------------------------------------------------------------------------------------------------------------------------------------------------------------------------------------------------------------------------------------------------------------------------------------------------------------------------------------------------------------------------------------------------------------------------------------------------------------------------------------------------------------------------------------------------------------------------------------------------------------------------------------------------------------------------------------------------------------------------------------------------------
--------------------------------------------------------------------------------------------------------------------------------------------------------------------------------------------------------------------------------------------------------------------------------------------------------------------------------------------------------------------------------------------------------------------------------------------------------------------------------------------------------------------------------------------------------------------------------------------------------------------------------------------------------------------------------------------------------------------------------------------------------------------------------------------------------------------------------------------------------------------------------------------------------------------------------------------------------------------------------------------------------------------------------------------------------------------------------------------------------------------------------------------------------------------------------------------------------------------------------------------------------------------------------------------------------------------------------------------------------------------------------------------------------------------------------------------------------
------------------------------------------SS-SSSSSSSS--S-------------------SSSSS----------------------------------------------S---SSSSSSS--SSSSS-S-------SSSSSSSSSSSSSSS-------------------S-S----------------------------------SSSSSSSS---SSSSSSSSSSSSSSSSSS-SS---------SSSSSSSSSSSS-SS----------------------------------------------------------------------------------------------------------------------------------------------------------------------------------------------------------------------------------------------------------------------------------------------------------------------------------------------------------------------------------------------------------------------------------------------------------------------------------------------------------------------------------------------------------------------------------------------------------------------------------------------------------------------------------------------------------------------------------------------------------------------------------------------------------------------------------------------------------------------------------------------------------------------------------------------------------------------------------------------------------------------------------------------------------------------------------------------------------------------------------------------------------------
----------------------------------------------------------------------------------------------------------------------------------------------------------------------------------------------------------------------------------------------------------------------------------------------------------------------------------------------------------------------?---------------------------------------------------------------------------------------------------------------------------------------------------------------------------------------------------------------------------------------------------------------------------------------------------------------------------------------------------------------------------------------------------------------------------------------------------------------------------------------------------------------------------------------------------------------------------------------------------------------------------------------------------------------------------------------------------------------------------------------------------------------------------------------------------------------------------------------------------------------------------------------------------------------------------------------------------------------------------------------------------------------------------------------------------------------------------------
-------------------------------------------------------------------------------------------------------------------------------------------------------------------------------------------------------------------------------------------------------------------------------------------------------------------------------------?------X-o------------------?------X---o----------------?------X--------------------?------X---o----------------?------X--------------------?------X--------------------?------X--------------------?------X--------------------?------X--------------------?------X--------------------?------X--------------------?------X--------------------?------X--------------------?------X--------------------?------X---o----------------?------X---o----------------?------X---o----------------?------X---o----------------?------X---o----------------?------X---o-----------------------X--------------------?------X--------------------?------X--------------------?------X---o----------------?----------o----------------?---------------------------?------X---o----------------?------X--------------------?------X--------------------?------X---o----------------?----------o----------------?------X---o----------------?------X--------------------?----------o----------------?------X---o----------------?----------o----------------?----------o----------------?----------o----------------?------X---
------------------------------------------------------------------------------------------------------------------------------------------------------------------------------------------------------------------------------------------------------------------------------------------------------------------Q-----ooo---XXX----Xoo---XX--------oo---XXX----oo----XX-------------XXXo---SSSS---?--------o---XXXXo---XS----o?--------o----XXXo---SS-S---?--------o---XXXXo---XS-----?-------oo---XXXXo---XS----XX--------o--XXXXXo---Xo----XX-------oo--XXXXXo---Xo-----X-------oo--XXXXXo---Xo----XX--------o--XXXXX----XX----XX--------o--XXXXX----Xo----XX-------oo--XXXXXo---Xo----XX--------o--XXXXX----XX-----?-------oo---XXXXo---Xo----o?--------o----XXXo---SSSS---?------------XXXXo---XS-S---?------------XXXXo---XS-----?--------o---XXXXo---SS-S---?-------------XXXo---SS-S---?-----------XXXXXo-------X-XX-------oo--XXXXX----XX----XX-------oo--XXXXXo---XS-----?--------o---XXXXo---XS-S--o?-------------XXXo---XSSS---?-------------XXXXX---SSS---?-------------XXXo---SS-S---?-------------XXXo---XSSS---?-------------XXXX----S-S---?-------o----XXXXo---XS-S---?-------------XXXX----SSS---?------------XXXXo---SSSS---?-------------XXXo---SS-S--o?-------------XXXo----SSS---?-------------XXXo---XXSS---?-------------XXXXX--XXSS---?-------------XXXXX---SSS---?-------------XXXX----SSS---?------------XXXXo---XS-----?---
----------------------------------------------------------------------------------------------------------------------------------------------------------------------------------------------------------------------------------------------------------------------------------------------------------------------------------------------------XX-------------------------XXX-------------------------XXX-------------------------XXX-------------------------XXX-------------------------XXX------------------------XXXX-------------------------XXX-------------------------XXX-------------------------XXX-------------------------XXX-------------------------XXX-------------------------XXX-------------------------XXX-------------------------XXX------------------------XXXX-----------------------XXXXX-------------------------XXX-------------------------XXX----------------------XXXXXX-------------------------XXX-------------------------XXX-------------------------XXX-------------------------XXX------------------------XXXX-------------------------XXX----------------------XXXXXX-------------------------XXX-------------------------XXX-----------------------XXXXX----------------------XXXXXX-----------------------XXXXX------------------------XXXX------------------------XXXX------------------------XXXX------------------------XXXX------------------------XXXX-------------------------XXX----------------------
-------------------------E---------------------------E---------------------------E---------------------------E---------------------------E---------------------------E---------------------------E---------------------------E---------------------------E---------------------------E------------------------------------------------------------------------------------------------------------------------------------------------------------------------------------------------------------------------------------------------------------------------------------------------------------------------------------------------------------------------------------------------------------------------------------------------------------------------------------------------------------------------------------------------------------------------------------------------------------------------------------------------------------------------------------------------------------------------------------------------------------------------------------------------------------------------------------------------------------------------------------------------------------------------------------------------------------------------------------------------------------------------------------------------------------------------------------------------------------------------------------------------------------------
---------------E-----E--<>-----------------E--S--E--<>-----------------E--S--E--<>-----------------E--S-----<>-----------------E--S--E--<>-----------------E--S--E--<>--------------------S--E--<>--------------------S--E--<>-----------------E--S--E--<>-----------------E-----E--<>-----------------------E-------------------------XXX--------------------------------------------------------------------------------------------------------------------------------------------------------------------------------------------------------------------------------------------------------------------------------------------------------------------------------------------------------------------------------------------------------------------------------------------------------------------------------------------------------------------------------------------------------------------------------------------------------------------------------------------------------------------------------------------------------------------------------------------------------------------------------------------------------------------------------------------------------------------------------------------------------------------------------------------------------------------------------------------------------------------------------------------------------------------------------------------------------------
--------------<>----<>--[]----------------<>----<>--[]----------------<>----<>--[]----------------<>----<>--[]----------------<>----<>--[]----------------<>----<>--[]-----------------E----<>--[]-----------------E----<>--[]----------------<>----<>--[]----------------<>----<>--[]----------------------<>---E--XXXXX--XXXXXXXXX----XXXXXXXXXXXX-------XXXXX----XXXXXXXXXXXX--------XXXXX---XXXXXXXXXXXX--------XXXXX---XXXXXXXXXXXX--------XXXXX---XXXXXXXXXXXX---------XXXX---XXXXXXXXXXXX--------XXXXX---XXXXXXXXXXX---------XXXXX---XXXXXXXXXXXX--------XXXXX---XXXXXXXXXXXX--------XXXXX---XXXXXXXXXXXX--------XXXXX---XXXXXXXXXXXX--------XXXXX---XXXXXXXXXXXX--------XXXXX---XXXXXXXXXXXX--------XXXXX---XXXXXXXXXXXX---------XXXX---XXXXXXXXXXXX--------XXXXX---XXXXXXXXXXXX--------XXXXX---XXXXXXXXXXXX--------XXXXX---XXXXXXXXXXXX--------XXXXX---XXXXXXXXXXXX--------XXXXX---XXXXXXXXXXXX--------XXXXX---XXXXXXXXXXX---------XXXXX---XXXXXXXXXXX---------XXXXX---XXXXXXXXXXXX--------XXXXX---XXXXXXXXXXXX---------XXXX---XXXXX---XXX----------XXXX---XXXXXXXXXXX---------XXXXX---XXXXXXXXXXXX---------XXXX---XXXXXX--XXX----------XXXX---XXXXXXXXXXX----------XXXX---XXXXXXXXXXX----------XXXX---XXXXXX-XXXX----------XXXX---XXXXXX-XXXX----------XXXX---XXXXXXXXXXX----------XXXX---XXXXXXX-XXX----------XXXX---XXXXXX--XXX----------XXXXX--XXXXX---XXX----------XXXX---XXXXXX--XXX----------XXXX---XXXXXX--XXXX--------XXXXX---XXXXXXXX
--------------[]----[]--[]----------------[]----[]--[]----------------[]----[]--[]----------------[]----[]--[]----------------[]----[]--[]----------------[]----[]--[]----------------<>----[]--[]----------------<>----[]--[]----------------[]----[]--[]----------------[]----[]--[]--------------------E-[]--<>-------------------------------------------------------------------------------------------------------------------------------------------------------------------------X-------------------------------------------------------------------------------------------------------------------------------------------------------------------------------------------------------------------------------------------------------------------------------------------------------------------------------------------------------------------------------------------------------X-----------------------X---X------------------------------------------------------------------------------------------------------------XXXX---------------------------------------------------------------------------------XXX-----------------------------------------------------------------------------------------------------------------------------------------X-X----------------------------------------------------------------------------------X--------------------------------------------------------X----------------------------
--------------[]----[]--[]----------------[]----[]--[]----------------[]----[]--[]----------------[]----[]--[]----------------[]----[]--[]----------------[]----[]--[]----------------[]----[]--[]----------------[]----[]--[]----------------[]----[]--[]----------------[]----[]--[]-------------------<>-[]--[]-------XX----------oo-------------XXXX---------oo-------------XXXX---------oo-------------XXX----------oo-------------XXXX---------oo-------------XXXX---------oo-------------XXX----------oo-------------XXX----------oo-------------XXX----------oo-------------XXX----------oo-------------XXX----------oo--------------XX----------oo-------------XXX----------oo-------------XXX----------oo-------------XXX----------oo-------------XXXX---------oo-------------XXXX---------oo-------------XXXX---------oo-------------XXXX---------oo-------------XXXX---------oo-------------XXX-----------o-------------XXX----------oo-------------XXX----------oo-------------XXXX---------oo-------------XXXX---------oo-------------XXXX----------o-------------XXXX---------oo-------------XXXX----------o-------------XXXX----------o------------XXXXX---------oo------------XXXXX----------o-------------XXXX---------oo------------XXXXX----------o------------XXXXX----------o-------------XXXX----------o------------XXXXX----------o-----XXX----XXXXX----------o-------X-----XXXX----------o-------------XXXX---------oo---------
-----EE-EE----[]-E--[]--[]-----E-EE-EE-E--[]-E--[]--[]-----E-EE-EE-E--[]-E--[]--[]-----E--E-EE-E--[]-E--[]--[]-----E-EE-EE-E--[]-E--[]--[]-----E-EE-EE-E--[]-E--[]--[]-----E-EE-EE-E--[]-E--[]--[]-----E-EE-EE-E--[]-E--[]--[]-----E-EE-EE-E--[]-E--[]--[]-----E-EE-EE-E--[]-E--[]--[]----------EE-E--EE-[]-[]--[]----XXX-----------XXXX------------------------XXXX------------------XXX---XXXX-----------------XXXX---XXXX-----------------XXXX---XXXX-----------------XXXX---XXXX-----------------XXXXX--XXXX-----------------XXXXXXXXXXX-----------------XXXXXXXXXXX-----------------XXXX-XXXXXX-----------------XXXX--XXXXX-----------------XXXX--XXXXX-----------------XXXX-XXXXXX-----------------XXXXXXXXXXX------------------XXX---XXXX-----------------XXXX---XXXX-----------------XXXX---XXXX------------------XXX---XXXX-----------------XXXX---XXXX-----------------XXXX---XXXX------------------XXXXXXXXXX-----------------XXXX--XXXXX-----------X-----XXXXXXXXXXX------------------XXX---XXXX------------------XXX---XXXX------------------XXX---XXXX------------------XXX---XXXX------------------XX----XXXX------------------XXX---XXXX------------------XXX---XXXX------------------XXX---XXXX------------------XXX---XXXX------------------XXX---XXXX------------------------XXXX------------------XXX---XXXX-------------------------XXX------------------XX----XXXX------------------XXX---XXXX------------------XXX---XXXX--------
-XXXXXXXXXXXXXXXXXX-XX--XX---XXXXXXXXXXXXXXXXX--XX--XX---XXXXXXXXXXXXXXXXX--XX--XX---XXXXXXXXXXXXXXXXXX-XX--XX---XXXXXXXXXXXXXXXXX--XX--XX---XXXXXXXXXXXXXXXXX--XX--XX---XXXXXXXXXXXXXXXXX--XX--XX---XXXXXXXXXXXXXXXXX--XX--XX---XXXXXXXXXXXXXXXXX--XX--XX---XXXXXXXXXXXXXXXXXX-XX--XX----XXXXXXXXXXXXXXXXXXXX--XXXX------------------------------------------------------------------------------------------------------------------------------------------------------------------------------------------------------------------------------------------------------------------------------------------------------------------------------------------------------------------------------------------------------------------------------------------------------------------------------------------------------------------------------------------------------------------------------------------------------------------------------------------------------------------------------------------------------------------------------------------------------------------------------------------------------------------------------------------------------------------------------------------------------------------------------------------------------------------------------------------------------------------------------------------------------------------------------------------------------------------------------------
