--------------------------------------------------------------------------------------------------------------------------------------------------------------------------------------------------------------------------------------------------------------------------------------------------------------------------------------------------------------------------------------------------------------------------------------------------------------------------------------------------------------------------------------------------------------------------------------------------------------------------------------------------------------------------------------------------------------------------------------------------------------------------------------------------------------------------------------------------------------------------------------------------------------------------------------------------------------------------------------------------------------------------------------------------------------------------------------------------------------------------------------------------------------------------------------------------------------------------------------------------------------------------------------------------------------------------------------------------------------------------------------------------------------------------------------------------------
--------------------------------------------------------------------------------------------------------------------------------------------------------------------------------------------------------------------------------------------------------------------------------------------------------------------------------------------------------------------------------------------------------------------------------------------------------------------------------------------------------------------------------------------------------------------------------------------------------------------------------------------------------------------------------------------------------------------------------------------------------------------------------------------------------------------------------------------------------------------------------------------------------------------------------------------------------------------------------------------------------------------------------------------------------------------------------------------------------------------------------------------------------------------------------------------------------------------------------------------------------------------------------------------------------------------------------------------------------------------------------------------------------------------------------------------------------
--------------------------------oo--------------------------o---------------------------oo--------------------------oo--------------------------oo--------------------------oo--------------------------oo--------------------------o---------------------------oo--------------------------oo--------------------------oo--------------------------oo--------------------------oo--------------------------oo--------------------------oo------------------------------------------------------oo--------------------------oo--------------------------o---------------------------o------------------------S--ooSS-SSSSSSS----------------oo--------------------------oo--------------------------oo--------------------------oo--------------------------oo--------------------------oo--------------------------oo--------------------------oo------------------------------------------------------o---------------------------o---------------------------oo--------------------------o---------------------------oo--------------------------oo--------------------------oo--------------------------oo--------------------------o---------------------------o---------------------------oo--------------------------oo--------------------------oo--------------------------oo--------------------------oo--------------------------oo--------------------------oo--------------------------oo--------------------------oo----------------------
----XXX----------------X-------XXXX------------------------X---------------------------XXXX------------------------XXXX-----------------------XXXXX--------------------E--XXXXX-------------------------XXX----------------------------------------------------XXXX--------------------E----XXX------------------------XXXX------------------------XXXX-------------------------XXX-------------------------XXX------------------------XXXX-----------------------------------------------------XXX-------------------------XXX-------------------------XX--------------------------X---------------------------XXXX----------------------XXXXXX-----------------------XXXX------------------------XXXX------------------------XXXX------------------------XXXX-----------------------XXXXXX------------------------XXX------------------------XXXX-------------------------------------------------------------------------------------------------------------XXX-----------------------------------------------------XXX------------------------XXXX-------------------------XXX------------------------XXXX-------------------------X---------------------------X--------------------------XXXX-----------------------XXXXX------------------------XXXX------------------------XXXX------------------------XXXX-----------------------XXXXX--------------------E---XXXX------------------------XXXX-----------------------XXXXX--------------------E
-----------------?-----------------------------------------------------------------------------------E---------------------------?-----------------------------------------------------------------------------------?---------------------------E-------------------------------------------------------?---------------------------?---------------------------E---------------------------E---------------------------?---------------------------?---------------------------?---------------------------?---------------------------?---------------------------E-----------------------------------------------------------------------------------------------------------------------------------------------------------------------?-----------------------------------------------------------------------------------?---------------------------?---------------------------?---------------------------?------X--------------------?---------------------------?---------------------------E---------------------------?---------------------------?---------------------------?---------------------------?-------------------------------------------------------?-----------------------------------------------------------------------------------?-------------------------------------------------------------------------------------------------------------------------------------------E--------------------------------------
-----------ooo--XXXS----?--------------ooo---ESS----SSS------------ooo---ESS----SSS------------ooo---XXS----SSS-----------Xooo---XXS----SSS----------ooooo---XX-----SSS------------ooo---XXS----SSS------------ooo---XXS----?--------------oo----XXS----SSS----------ooooo---E------SSS------------ooo--XXXS----?-------------Xooo--XXXS----S--------------ooo---XXS----SSS-----------oooo---XXS----S-------------Xoo---XXXS----SS------------Xoo---XXXS----S-------------Xoo---XXXS----SSS-----------ooo----XX-----SSS-----------Xooo---XXS----S--------------ooo---XXS----S----------------------------SSS------------o------------SSS----------ooo----E------SSSS---------oo------E------SSSS---------oooo----E------SSSS-----------ooo---XXS----S--------------ooo---ESS----SSS-------------o----------SSSS-----------oooo--XXXS----?-------------oooo--XXXS----SS------------Xooo---XXS----?------------ooooo--XXXS----S-------------Xooo---XXS----SS------------Xooo---XXS----S------------oooo----XXS----S-------------oooo---XXS----S-------------Xoo----XXS----SSS-----------Xooo---XXS----S-------------Xooo---XXS----SSS----------oooo----XXS----SS------------oooo---XXS----?--------------ooo---XX-----SSS------------ooo---ESS----SSS-------------oo--XXXS----SSS-----------ooo----XX-----SSS------------ooo---ESS----SSS------------ooo---XSS----SSS-----------Xooo---XSS----SSS------------ooo---XXS----SSS-------------oo---ESS----SSS-
--------------------o-------------------------------------------------------o---------------------------o---------------------------o-------------------------------------------------------o---------------------------o-------------------------------------------------------o---------------------------oo----------------------------------------------------------------------------------o----------------------------------------------------------------------------------oo----------------------------------------------------------------------------------oo---------------------------------------------------------------------------------------------------------------o---------------------------o---------------------------o---------------------------o-------------------------------------------------------o------------------------------------------------------oo------------------------------------------------------oo-------------------------------------------------------o---------------------------o--------------------------------------------------------------------------------------------------------------oo---------------------------o--------------------------oo---------------------------o-------------------------------------------------------o-----------------------------------------------------------------------------------o---------------------------o-----------------------------------
----------------------------------------------------------------------------------------------------------------------------------------------------S-SS------------------------------------------------------------------------------------------------------------S--S----------------------------------------------------------------------------------------------------------------------------------------------------------------------------------------------------------------------------------------------------------------------------------------------------------------S-------------------------------------------------------S---------------------------S---------------------------S-----------------------------------------------------------------------------------------------------------------------------------------------------------------------------------------------------------------------------------------------------------------------------------------------------------------------------------------------------------------------------------------------------------------------------------------------------------------------------------------------------------------------------------------------------------------------------------------------------------------------------------------------------------------------------------------------------------------------------------------------
--------------------------------------------------------------------------------------------------------------------------------------------------SoS-------------------------------------------------------------------------------------------------------------SoS---Q-----E---------------------------------------------------------------------------------------------------------------------------------------------------------------------------------------------------------------------------------------------------------------------------------------------------------S---------E--o------------------------E-----------------S---------E---------------SoS---------E---------------SoS---------E-----------------------------------------------------------------------------------E-------------------------------------------------------------------------------------------------------------------------------------------------------------------------------------------------------------------------------------------------------------------------------------------------------------------------------------------------------------------------------------------------------------------------------------------------------------------------------------------E-----------------------------------------------------------------------------------------------------------------------------------------------------
-------------XXX---XXXX------------------XXX----XXX--XX--------------XXX----XXX------------------XXX---XXXX------------------XXX----XXX-----XX-----SS----XX--<>-XXX--XXX-------------XX--<>-XXX------------------XXX----XXX------------------XXX---XXXX--XX--------SS--------<>-XXX--E?X-------------XXX----XXX------------------XXX---XXXX--X---------------XXX---XXXX--XXX-------------XXX---XXXX--XXX-------------XXX---XXXX--XXX-------------XXX---XXXX--XXXX------------XXX----XXX------------------XXX---XXXX--XXXX------------XXX---XXXX--XXXX------------XXX---XXXX-------S----SS--------<>------E-------------------<>------E?S-------------XX--<>-XXX--E??XXS---SSS--------<>------E?SXXS---SSS--------<>------E?X-------------XXX----XXX-----X------------XXX----XXX----------------------<>-XX---E?X-------------XXX---XXXX------------------XXX---XXXX--XXXX------------XXX----XXX------------------XXX---XXXX--XXX-------------XXX----XXX------------------XXX----XXX--XX-XX-----------XXX---XXXX--XXX-------------XXX---XXXX--XX--------------XXX---XXXX--XXX-------------XXX---XXXX--XXX-------------XXX---XXXX--XXXXX-----------XXX----XXX--X---------------XXX---XXXX--XX--------------XXX----XXX------------------XXX----XXX--X---------------XXX----XXX-----XX-----------XX--<>-XXX------------------XXX----XXX-----X------------XXX----XXX--XX--------------XXX----XXX------------------XXX----XXX------------------XX--<>-XXX--X--
--Eo---------------------------o--------------E------------o---------------------------o--------------------------Eo--------------------------oo-------------[]------------o-------------[]-----------Eo---------------------------o--------------------------oo-------------[]-----------Eo---------------------------o---------------------------o--------------------------Eo--------------------------Eo--------------------------Eo---------------------------o--------------------------Eo--------------------------Eo---------------------------o-----------------------------------------[]--------------------------[]------------o-------------[]------------o-------------[]------------o-------------[]-----------Eo---------------------------o--------------E--------------------------[]-----------Eo---------------------------o--------------------------Eo--------------------------Eo---------------------------o--------------------------Eo--------------------------Eo--------------------------Eo--------------------------Eo--------------------------Eo---------------------------o---------------------------o--------------E-----------Eo---------------------------o--------------E------------o--------------E------------o---------------------------o-------------[]------------o---------------------------o--------------E------------o---------------------------o-----------------------------------------[]---------
--XXXXX-----------------------XXXXXX---------<>-----------XXXXXX----------------------XXXXXX----------------------XXXXXX----------------------XXXXX----------[]-----------XXXXXX---------[]-----------XXXXX-----------------------XXXXXX----------------------XXXXX----------[]-----------XXXXXX----------------------XXXXX-----------------------XXXXXX----------------------XXXXX-----------------------XXXXXX----------------------XXXXXX----------------------XXXXXX----------------------XXXXX-----------------------XXXXXX----------------------XXXXX------------------------XXX-----------[]--------------------------[]-----------XXXXXX---------[]-----------XXXXX----------[]-----------XXXXX----------[]-----------XXXXXX----------------------XXXXXX---------<>-----------XXXX-----------[]-----------XXXXX-----------------------XXXXXX----------------------XXXXXX----------------------XXXXX-----------------------XXXXXX----------------------XXXXXX----------------------XXXXX-----------------------XXXXX-----------------------XXXXXX----------------------XXXXXX----------------------XXXXXX----------------------XXXXX----------<>-----------XXXXX-----------------------XXXXX----------<>-----------XXXXXX---------<>-----------XXXXXX----------------------XXXXX----------[]-----------XXXXXX----------------------XXXXXX---------<>-----------XXXXXX----------------------XXXXXX---------<>-----------XXXXXX---------[]---------
---------------------------------------------[]--------------------------------------------------------------------------------------------------------------[]--------------------------[]----------------------------------------------------------------------------------[]------------------------------------------------------------------------------------------------------------------------------------------------------------------------------------------------------------------------------------------------------------------------------------------------------------------[]--------------------------[]--------------------------[]--------------------------[]--------------------------[]------------------------------------------------------[]--------------------------[]----------------------------------------------------------------------------------------------------------------------------------------------------------------------------------------------------------------------------------------------------------------------------------------------------------------------------------------------[]------------------------------------------------------[]--------------------------[]------------------------------------------------------[]------------------------------------------------------[]------------------------------------------------------[]--------------------------[]---------
-----------X---XXXX----XXXXX---------------XXXXXXXX-XXXX---------------XXXXXXX---XXX---------------XXXXXXX---XXX---------------XXXX-----XXXX------------X--XXXXXXXXXXXXX-----------X---XXXXXXXXXXXXX---------------XXXX-----XXXXX--------------XXXX------XXX-----------XXX-XXXXXXXXXXXXX-----------X---XXXX----XXXXX----------------XXX------XXX---------------XXXX-X----XXX---------------XXXX------XXX---------------XXXX------XXX---------------XXXX------XXX---------------XXXX-XX--XXXX---------------XXXX------XXX---------------XXXX------XXX---------------XXXX------XXX---------XXXXXXXXXXXXXXXXXXXXX-------XXXXXXXXXXXXXXXXXXX-----------XXXXXXXXXXXXXXXXX----------XXXXXXXXXXXXXXXXXX----------XXXXXXXXXXXXXXXXXX-----------X---XXXX----XXXXX---------------XXXXXXX--XXXX-----------XXXXXXXXXXXXXXXXX-----------X---XXXX-----XXXX---------------XXXX------XXX----------------XXX------XXX---------------XXXX------XXX---------------XXXX------XXX---------------XXXX------XXX---------------XXXX------XXX---------------XXXX------XXX---------------XXXX------XXX---------------XXXX------XXX---------------XXXX------XXX---------------XXXXXXX---XXX---------------XXXX------XXX---------------XXXXXXXXXXXXX---------------XXXXXXXX-XXXXXXX-------XXX--XXXX-XX-XXXXX-----------XX--XXXXXXXXXXXXXX--------------XXXXXXX-XXXXX---------------XXXXXXX--XXXX---------------XXXX-XX--XXXXX--------------XXXXXXX-XXXXX---------------XXXXXXXXXXXXX
