--------------------------------------------------------------------------------------------------------------------------------------------------------------------------------------------------------------------------------------------------------------------------------------------------------------------------------------------------------------------------------------------------------------------------------------------------------------------------------------------------------------------------------------------------------------------------------------------------------------------------------------------------------------------------------------------------------------------------------------------------------------------------------------------------------------------------------------------------------------------------------------------------------------------------------------------------------------------------------------------------------------------------------------------------------------------------------------------------------------------------------------------------------------------------------------------------------------------------------------------------------------------------------------------------------------------------------------------------------------------------------------------------------------------------------------------------------
--------------------------------------------------------------------------------------------------------------------------------------------------------------------------------------------------------------------------------------------------------------------------------------------------------------------------------------------------------------------------------------------------------------------------------------------------------------------------------------------------------------------------------------------------------------------------------------------------------------------------------------------------------------------------------------------------------------------------------------------------------------------------------------------------------------------------------------------------------------------------------------------------------------------------------------------------------------------------------------------------------------------------------------------------------------------------------------------------------------------------------------------------------------------------------------------------------------------------------------------------------------------------------------------------------------------------------------------------------------------------------------------------------------------------------------------------------
----oo--------------------------oo--------------------------oo--------------------------oo----------------------------------------------------------------------------------oo--------------------------oo--------------------------oo--------------------------oo------------------------------------------------------o---------------------------oo--------------------------oo--------------------------oo--------------------------oo--------------------------oo--------------------------oo--------------------------oo--------------------------ooo-------------------------oo--------------------------oo--------------------------oo------------------------------------------------------o---------------------------oo------------------------------------------------------oo--------------------------oo--------------------------oo--------------------------oo--------------------------o---------------------------oo--------------------------oo--------------------------o-------------------------------------------------------o---------------------------oo--------------------------oo------------------------------------------------------------------------------------------------------------------------------------------------------------------------------------------------------------------------------------------------------------------------------------------------------------------------------------------
---XXXX--------------------E----XXX------------------------XXX------------------------XXXXXX-------------------E-----------------------------------------------------------XXXX-----------------------XXXXX--------------------E----XXX----------------X-------XXXX-----------------------------------------------------XXX------------------------XXXX------------------------XXXX-------------------------XX-------------------------XXXX------------------------XXXX------------------------XXXX------------------------XXXXX-----------------------XXXXX-----------------------XXXXX-----------------------XXXX-----------------------XXXXX--------------------------------------------XX-------X---------------------------XXX----------------------------------------------------XXXX-------------------------XXX-------------------------XXX------------------------XXXX-------------------------X--------------------------XXXX------------------------XXXX-------------------------------------------------------------------------------------------------------------XXX-----------------------XXXXXX----------------------------------------------------------------------------------------------------------------------------------------------------------------------------------------------------------------------------------------------------------------------------------------------------------------------------------------
-----------------?---------------------------?---------------------------E-------------------------------------------------------?-------------------------------------------------------?------------------------------------------------------E?---------------------------?--------------------------E?---------------------------?---------------------------E---------------------------?---------------------------?---------------------------?---------------------------?---------------------------E----------------------------------------------------------------------------------------------------------------------------------------------------------------------E?---------------------------?---------------------------?---------------------------?---------------------------?---------------------------?---------------------------?---------------------------?---------------------------?---------------------------?---------------------------E---------------------------?---------------------------?---------------------------?---------------------------?----------------------------------------------------------------------------------------------------------------------------------------------------------------------------------------------------------------------------------------------------------------------------------------------------------------------------------------------------------
---------oooo---XXX-----SS-------------ooo---XSSS---?--------------ooo---XXS----SSS----------ooooo---XX-----SSS------------ooo--XXX-----?--------------ooo---EXS----?-------------Xooo---XXS----SSS----------oooo----XX-----SSS------------oo---XXX-----S-------------Xooo---XXS----SSS------------oo---XXXX----S------------oooo---XXX-----?------------oooo----XXS----SS------------Xooo--XXXS----S-------------oooo---XXS----S------------ooooo---XXS----S-------------Xoo---XXXS----S--------------oo----XXS----SSS-------------------------SSSS------------oo----------SSSS------------o-----------SSSS---------o--o----E------SSSS---------oooo----E------SSSS----------Xooo--XXXX----?-------------Xooo---XXS----S-------------oooo---XXS----S--------------oo---XXX-----SS------------ooo----XXS----SS------------oooo---XXS----S------------ooooo---XXS----S-------------Xoo---XXXS----SSS-----------oooo---XXS----S-------------oooo---XXS----S------------ooooo---XXS----SS------------Xooo---XXS----?--------------oo---XXX-----SS------------ooo----XXS----S--------------oo---XXXS----SS-------------ooo----------SSSS---------QQ-----------------------------------------------------QQQ------------------------QQQQQ-------------------------QQ-------------------------QQQQ-------------------------QQ--------------------------QQ-------------------------QQQ--------------------------QQ---------------------------------------------
--------------------o---------------------------o--------------------------oo------------------------------------------------------ooo-------------------------ooo--------------------------o---------------------------o----------------------------------------------------------------------------------oo---------------------------o-----------------------------------------------------------------------------------------------------------------------------------------------------------------------o---------------------------------------------------------------------------------------------------------------o---------------------------o--------------------------ooo------------------------------------------------------o-------------------------------------------------------o-------------------------------------------------------o-------------------------------------------------------o-----------------------------------------------------------------------------------o---------------------------o--------------------------oo-----------------------------------------------------------------------------------------------------------------------------------------------------------------------------------------------------------------------------------------------------------------------------------------------------------------------------------------------------------------------------------
--------------------------------------------------------------------------------------------S--S------------------------------------------------------------------------------------------------------------------------------------------------------------------------------------------------------------------------------------------------------------------------------------------------------------------------------------------------------------------------------------------------------------------------------------------------------------SS--------------------------SS--------------------------S---------------------------S-------------------------------------------------------------------------------------------------------------------------------------------------------------------------------------------------------------------------------------------------------------------------------------------------------------------------------------------------------------------------------------------------------------------------------------------------------------------------------------------------------------------------------------------------------------------------------------------------------------------------------------------------------------------------------------------------------------------------------------------------------------------------------------------------------
--------------------------------------------------------------------------------------------S---------------------------------------------------------------------------------------------------------------------------------------------------------------------------------------------------------------------------------------------------------------------------------------------------------------------------------------------------------------------------------------------------------------------------------------------E---------------SoS---------E---------------SoS---------E---------------SoS---------E---------------SoS---------E----------------------------------------------------------------------------------------------------------------------------------------------------------------------------------------------------------------------------------------------------------------------------------------------------------------------------------------------------------------------o----------------------------------------------------------------------------------------E--------------------------------oo---------------------E--ooo---------------------------o---------------------------o----------------------E--oooo----o----------------E---oo----------------------E--ooo---------------------------o----------------------E----o-----oo---------------E--ooo----------------------E---------
------------XXX-----XXX--XXX-------------XXX----XXX------------------XXX----XXX-----X------SS----XX-----XXX--XXX-------------XXX----XXX------------------XXX----XXX------------------XXX----XXX-----XX-----------XX-----XXX--XXX-------------XXX---XXXX------------------XXX---XXXX--XX--------------XXX---XXXX-----XX-----S-----XXX---XXXX--XX-XX-----------XXX---XXXX--XXX-------------XXX---XXXX--XXX-------------XXX---XXXX--XXXX------------XXX---XXXX--XXX-------------XXX---XXXX--XXX-------------XXX----XXX--XX------------------<>------E?S-------SS--------<>------E?SXSS---SSS--------<>------E?SXSS---SSS--------<>------E?SXXS---SSS----XX--<>-XX---E?X-------------XXXX---XXX------------------XXX---XXXX------------------XXX---XXXX--XX--------------XXX---XXXX--XXX-------------XXX---XXXX--XXX-------------XXX---XXXX--XXXX------------XXX---XXXX--XXX-------------XXX---XXXX--XXXXX-----------XXX---XXXX--XX--------------XXX---XXXX--XXXXX-----------XXX---XXXX--XXX-------------XXX---XXXX------X-----------XXX---XXXX--XXXXX-----------XXX----XXX------------------XXX---XXXX--X-------------------<>------E?S-oo----QQQQ------------------QQ-----QQQ------<>----------------QQQQ---Q--<>---------ooo----QQQQQ-Q---------------oo----QQQQ------<>-----------o----QQQQ---Q--<>-----------o----QQQQ---Q--<>-----------o----QQQQ---Q--<>----------------QQQQ---Q--<>-----------oo----QQ-------<>----------QQ-----QQQ------<>---------
--Eo-------------<>-----------Eo---------------------------o--------------------------oo-------------<>-----------Eo--------------E-----------Eo--------------E-----------Eo---------------------------o--------------E-----------Eo---------------------------o--------------------------Eo--------------------------Eo---------------------------o--------------------------Eo--------------------------Eo--------------------------Eo--------------------------Eo--------------------------Eo-----------------------------------------[]------------o-------------[]------------o-------------[]------------o-------------[]------------o-------------[]-----------Eo---------------------------o--------------------------Eo---------------------------o--------------------------Eo--------------------------Eo--------------------------Eo--------------------------Eo--------------------------Eo--------------------------Eo---------------------------o--------------------------Eo---------------------------o--------------------------Eo---------------------------o---------------------------o-------------[]------------------------------------------------------[]--------------------------[]------------------------------------------------------[]--------------------------[]--------------------------[]--------------------------[]--------------------------[]--------------------------[]--------------------------[]-----E---
--XXXXX----------[]-----------XXXXXX----------------------XXXXXX----------------------XXXXX----------[]-----------XXXXX----------<>-----E-----XXXXX----------<>-----E-----XXXXXX----------------------XXXXXX---------<>-----------XXXXX-----------------------XXXXXX----------------------XXXXX-----------------------XXXXX-----------------------XXXXXX----------------------XXXXXX----------------------XXXXXX----------------------XXXXX-----------------------XXXXX-----------------------XXXXXX---------<>------------X-------------[]-----------XXXXXX---------[]-----------XXXXX----------[]-----------XXXXX----------[]-----------XXXXX----------[]-----------XXXXX-----------------------XXXXXX----------------------XXXXXX----------------------XXXXX-----------------------XXXXX----------<>-----------XXXXX-----------------------XXXXX-----------------------XXXXXX----------------------XXXXXX----------------------XXXXXX----------------------XXXXXX----------------------XXXXXX----------------------XXXXX-----------------------XXXXXX----------------------XXXXXX----------------------XXXXX----------[]------------------------------------------------------[]--------------------------[]------------------------------------------------------[]--------------------------[]--------------------------[]--------------------------[]--------------------------[]--------------------------[]--------------------------[]----<>---
-----------------[]----------------------------------------------------------------------------------[]--------------------------[]--------------------------[]------------------------------------------------------[]--------------------------------------------------------------------------------------------------------------------------------------------------------------------------------------------------------------------------------------------------------------------------------------[]-----------------------E--[]--------------------E-----[]--------------------------[]--------------------------[]--------------------------[]------------------------------------------------------------------------------------------------------------------------------------------[]------------------------------------------------------------------------------------------------------------------------------------------------------------------------------------------------------------------------------------------------------------------------------------------------------------------[]-----------------------E--------E------------------E--[]--------------------E-EE--[]-----------------------E---------------------------E--[]-----------------------E--[]-----------------------E--[]-----------------------E--[]-----------------------E--[]----E------------------E--[]-----------------------E--[]----[]---
-----------XX--XXXXXXXXXXXXX-----------X---XXXX----XXXXX---------------XXXX-XX---XXX---------------XXXXXXXXXXXXX-----------X---XXXXXXXXXXXXX---------------XXXXXXXXXXXXX---------------XXXXXXX-XXXXX---------------XXXXXXXX-XXXX---------------XXXX-----XXXX----------------XXX------XXX---------------XXXX----XXXXX---------------XXXX------XXX---------------XXXX------XXX---------------XXXX------XXX---------------XXXX------XXX---------------XXXX------XXX---------------XXXX------XXX---------------XXXXXXX--XXXXX--------XXXXXXXXXXXXXXXXXXXX---------XXXXXXXXXXXXXXXXXX----------XXXXXXXXXXXXXXXXXX----------XXXXXXXXXXXXXXXXXX-----------XXX-XXXXXXXXXXXXX-----------------X-----XXXXX----------------XXX------XXX---------------XXXX------XXX---------------XXXX------XXX---------------XXXX-----XXXX---------------XXXX------XXX---------------XXXX------XXX---------------XXXX------XXX----------------XXX------XXX---------------XXXX------XXX---------------XXXXXXX---XXX----------------XXX------XXX---------------XXXX------XXX---------------XXXX------XXX---------------XXXX------XXX----------XXXXXXXXXXXXXXXXXXXXXXXXXXXXXXXXXXXXXXXXXXXXXXXXXX-XXXXXXXXXXXXXXXXXXXXXXXXXXXXXXXXXXXXXXXXXXXXXXXXXXXXXXXXXXXXXXXXXXXXXXXXXXXXXXXXXXXXXXXXXXXXXXXXXXXXXXXXXXXXXXXXXXXXXXXXXXXXXXXXXXXXXXXXXXXXXXXXXXXXXXXXXXXXXXXXXXXXXXXXXXXXXXXXXXXXXXXXXXXXXXXXXXXXXXXXXXXXXXXXXXXXXXXXXXXXXXXXXXXXXXXXXXXXXXXXXXXXXXXXXXXXXXXXXXXXXXXXXXXXXXXXXXX
