--------------------------------------------------------------------------------------------------------------------------------------------------------------------------------------------------------------------------------------------------------------------------------------------------------------------------------------------------------------------------------------------------------------------------------------------------------------------------------------------------------------------------------------------------------------------------------------------------------------------------------------------------------------------------------------------------------------------------------------------------------------------------------------------------------------------------------------------------------------------------------------------------------------------------------------------------------------------------------------------------------------------------------------------------------------------------------------------------------------------------------------------------------------------------------------------------------------------------------------------------------------------------------------------------------------------------------------------------------------------------------------------------------------------------------------------------------
--------------------------------------------------------------------------------------------------------------------------------------------------------------------------------------------------------------------------------------------------------------------------------------------------------------------------------------------------------------------------------------------------------------------------------------------------------------------------------------------------------------------------------------------------------------------------------------------------------------------------------------------------------------------------------------------------------------------------------------------------------------------------------------------------------------------------------------------------------------------------------------------------------------------------------------------------------------------------------------------------------------------------------------------------------------------------------------------------------------------------------------------------------------------------------------------------------------------------------------------------------------------------------------------------------------------------------------------------------------------------------------------------------------------------------------------------------
----oo--------------------------oo------------------------------------------------------oo--------------------------oo--------------------------oo------------------------------------------------------o---------------------------oo--------------------------oo--------------------------oo--------------------------o---------------------------oo--------------------------oo--------------------------oo--------------------------oo--------------------------oo--------------------------oo--------------------------oo--------------------------oo--------------------------o-oS------------------------ooo-------------------------oo----------------------------------------------------------------------------------oo------------------------------------------------------oo--------------------------oo--------------------------oo--------------------------oo--------------------------oo------------------------------------------------------oo--------------------------o---------------------------o---------------------------o-------------------------------------------------------oo--------------------------o---------------------------oo--------------------------oo--------------------------oo--------------------------oo--------------------------oo--------------------------oo--------------------------oo--------------------------oo--------------------------oo--------------------------oo----------------------
---XXXX------------------------XXXX----------------------------------------------------XXXX------------------------XXXX-----------------------XXXXX--------------------E-----------------------X--------XX-------------------------XXXX------------------------XXXX-------------------------XXX-------------------------X---------------------------X--------------------------XXXX------------------------XXXX------------------------XXXX-------------------------XXX------------------------XXXX-------------------------XX-------------------------XXXX-------------------------XXX------------------------XXXXX----------------------XXXXX-------------------------XX----------------------------------------------------XXXXXX-------------------E-----------------------XX-------XXX-------------------------X--------------------------XXXX-------------------------XXX-------------------------XXX-----------------------------------------------------XXX-----------------------------------------------------X---------------------------XX------------------------------------------------------XXX-------------------------X-------------------------XXXXX--------------------E--XXXXXX-----------------------XXXX-----------------------XXXXXX----------------------XXXXXX----------------------XXXXX------------------------XXXXX----------------------XXXXXX----------------------XXXXX-----------------------XXXXX---------------------
-----------------?-------------------------------------------------------?---------------------------E---------------------------------------------------------------------------------------------------------------?---------------------------E-------------------------------------------------------?---------------------------?---------------------------?---------------------------?---------------------------E---------------------------?---------------------------?------X--------------------?---------------------------?-------------------------------------------------------------------------------------------------------------------------------------------?-----------------------------------------------------------------------------------?---------------------------?---------------------------?---------------------------E---------------------------?o--------------------------?---------------------------?---------------------------?---------------------------?---------------------------?---------------------------?---------------------------?---------------------------?---------------------------?--------------------------------------------------------------------------------------------------------------------------------------------------------------------------------------------------------------------------------------------------------------------------------------------------
-----------ooo--XXXS----?---------------o----ESS----SSS------------ooo---XXS----S--------------ooo---XXS----SSS------------ooo---XXS----SSS----------ooooo---XX-----SSS------------ooo--XXX--------------------ooo---XXS----S------------oooo----XXS----SSS------------ooo---XXS----SSS-----------Xooo--XXXS----S-------------Xooo---XXS----S-------------Xooo---XXS----S-------------ooo----XXS----SSS-----------Xooo---ESS----SSS-----------oooo--XXXS----S------------ooooo---XXS----?-------------oooo---XXS----S-------------Xooo---XXS----S---------------------------SSSS------------------------SSSS------------o-----------SSSS---------oooo----XX-----SSS?-----------ooo--XXXS----?--------------ooo---XXS----S------------oooo----E------SSS-----------Xooo--XXXS----?--------------ooo---XXS----S-------------Xooo---XSS----SSS------------oo----XXS----SSS-----------Xooo--XXXS----SS------------Xooo--XXXS----S-------------ooo---XXX-----S--------------oo---XXXS----SS------------Xooo--XXXS----S-------------Xoo----XXS----SSS-----------oooo---XXS----?-------------Xoo----XXS----SS-----------ooooo--XXXS----S-------------Xooo--XXXS----S------------oooo----XX-----SSS----------oooo----E------SSSS---------oooo----E------SSSS---------ooooo---E------SSSS----------oooo---E------SSS----------oooo----E------SSSS---------ooooo---E------SSS?---------o-------E-----SSSSS---------oooo----XX-----SSSS---------oooo----EX-----SSSS
--------------------o--------------------------oo---------------------------o--------------------------oo---------------------------o---------------------------o--------------------------ooo--------------------------o--------------------------oo--------------------------oo---------------------------o-------------------------------------------------------o---------------------------o-----------------------------------------------------------------------------------o---------------------------o-------------------------------------------------------------------------------------------------------------------------------------------o---------------------------o--------------------------oo-------------------------------------------------------o---------------------------o-------------------------------------------------------------------------------------------------------------------------------------------o-------------------------------------------------------o-------------------------------------------------------o-------------------------------------------------------o--------------------------oo---------------------------o------------------------------------------------------ooo----------------------------------------------------------------------------------o-------------------------------------------------------o---------------------------o---------------------------o-------
----------------------------------------------------------------------------------------------------------------------------------------------------S---------------------------------------------------------------------------------------------------------------------------------------------------------------------------------------------------------------------------------------------------------------------------------------------------------------------------------------------------------------------------------------------------------------------------------------------------------------S---------------------------S-----------------------------------------------------------------------------------------------------------------------------------------------------------------------------------------------------------------------------------------------------------------------------------------------------------------------------------------------------------------------------------------------------------------------------------------------------------------------------------------------------------------------S---------------------------S---------------------------S---------------------------SS------------------------------------------------------S---------------------------SSSS------------------------S---------------------------S-------------------o-------S-------------------
----------------------------------------------------------------------------------------------------------------------------------------------------S-----------------------------------------------------------------------------------------------------------------------------------------------------------------------------------------------------------------------------------------------------------------------------------------------------------------------------------------------------------------------------------------------------------------E---------------------------E-----------------S---------E---------------SoS---------E-----------------------------------------------------------------------------------E-------------------------------------------------------------------------------------------------------------------------------------------------------------------------------------------------------------------------Q-----------------------------------------------------------------------------------------------------------------------------------------------------------------------------------------------S---------E----------------oS---------E---------------SoS---------E---------------SoS---------E---------------------------E-----------------S---------E---------------SoS---------E---------------------------E-----------------S---------E---------------SoS---------E---------
-------------XXX----XXX-----XX-----------XX-----XXX--XXX-------------XXX----XXX------X-----------XXX----XXX------------------XXX----XXX--XXXXX-----SS----XX-----XXX--XXX-------------XXX----XX-------------------XXX----XXX-----XX-----------XXX----XXX--X---------------XXX----XXX------------------XXX---XXXX--X---------------XXX---XXXX--XXX-------------XXX---XXXX--XX--------------XXX---XXXX--XXXX------------XXX----XXX--XX--------------XXX---XXXX--XXXX------------XXX---XXXX--XXX-------------XXX---XXXX--XX-X------------XXX---XXXX--XXX--S--------------<>-----E--S-----------------<>------E?S-----------------<>------E?SXX----SSS----XX--<>-XXX--EXX-------------XXX----XXX------------------XXX---XXXX----------------------<>-XX---E?X-------------XXX---XXXX------------------XXX---XXXX--XX--------------XXX---XXXXX-XX--------------XXX---XXXX--XXX-------------XXX---XXXX------------------XXX---XXXX--XXX-------------XXX---XXXX------------------XXX---XXXX--XX--------------XXX---XXXX------------------XXX---XXXX--XX-X------------XXX---XXXX--XXX-------------XXX---XXXX--X---------------XXX---XXXX--XX--------------XXX----XXX------------SS--------<>-XX---E?XXX-----SS--------<>-XX---E?XXXS---SSS----XX--<>---------XX-----SS--------<>-XXX--E?------------------<>-XXX--E?--------SS----XX--<>-XX---E--------SSS--------<>-XXX--E?SXXS---SSS--------<>------E?X-------SS----XX--<>-XX---E?-XXS---SSS----XX--<>-XXX--E--
--Eo--------------E------------o-------------<>-----------Eo---------------------------o--------------------------Eo--------------E------------o-------------<>------------o--------------E-----E-----Eo--------------E------------o--------------E------------o--------------E-----------Eo---------------------------o--------------------------Eo---------------------------o---------------------------o--------------------------Eo--------------------------Eo--------------------------Eo--------------------------Eo-----------------------------------------[]----<>--------------------[]--------------------------[]------------o-------------[]-----------Eo---------------------------o---------------------------o-------------[]-----------Eo--------------------------Eo---------------------------o---------------------------o---------------------------o--------------------------Eo--------------------------Eo---------------------------o--------------------------Eo---------------------------o--------------------------Eo---------------------------o--------------------------Eo--------------------------Eo---------------------------o-------------[]------------o-------------[]------------o-------------[]------------o-------------[]------------o-------------[]------------o-------------[]------------o-------------[]------------o-------------[]-----------Eo-------------[]------------o-------------[]---------
--XXXXX----------<>-----------XXXXXX---------[]-----------XXXXX-----------------------XXXXXX----------------------XXXXXX---------<>-----------XXXXX----------[]-----------XXXXX----------<>----<>-----XXXXX----------<>-----------XXXXX----------<>-----------XXXXXX---------<>-----------XXXXXX----------------------XXXXXX----------------------XXXXXX----------------------XXXXXX----------------------XXXXXX----------------------XXXXX-----------------------XXXXX-----------------------XXXXXX----------------------XXXXXX----------------------XXXX-----------[]----[]--------------------[]-----------XXXX-----------[]-----------XXXXX----------[]-----------XXXXX-----------------------XXXXX-----------------------XXXXX----------[]-----------XXXXX-----------------------XXXXX-----------------------XXXXXX----------------------XXXXXX----------------------XXXXXX----------------------XXXXXX----------------------XXXXX-----------------------XXXXX-----------------------XXXXXX----------------------XXXXXX----------------------XXXXXX----------------------XXXXXX----------------------XXXXX-----------------------XXXXXX----------------------XXXXX----------[]-----------XXXXX----------[]-----------XXXXX----------[]-----------XXXXX----------[]-----------XXXXXX---------[]-----------XXXXX----------[]-----------XXXXX----------[]-----------XXXXX----------[]-----------XXXXX----------[]-----------XXXXX----------[]---------
-----------------[]--------------------------[]----------------------------------------------------------------------------------[]--------------------------[]--------------------------[]----[]--------------------[]--------------------------[]--------------------------[]-----------------------------------------------------------------------------------------------------------------------------------------------------------------------------------------------------------------------------------------------------------------------------------E--[]----[]--------------E-----[]--------------------------[]--------------------------[]----------------------------------------------------------------------------------[]----------------------------------------------------------------------------------------------------------------------------------------------------------------------------------------------------------------------------------------------------------------------------------------------------------------------------------------------------------------------------------------------------------------------------------[]--------------------------[]--------------------------[]--------------------------[]--------------------------[]--------------------------[]--------------------------[]-----------------------E--[]--------------------------[]--------------------------[]---------
-----------XX--XXXXXXXXXXXXX---------------XXXXXXXX-XXXX---------------XXXX------XXX---------------XXXXXXX---XXX---------------XXXXXXX--XXXX---------------XXXXXXXXXXXXX-----------XX--XXXXXXXXXXXXX-----------X---XXXX--X-XXXXX---------------XXXXXXX--XXXX---------------XXXXXXXX-XXXX---------------XXXX------XXX---------------XXXX------XXX---------------XXXX------XXX---------------XXXX------XXX---------------XXXX------XXX---------------XXXX------XXX---------------XXXX------XXX---------------XXXX------XXX----------------XXX------XXX---------XXXXXXXXXXXXXXXXXXXXX-------XXXXXXXXXXXXXXXXXXX----------XXXXXXXXXXXXXXXXXX-----------XXX-XXXXXXXXXXXXX-----------X---XXXX----XXXXX----------------XXX------XXX-----------XXXXXXXXXXXXXXXXX----------------XXX------XXX---------------XXXX------XXXX---------------XXX------XXX---------------XXXXXXX---XXXX---------------XXX------XXX---------------XXXX------XXX---------------XXXX----XXXXX---------------XXXX------XXX---------------XXXX-----XXXXX--------------XXXX------XXX---------------XXXX------XXX----------------XXX------XXX---------------XXXX-----XXXX---------------XXXX-----XXXX-----------XXXXXXXXXXXXXXXXX-----------XXXXXXXXXXXXXXXXX----------XXXXXXXXXXXXXXXXXX-----------XXX-XXXXXXXXXXXXX-----------XX--XXXXXXXXXXXXX-----------XXXXXXXXXXXXXXXXX-----------XXXXXXXXXXXXXXXXX----------XXXXXXXXXXXXXXXXXX-----------XXX-XXXXXXXXXXXXX-----------XX--XXXXXXXXXXXXX
