--------------------------------------------------------------------------------------------------------------------------------------------------------------------------------------------------------------------------------------------------------------------------------------------------------------------------------------------------------------------------------------------------------------------------------------------------------------------------------------------------------------------------------------------------------------------------------------------------------------------------------------------------------------------------------------------------------------------------------------------------------------------------------------------------------------------------------------------------------------------------------------------------------------------------------------------------------------------------------------------------------------------------------------------------------------------------------------------------------------------------------------------------------------------------------------------------------------------------------------------------------------------------------------------------------------------------------------------------------------------------------------------------------------------------------------------------------
--------------------------------------------------------------------------------------------------------------------------------------------------------------------------------------------------------------------------------------------------------------------------------------------------------------------------------------------------------------------------------------------------------------------------------------------------------------------------------------------------------------------------------------------------------------------------------------------------------------------------------------------------------------------------------------------------------------------------------------------------------------------------------------------------------------------------------------------------------------------------------------------------------------------------------------------------------------------------------------------------------------------------------------------------------------------------------------------------------------------------------------------------------------------------------------------------------------------------------------------------------------------------------------------------------------------------------------------------------------------------------------------------------------------------------------------------------
----oo--------------------------oo--------------------------oo--------------------------oo--------------------------oo--------------------------oo--------------------------oo--------------------------oo------------------------------------------------------oo------------------------------------------------------oo--------------------------o---------------------------oo------------------------------------------------------oo--------------------------oo--------------------------o---------------------------oo--------------------------ooo-------------------------ooo-------------------------oo------------------------------------------------------oo--------------------------oo--------------------------oo--------------------------o---------------------------oo--------------------------oo--------------------------oo--------------------------oo--------------------------oo------------------------------------------------------oo--------------------------oo--------------------------oo--------------------------oo--------------------------oo--------------------------oo--------------------------oo-------------------------------------------------------------------------------------------------------------------------------------------------------------------------------------------------------------------------------o------------------------------------------------------------------------------
----XXX-----------------------XXXXX-------------------------XXX------------------------XXXX-------------------------XXX------------------------XXXX-----------------------XXXXX-------------------------XXX---------------------------------------------------XXXXX--------------------E--------------------------------XXX-----------------------------------------------------XXX-----------------------------------------------------XXX-------------------------XXX---------------------------------------------------XXXXX--------------------E---XXXXX-----------------------XXXXX-----------------------XXXXX------------------------XX-------------------------XXXX-----------------------XXXXX--------------------E----XXX----------------X------------------------------------XXX-------------------------XXX------------------------XXXX------------------------XXXX-------------------------XXX---------------------------------------------------XXXXX------------------------XXXX------------------------XXXX------------------------XXXX------------------------XXXX------------------------XXXX-----------------------XXXXXX-------------------------------------------------------------------------------------------------------------------------------------------------------------------------Q----------------------------------------------------------------------------------------------------------------------------------
-----------------??------------------------------------------------------E---------------------------E---------------------------E-----------------------------------------------------------------------------------?---------------------------?-------------------------------------------------------?---------------------------?---------------------------E---------------------------?---------------------------?---------------------------?---------------------------?---------------------------?-------------------------------------------------------------------------------------------------------------------------------------------?---------------------------?-------------------------------------------------------?---------------------------?---------------------------?---------------------------E---------------------------E---------------------------?---------------------------E---------------------------?---------------------------?---------------------------?---------------------------E---------------------------?---------------------------?---------------------------E------------------------------------------------------------------------------------------------------------------------------------------------------------------------------------------------------------------------------------------------------------------------------------------------------------------------------
-----------oo---XXXS----S--------------oo----ESS----SSS-----------Xooo---XSS----SSS------------oo----XXS----SSS-----------ooo----XXS----SSS----------ooooo---E------SSS----------ooooo---XX-----SSS------------ooo---XXS----?-------------Xooo---XXS----?------------ooooo---XX-----SSS-----------oooo--XXXS----?--------------ooo---XXS----S--------------ooo---XXS----SS-----------oooo---XXXS----S-------------oooo--XXX-----?-------------Xooo---XXS----S-------------ooo----XXS----S-------------Xooo--XXXS----S------------ooooo---XX-----SSS-------------------------SSSS-----------ooo----------SSSS------------------------SSSS-----------ooo--XXXS----?---------------oo---XSSS---SSS----------oooo----X------SSS------------ooo--XXXS----?-------------Xooo---XXS----?-------------Xooo---XXS----S-------------Xooo---XXS----SSS----------oooo----XXS----SS------------Xoo---XXXS----SSS-----------ooo----XXS----S---------------oo---XXS----SSS----------oXooo--XXXS----SSS-----------ooo----XXS----SS-------------ooo---XXS----SSS-----------Xoo---XXXS----SS------------Xooo---XSSS---S-------------oooo---XSS----SSS----------oooo-----------SSSSQQ-Q-----QQQ-----------------------------------------------------QQ--------------------------QQ--------------------------QQQ-----------------------?QQQQ-----------------------------------------------------QQ------------------------------------------------------QQ-----------------
--------------------o---------------------------o---------------------------o---------------------------o---------------------------o-------------------------------------------------------o---------------------------o--------------------------oo---------------------------o---------------------------o---------------------------o-------------------------------------------------------o--------------------------oo-------------------------------------------------------o--------------------------oo---------------------------o---------------------------------------------------------------------------------------------------------------o-----------------------------------------------------------------------------------o--------------------------oo---------------------------o---------------------------o---------------------------o-------------------------------------------------------o-----------------------------------------------------------------------------------o---------------------------o-----------------------------------------------------------------------------------o---------------------------------------------------------------------------------------------------------------------------------------------------------------------------------------------------------------------------------------------------------------------------------------------------------------------------
----------------------------------------------------------------------------------------------------------------------------------------------------SS-S--------------------------------------------------------------------------------------------------------------------------------------------------------------------------------------------------------------------------------------------------------------------------------------------------------------------------------------------------------------------------------------------------------------------------------SS--------------------------S-----------------------------------------------------------------------------------S-----------------------------------------------------------------------------------------------------------------------------------------------------------------------------------------------------------------------------------------------------------------------------------------------------------------------------------------------------------------------------------------------------------------------------------SS----------------------------------------------------------------------------------------------------------------------------------------------------------------------------------------------------------------------------------------------------------------------------------------------------------
--------------------------------------------------------------------------------------------------------------------------------------------------S-S---------E-----------------S-------------------------------------------------------------------------------------------------------------------------------------------------------------------------------------------------------------------------------------------------------------------------------------------------------------------------------------------------------------------------------------E---------------SoS---------E---------------S-----------E--o----------------------------------------------------------------------S---------E-------------------------------------------------------------------------------------------------------------------------------------Q---------------------------------------------------------------------------------------------------------------------------------------------------------------------------------------------------------------------------------------------------------------------------------SoS---------E--------------------------------------o----------------E--ooo----------------------E----o----------------------E--o-o----------------------E----o---------------------------o----------------------E--oooo---------------------E--ooo----------------------E--ooo--------------------------------
-------------XXX----XXX-----X------------XX-----XXX------------------XXX----XXX------------------XXX----XXX--XX-X------------XXX----XXX--XX--------SS--------<>-XXX--E?XXX-----------XXX----XXX------------------XXX----XXX------------------XXX---XXXX-----X------------XX-----XXX--XXX-------------XXX---XXXX------------------XXX---XXXX--XX-XX-----------XXX---XXXX--XXX-------------XXX---XXXX--XX-X------------XXX----XXX------------------XXX---XXXX--XXXXX-----------XXX---XXXX--XX--------------XXX---XXXX-----XX-----------XX-----XXX--XXX-----------------<>-----E--S-------SS--------<>------E?SSXS----SS--------<>------E?--------------XXX----XXX------------------XXX----XXXX-----------SS----XX--<>-XXX--S?X-------------XXX---XXXX-----XX-----------XXX---XXXX------------------XXX---XXXX--XX--------------XXX---XXXX--XX-XX-----------XXX---XXXX--XXX-------------XXX---XXXX--XXXX------------XXX----XXX--XXX-------------XXX----XXX------------------XXX---XXXX--XXX-------------XXX---XXXX--XX--------------XXX----XXX------------------XXX---XXXX--XXX-------------XXX---XXXXX-XX-XX-----------XXX---XXXX--XXX-------SS--------<>------E?SoQQ--E-QQQQQ------------------o-----QQ-------<>-----------o----QQQQ------<>-----------o----QQQQ---Q--<>-----------o----QQQQ---Q--<>-----------o----QQQQ---Q---------------o-----QQQ------<>----------Qo----QQQQ------<>-----------Q-----QQQ------<>----------------QQQQ---Q-------------
--Eo--------------E------------o-------------XX------------o---------------------------o--------------E------------o--------------------------oo-------------[]------------o-------------<>-----------Eo---------------------------o--------------------------Eo-------------<>-----------Eo--------------------------Eo---------------------------o--------------------------Eo--------------------------Eo--------------------------Eo--------------------------Eo--------------------------Eo---------------------------o-------------<>--------------------------[]----<>--------------------[]--------------------------[]-----------Eo------------------------------------------------------Eo-------------[]-----------Eo---------------------------o---------------------------o--------------------------Eo---------------------------o---------------------------o--------------------------Eo---------------------------o--------------E------------o--------------------------Eo---------------------------o---------------------------o---------------------------o---------------------------o---------------------------o-------------[]------------------------------------------------------[]--------------------------[]--------------------------[]--------------------------[]------------------------------------------------------[]--------------------------[]--------------------------[]-------------------------------------
--XXXXXX---------<>-----------XXXXXX---------[]-----------XXXXXX----------------------XXXXXX---------<>-----------XXXXXX---------<>-----------XXXXX----------[]-----------XXXXXX---------[]-----------XXXXXX----------------------XXXXXX----------------------XXXXX----------[]-----------XXXXX-----------------------XXXXX-----------------------XXXXXX----------------------XXXXXX----------------------XXXXXX----------------------XXXXXX----------------------XXXXXX----------------------XXXXX-----------------------XXXXX----------[]--------------------------[]----[]-----XXXX-----------[]-----------XXXX-----------[]-----------XXXXX------------------------XXXXX----------------------XXXXX----------[]-----------XXXXX-----------------------XXXXXX----------------------XXXXX-----------------------XXXXX-----------------------XXXXX-----------------------XXXXXX----------------------XXXXXX----------------------XXXXXX---------<>-----------XXXXXX----------------------XXXXXX----------------------XXXXXX----------------------XXXXXX----------------------XXXXXX----------------------XXXXXX----------------------XXXXX----------[]------------------------------------------------------[]--------------------------[]--------------------------[]--------------------------[]-----E------------------------------------------------[]--------------------------[]--------------------------[]-------------------------------------
-----------------[]--------------------------[]------------------------------------------------------[]--------------------------[]--------------------------[]--------------------------[]----------------------------------------------------------------------------------[]----------------------------------------------------------------------------------------------------------------------------------------------------------------------------------------------------------------------------------------------------------[]--------------------E--E--[]----[]--------------------[]------------------E----E--[]----------------------------------------------------------------------------------[]------------------------------------------------------------------------------------------------------------------------------------------------------------------------------------------------------------------------------[]--------------------------------------------------------------------------------------------------------------------------------------------------------------------------------------------------[]-----------------------E-------EE--E---------------E--[]-----------------------E--[]----E------------------E--[]-----------------------E--[]-----------------------E---------------------------E--[]-----------------------E--[]-----------------------E--[]--------------------E--E--------E----
----------XXX--XXXXXXXXXXXXX---------------XXXXXXXXXXXXX---------------XXXX-----XXXX---------------XXXXXXX--XXXX---------------XXXXXXX--XXXX-----------XXX-XXXXXXXXXXXXX---------------XXXXXXXXXXXXX---------------XXXX-----XXXX----------------XXX------XXX---------------XXXXXXXXXXXXX---------------XXXX-----XXXX---------------XXXX------XXX---------------XXXX------XXX---------------XXXX-----XXXX---------------XXXX-----XXXX---------------XXXX------XXX---------------XXXX------XXX---------------XXXX-----XXXX---------------XXXXXXXXXXXXXXXX-----XXXXXXXXXXXXXXXXXXXX----------XXXXXXXXXXXXXXXXXX---------XXXXXXXXXXXXXXXXXXX-----------X---XXXX----XXXXXXX-------------XXXX-----XXXX-----------XX--XXXXXXXXXXXXX-----------X---XXXX-----XXXX-----------------XX------XXX----------------XXX------XXX---------------XXXX-----XXXX---------------XXXX------XXXX--------------XXXX------XXX---------------XXXX-----XXXX---------------XXXXXXX--XXXX---------------XXXX------XXX---------------XXXX-----XXXX---------------XXXX-XX---XXX---------------XXXX------XXX-----------------XX------XXX---------------XXXX------XXX----------XXXXXXXXXXXXXXXXXXXXXXXXXXXXXXXXXXXXXXXXXXXXXXXXXXXXXXXXXXXXXXXXXXXXXXXXXXXXXXXXXXXXXXXXXXXXXXXXXXXXXXXXXXXXXXXXXXXXXXXXXXXXXXXXXXXXXXXXXXXXXXXXXXXXXXXXXXXXXXXXXXXXXXXXXXXXXXXXXXXXXXXXXXXXXXXXXXXXXXXXXXXXXXXXXXXXXXXXXXXXXXXXXXXXXXXXXXXXXXXXXXXXXXXXXXXXXXXXXXXXXXXXXXXXXXXXXXXXXXXXXXXXXXXXXXXXXXXXXX
