--------------------------------------------------------------------------------------------------------------------------------------------------------------------------------------------------------------------------------------------------------------------------------------------------------------------------------------------------------------------------------------------------------------------------------------------------------------------------------------------------------------------------------------------------------------------------------------------------------------------------------------------------------------------------------------------------------------------------------------------------------------------------------------------------------------------------------------------------------------------------------------------------------------------------------------------------------------------------------------------------------------------------------------------------------------------------------------------------------------------------------------------------------------------------------------------------------------------------------------------------------------------------------------------------------------------------------------------------------------------------------------------------------------------------------------------------------
--------------------------------------------------------------------------------------------------------------------------------------------------------------------------------------------------------------------------------------------------------------------------------------------------------------------------------------------------------------------------------------------------------------------------------------------------------------------------------------------------------------------------------------------------------------------------------------------------------------------------------------------------------------------------------------------------------------------------------------------------------------------------------------------------------------------------------------------------------------------------------------------------------------------------------------------------------------------------------------------------------------------------------------------------------------------------------------------------------------------------------------------------------------------------------------------------------------------------------------------------------------------------------------------------------------------------------------------------------------------------------------------------------------------------------------------------------
--------------------------------oo--------------------------oo--------------------------oo--------------------------oo------------------------------------------------------o---------------------------oo--------------------------oo--------------------------oo--------------------------oo--------------------------oo--------------------------oo--------------------------o---------------------------o---------------------------oo--------------------------oo--------------------------oo--------------------------ooo-------------------------ooo-------------------------oo--------------------------oo--------------------------oo--------------------------oo--------------------------oo--------------------------oo------------------------------------------------------oo--------------------------oo--------------------------oo--------------------------oo--------------------------o---------------------------oo--------------------------o---------------------------oo--------------------------o---------------------------o---------------------------o---------------------------oo--------------------------oo--------------------------------------------------------------------------------------------------------------------------------------------------------------------------------------------------------------------------------------------------------------------------------------------------------------
-----------------------XX------XXXX-------------------------XXX-----------------------XXXXXX-------------------E--XXXXX--------------------E--------------------------------X--------------------------XXXX------------------------XXXX-------------------------XXX-------------------------XXX-------------------------XXX------------------------XXXX-------------------------X------------------------------------------------------XXXX-------------------------XXX------------------------XXXX------------------------XXXXX----------------------XXXXXX-----------------------XXXXX-----------------------XXXX-------------------------XXX-------------------------XX-------------------------XXXX-----------------------XXXXX--------------------------------------------X-------XXXX-------------------------XXX------------------------XXXX------------------------XXXX-------------------------X--------------------------XXXX-----------------------------------------------------XXX-----------------------------------------------------X---------------------------X---------------------------XXX------------------------XXXX--------------------------------------------------------------------------------------------------------------------------------------------------------------------------------------------------------------------------------------------------------------Q----------------------------------------------
-----------------?-------------------------------------------------------E--------------------------------------------------------------X--------------------?---------------------------?-------------------------------------------------------?---------------------------?---------------------------?---------------------------?---------------------------?---------------------------?---------------------------?---------------------------?---------------------------?---------------------------?-------------------------------------------------------------------------------------------------------------------------------------------?---------------------------E-----------------------------------------------------------------------------------?---------------------------?---------------------------E---------------------------?---------------------------?---------------------------?---------------------------?---------------------------?---------------------------?---------------------------?---------------------------?---------------------------E---------------------------?---------------------------E--------------------------------------------------------------------------------------------------------------------------------------------------------------------------------------------------------------------------------------------------------------------------------------------------
-----------ooo--XXX-----?--------------ooo---ESS----SSS------------ooo---XSS----SSS-----------oooo---X-----SSSS----------oooo----XX-----SS-------------ooo---XX-----?--------------ooo---XXS----S--------------ooo---XSS----SSS------------ooo--XXXS----S------------oooo---XXX-----S-------------oooo---XXS----S-------------Xooo---XXS----S-------------Xooo---XXS----SSS-----------Xooo---XXS----S-------------Xooo---XXS----?-------------ooo----XXS----S-------------Xooo--XXXS----?-------------Xooo---XXS----SSS-------------------------SSSS---------------------SQSSSSS------------o-----------SSSS---------oooo----E------SSS------------ooo--XXXS----?--------------ooo---XSS----SSS------------ooo---ESS----SSS----------oooo----XX-----SSS-----------Xooo--XXXS----?--------------ooo---XXS----SS-------------ooo---XSS----SS------------ooo---XXXS----SSS-----------Xooo---XXS----SSS-----------oooo---XXS----S-------------Xooo---XXS----SSS-----------Xoo---XXXS----S-------------Xoo----XXS----S--------------ooo---XXS----SS------------Xooo---XXS----S--------------oo---XXX-----S------------oooo----XXS----SS------------Xoo----XXS----SSS------------------------------------QQQQQ-QQQ-------------------QQQQQ-------------------------QQ-------------------------QQQQ------------------------QQQ-------------------------QQQQ-------------------------QQ------------------------QQQQQ------------------------QQQQ----------------
--------------------o---------------------------o---------------------------o-------------------------------------------------------o--------------------------ooo--------------------------o---------------------------------------------------------------------------------------------------------------o---------------------------------------------------------------------------------------------------------------o---------------------------o-----------------------------------------------------------------------------------------------------------------------------------------------------------------------o---------------------------o-------------------------------------------------------o-------------------------------------------------------o---------------------------------------------------------------------------------------------------------------------------------------------------------------------------------------------------o-----------------------------------------------------------------------------------o--------------------------oo-------------------------------------------------------o-----------------------------------------------------------------------------------------------------------------------------------------------------------------------------------------------------------------------------------------------------------------------------------------------
------------------------------------------------------------------------------------------------------------------------S---------------------------------------------------------------------------------------------------------------------------------------------------------------------------------------------------------------------------------------------------------------------------------------------------------------------------------------------------------------------------------------------------------------------------------------------------------------SS------------------------S-SSS-------------------------------------------------------------------------------------------------------------S-------------------------------------------------------------------------------------------------------------------------------------------------------------------------------------------------------------------------------------------------------------------------------------------------------------------------------------------------------------------------------------------------------------------------------------------------------------------------------------------------------------------------------------------------------------------------------------------------------------------------------------------------------------------------------------------------------------------
-----------------------------------------------------------------------------------------------------------------------oS-----------------------------------------------------------------------------------------------------------------------------------------------------------------------------------------------------------------------------------------------------------------------------------------------------------------------------------------------------------------------------------------------------------------E---------------------------E---------------SoS---------E---------------SoS---------E--------------------------------------------------------------------------XX-------------------------S---------E-----------------------------------------------------------------------------------------------------------------------------------------------------------------------------------------------------------------------------------------------------------------------------------------------------------------------------------------Q-----------------------------------------------------------------------------------------E------------------------------------------------------------o?------------------------ooo--------------------------ooo-------------------------oo---------------------------o-----o--------------------oo---------------------------o--------------------------ooo---
-------------XXX----XXX------------------XXX----XXX------------------XXX----XXX------------------XX--<>-XXX--X?XXXX---SSS----XXX----XXX--XXX-------------XXXX---XXX------------------XXX----XXX-----X------------XXX---XXXX--XXX-------------XXX---XXXX------------------XXX---XXXX--XXXX------------XXX---XXXX--XX--------------XXX---XXXX--X--X------------XXX---XXXX--XXX-------------XXX---XXXX--XXXX------------XXX---XXXX--XX--------------XXX---XXXX--XXX-------------XXX---XXXX--XXX-------------XXX---XXXX--XX------------------<>-----E--S-----------------<>------S?S-------SS--------<>------E?S-SS---SSS----XX--<>------E?X-------------XXX----XXX------------------XXX----XXX-----XX-----------XXX----XXX--X--XX-----SS----XX--<>-XXX--XXX-------------XXX---XXXX------------------XXX---XXXX--XX--------------XXX---XXXX--XXX-------------XXX---XXXX--XXX-------------XXX---XXXX--XXX-------------XXX---XXXX--XXX-------------XXX---XXXX--XXX-------------XXX---XXXX--XX-X------------XXX---XXXX--XXX-------------XXX---XXXX--XX--------------XXX---XXXX--XX--------------XXX---XXXX-----XX-----------XXX---XXXX--XXX-------------XXX---XXXX--X-------------------<>--------------E?QQQQ--QQQ-----------Q--o--EQQQQQ---Q---------------o----QQQQ---Q--<>-----------o--E?QQQQ--QQ---------------o----QQQQ---Q---------------o--E?QQQQ--QQ---------------o----QQQQ-------------------o----QQQQ---Q--<>-----------o----QQQQ--QQ-------------
--Eo--------------E------------o--------------E------------o---------------------------o-------------[]------------o--------------E-----------Eo--------------E-----------Eo---------------------------o---------------------------o--------------------------Eo--------------------------Eo---------------------------o--------------------------Eo--------------------------Eo--------------------------Eo---------------------------o--------------------------Eo---------------------------o-----------------------------X-----------[]----<>--------------------[]--------------------------[]------------o-------------[]-----------Eo---------------------------o---------------------------o---------------------------o-------------[]-----------Eo---------------------------o---------------------------o---------------------------o---------------------------o--------------------------Eo--------------------------Eo--------------------------Eo---------------------------o---------------------------o--------------------------Eo---------------------------o---------------------------o---------------------------o-----------------------------------------[]---------S------------------------------------------------------------------------[]-----------------------------------------------------------------S------------------------------------------------------------------------[]-------------------------------------
--XXXXX----------<>-----------XXXXXX---------<>-----------XXXXXX----------------------XXXXXX---------[]-----------XXXXX----------<>-----------XXXXX----------<>----<>-----XXXXXX----------------------XXXXXX----------------------XXXXX-----------------------XXXXX-----------------------XXXXXX----------------------XXXXXX----------------------XXXXXX----------------------XXXXXX----------------------XXXXXX----------------------XXXXX-----------------------XXXXXX----------------------XXXXXX-------------------------------------[]----[]-------XXX----------[]-----------XXXXX----------[]-----------XXXXX----------[]-----------XXXXX-----------------------XXXXXX----------------------XXXXXX----------------------XXXXX----------[]-----------XXXXX-----------------------XXXXX-----------------------XXXXXX----------------------XXXXX-----------------------XXXXXX----------------------XXXXX-----------------------XXXXXX----------------------XXXXX-----------------------XXXXXX----------------------XXXXX-----------------------XXXXXX----------------------XXXXX-----------------------XXXXXX----------------------XXXXXX-------------------------------------[]---------S-----------------------------------------------<>-----------------------[]-----------------------------------------------------------------S------------------------------------------------------------------------[]-------------------------------------
-----------------[]--------------------------[]------------------------------------------------------[]--------------------------[]--------------------------[]----[]-----------------------------------------------------------------------------------------------------------------------------------------------------------------------------------------------------------------------------------------------------------------------------------------------------------------------------------------------------------------E--[]----[]-----------------E--[]--------------------------[]--------------------------[]--------------------------------------------------------------------------------------------------------------[]-------------------------------------------------------------------------------------------------------------------------------------------------------------------------------------------------------------------------------------------------------------------------------------------------------------------------------------------------------------------------------------------------------------------------------EE-[]----E----S-------------E--------E--E---------------E-----[]-------------------EE--[]-----------------------E---------------------------E-------------]-------------E---------------------------E---------------------------E--[]-----------------------E-------------
-----------XX--XXXX----XXXXX---------------XXXXXXXXXXXXXX--------------XXXX-----XXXX---------------XXXXXXXXXXXXX---------------XXXXXXX---XXX-----------X---XXXXXXXXXXXXX-----------X---XXXX-----XXXX---------------XXXX------XXX---------------XXXX------XXX---------------XXXX------XXX----------------XXX------XXX----------------XXX------XXX---------------XXXX------XXX---------------XXXX------XXX----------------XXX------XXX---------------XXXX------XXX---------------XXXX------XXXX--------------XXXX------XXXXXX------XXXXXXXXXXXXXXXXXXXXX-------XXXXXXXXXXXXXXXXXXX----------XXXXXXXXXXXXXXXXXX----------XXXXXXXXXXXXXXXXXX-----------X---XXXX----XXXXXX--------------XXXX-----XXXX---------------XXXXXXX---XXX-----------XX--XXXXXXXXXXXXX---------------XXXX------XXXX--------------XXXX------XXX---------------XXXX------XXX---------------XXXX------XXX---------------XXXX------XXX---------------XXXX------XXX---------------XXXX------XXX---------------XXXX------XXX---------------XXXX------XXX---------------XXXX------XXX---------------XXXX------XXX----------------XXX------XXX---------------XXXX------XXX---------------XXXX------XXXXXXX----XXXXXXXXXXXXXXXXXXXXXXXXXXXXXXXXXXXXXXXXXXXXXXXXXXXXXXXXXXXXXXXXXXXXXXXXXXXXXXXXXXXXXXXXXXXXXXXXXXXXXXXXXXXXXXXXXXXXXXXXXXXXXXXXXXXXXXXXXXXXXXXXXXXXXXXXXXXXXXXXXXXXXXXXXXXXXXXXXXXXXXXXXXXXXXXXXXXXXXXXXXXXXXXXXXXXXXXXXXXXXXXXXXXXXXXXXXXXXXXXXXXXXXXXXXXXXXXXXXXXXXXXXXX--XXX
