--------------------------------------------------------------------------------------------------------------------------------------------------------------------------------------------------------------------------------------------------------------------------------------------------------------------------------------------------------------------------------------------------------------------------------------------------------------------------------------------------------------------------------------------------------------------------------------------------------------------------------------------------------------------------------------------------------------------------------------------------------------------------------------------------------------------------------------------------------------------------------------------------------------------------------------------------------------------------------------------------------------------------------------------------------------------------------------------------------------------------------------------------------------------------------------------------------------------------------------------------------------------------------------------------------------------------------------------------------------------------------------------------------------------------------------------------------
--------------------------------------------------------------------------------------------------------------------------------------------------------------------------------------------------------------------------------------------------------------------------------------------------------------------------------------------------------------------------------------------------------------------------------------------------------------------------------------------------------------------------------------------------------------------------------------------------------------------------------------------------------------------------------------------------------------------------------------------------------------------------------------------------------------------------------------------------------------------------------------------------------------------------------------------------------------------------------------------------------------------------------------------------------------------------------------------------------------------------------------------------------------------------------------------------------------------------------------------------------------------------------------------------------------------------------------------------------------------------------------------------------------------------------------------------------
------------------------------------------------------------------------------------------------------------------------------------------------------------------------------------------------------------------------------------------------------------------------------------------------------------------------------------------------------------------------------------------------------------------------------------------------------------------------------------------------------------------------------------------------------------------------------------------------------------------------------------------------------------------------------------------------------------------------------------------------------------------------------------------------------------------------------------------------------------------------SSSSSSSSSSSSSSSS----------------------------------------------------------------------------------------------------------------------------------------------------------------------------------------------------------------------------------------------------------------------------------------------------------------------------------------------------------------------------------------------------------------------------------------------------------------------------------------------------------------------------------------------------------------
--------------------------------------------o----------------------------------------------------------------------------------------------------------------------------------------------------------------------------------------------------------------------------------------------------------------------------------------------------------------------------------------------------------------------------------------------------------------------------------------------------------------------------------------------------------------------------E--E----------------------------------------------------------------------------------------------------------------------------------------------------------------------------------------------------------------------------------------------------------------------------------------------------------------------------------------------E---------------------------------------------------------------------------oo-----------------------------------------------------------------------------------------------------------------------------------------------------------------------------------------------------------------------------------------------------------------------------------------------------------------------------------------------------------------------------------------------------------------------------------------------
---------------------------------oo--oo---oo----------E---------------oo---------ooo--------------------------------Eoooo------------------------ooo----------------Eooo------------------------------Eoooo---------------------------------------------Eoooooo-------oo---oooo-----Eooo-----oooo-oo------------oooo--oo----------oo----------------------------------------o----ooooooooooo---------ooo------------------------------Eoooo-------------------------------------------------------------------------------o-------------oo---------------o---oo----------XXX-XXX---------------E---------------------------------------------------------------------------------------------o-----------------------------------------------------------------------------------------------------------------------------------------------------------------------------------------------------------oo---oo--oo---------oXo-----------------------------oo--oo--ooooooo---------XXX----------------------------oo---------------------oo------------------------------------oo--------------------------Eoooo------------------------------------------oooo----------------ooo-------------------------------------ooo-------oooooo------------------------------------------oo------------------------------------------------------oo------o---o---------------oooo------------------------------------------------------------------------------
QQ----------------Q--------------------------------XXXX------------------oo----XXXXX---------SSSSSSS------SSS-------XXXXXX------------------X---XXXX----------------XXXX-SS-----------SQQ----SSS------XXXXX-------------------------ooo---ooX----ooo----XXXX-XXXX-----------XXXX----XXXX-----XXXX--------ooo--XXXXXX-XXXXX------------o---XXXXo-----------------------------XX----------------------XXX-------------------------------XXXXXX---------------------------------------------------QQQ-----------------------XXX-----------XXXX----oo---------------------------------------------SQS--SQSSS--------oo----XXX----E-------------------Q-Q-----------------ooo---------------------------oXXX----------------------------------------------------------------------------------------------------X-----------------------------------------------------XXX--------------------------------XX---X--------------o---XXXXXX------------------o---XXXXXXX--------------------XXX-----------------------------------------------------oo------------XX---------XXX---------XXX--------------------------XXXXX----------------------o----XXX-----Xo-----XXXX-----------------XXXX------------------------------------XX------------------oo------------------------------------------------------------------------Q-----------------XXX--------------------Xoo--XXXXXX--------------Q----------SS----------SQQQ------------------------------------
-----------------------------------------E-----------------XXX-------------------------------------------------------------------------------------------SS-------------------------------------------------------------------------XX--------------------------------------------------------------SSS-XXX-----------------------------------------------------------------------------SSS-XXX-----------------------------------XX--------------------------------------------------------------------------------------------------------------------------------------o---------------------------------------------------------------------------------------------------o--XXE-----------------------------------------------------------------------------------------------------------------------X-----------------------------------------------------X----------------------------------------------SSSSS--------------------E--ESSSS------------------------SS--XXX--------------oE-----o------------XX---------------------------------------------------------------------SX-----------------------------XX-------------XXX---------------------------------------------------------------------------------------E--SSS---------------------------------------------------o-------------------------------------------------------E--SSS-----------X------------------------------------------------------------------------------------
---------------------------------XXX----XXX--X------------------------------------------------S-----------------------------------------------------------------XXX------------------------------------------XXX------------------------------------------------------------------------------------X----------------------------------------------------------------------------------XXXX--------------------------------------XXX-------------------------------------------------------------------------------------------------------------------------------------XXX-------------------------------------------------------------------------------------------------XXX-oo----o--------X--------------------------------------------------------------------------------------------------------XXX----X------------------------------------------------X------------------------------------------XXXXXXX--------------------XXXXXXXX--------------------XXXXXXXX------------------XXX----XXX-XXXXXXXX-------------------------------------------------------------------------oo----o--------------------------XXXXX---o-----XXXXX---------------------------------------------o---------------------------------XXXXXXXXXX--------------------------------------------------------------------------------------------------------XXXXXX-X--------------------------------------------------------------------------------------------------
----------------------------------------------------XXXX-------XXXX---------------------------S----------------------------------XXX-----------------------------------X----------------------------------------------XQX---------------------------------------------X------------------------------------------------------XXXX-----------------------------------------------------------------------------------------------XXXX------------------SQX-----------------------------------------------------------------------------------------------------------------------------------------------------------------E---------------------------------------------------------XXXXX---------------------S-SSSSQ--------------------------------XXX-------------------------------------------------XXX----------------------------------------------------XXSS-----------------E----------------------------------------------------------------------------------------XXX-XXXX---------------------------XX---------X-----------------------------------------------------------------XXX--------------------------X-----XXX-----------X------XXXX---------------------------------------o------------------------------------------------------o-------------------E------XXXXX----------XXX------------------------------------------------------------XXX------------------------------------------------------------------------------------
QQQ-------------S---------------E-----------------------XXXX---------XX------X-------------XXXX--S-----Q--------XXXXXXXXXXX------------------XXXX---XX--o-----------------Q----Q-----Q??SS--------XXXXX-XXXXX-------------------XXXX---XX----XXX-----X------XXXX-----------------XX-------XXXXXXXX--o---------------XXX------------------XXXXX-----------XX----------<>-------XXXX-XXX-----------------------------------------XXXXXXXXXXXXXXX----------------------------X--------------------QQQ---Q------XX----------XXX----------XXX---XXXX--XXX-----------------------------------Q-----Q--S----SSS----XXX----XXX---XXX---------------------QQQQQ-----------QQQ---XXXX---------------------XX---XXX-----oo--------------------------------------------------------------------------------X---------XXX----X---X------------------------------------------XXXX-------------S?SS<>-----------E---XXXXXXXXX--------------------XXXX------o-----------------XXXX-----------------------E-EE---------------------------------XXXXX--------E-XXXXXXXXXX-----------------XXX---XXXXXXXX-------------------------XXXXX----------------Xo----------------------------E------------XXX--XXXX--------------------------------XXXX--------o----------XXXXX-----------------<>----<>---------------------------------XXXX-XXXX----------------Q-X-XX-----------------------Xo---------------------XXXX----------------Q----Q-----------------------------------
----------------------------XXXXXX-XXXX---XXXXXXX----------------------------------------XXXXXX---------------------------------------------------------------------------------------------------XX----------------------------------------------------------------------------------------------------------------------------------------------------XXX----------[]-------------------------------------------------------XXXXXX-------------------------------------XX--------------------------------XXX-----------------------------------------------XXXXXX?--XXXX?----X------------------------------------------------------------------------------------------------------------------------------E------------------------------------------XX-----------------------------------XX-------XXXXX-------------------------------------------XX----XXXXXXX----------------[]----------<>--------------------------------------------------------------------------------------XXXXXXXXXXXX------------------------------------XXXXXXXX-----------------------------------------------------------------------------------------------------------------<>-------------------------XXX?XSX------------X-----------------------------------------------------[]----[]---------------------------------------------------------------------------------------------------------------------------------------------------------------------------
---------------------------X------------------------------------------------------XX----XXXXXXX----S--------X-------------------------------------XXXXXXXX----XXXX--------------------------------XX-----------XX---------------------------------------XXXX------------------------------------XXXXX-------------o-----XXX----------------------------XXXXX---------[]-------------XXX--------------------------------------XXXXXXX------------------------------------XXXX------------------------------XXXX---------------------------------XXX-----------------------------------------------------------------------------------------------------------------------------------------------XX------XXXXXXX----------------------------------------XXo----------------------------------XXXX-----XXXXXX-------XXXXX-----------------------------XXXX--EXXXXXXXX----------------[]----------[]--------XXXXXXXX----XXXX------------XXXXXXXXX----XX-----------------------------------------X-----------------------------------o------XX-------------XXXXXXXX--------------------------------------------------------------------XXXX-------------------------[]-----------------------------------------------------------XXXX-XXXX------------------------------[]----[]----X----------------------------------------------------------------------------------XXXX--------------------------------------------------------------------------------
------------------------------------------------------XX--------------------------------XXXXXX--------------X----------------------------XXoXXXX----------------------oo-----------E-E--------E---XX--------------------------oo-----------------------------------------------------XXXXXXX---------------------XXX----------------------------------XXXXX----------[]----E-------------------------XXX------E-------------XXXXXXXX-------------------------------EE--XXXX-E---E-----EE-E---------------XXXXX-----------------------------------------------------------------X-----------E----------------------------------------------------------EE---------------------------------------X---------------------------o-------E------------------oo-XX-------------------------------EE-XXXX----XXXXXXX-----------------------------------------XXXX--XXXXXXXXX----------------[]---E------[]---------------------------XXX-------------------------XXX-------------------------XXX--------------------------oo-------------XX-----------------------------------------------------------------XXXX-----oo------------------ooo--------------------------XX-[]---------------------------------------------------X-------------------------------------------E--[]----[]------------------------------------------------------------------------------------XXo----------------------------EE-E------------------------------E---------------------
XXXXX------XXXX-XXXXXXXX------------------------------X-----------------------------XXXXXXXX---------XXXXXXXXXXX-------------------------XXX--------------------------XXXXXX-XXXXXXXXXXXXXXXXXXXXXXX-------------------------XXX----------------------------------------------------------------------------------------------------------------XXXXXXXXXX--------XXXXXXXXXX----------------------------XXXXXXo--XXXXX----XXXXXXXXX---------------------------XXXXXXXXXXXX---XXXXXXXXXXXXXXXXXXXX---XXXXXXXXX---XXXXXXXX--------------------------------XXX---------XX----XXXXX-XXXX-XXXXXXXXXXXXXXXXXXXXX-X----------------------------XXXXXXXXXXXXXXXXXXXXXXXXXXXX------------------------------------------------------XXXXXXXXX-XXXXXX-----------XXXXXXXXXX-----------XXX--X-X--XXXXXXXXXXXX-XXXXXXXXXXXXXXX-------------XXXXXXXXX----XXXXXXXXXXXXXX---XXXXXXXXXXXXXXXXXXXXXXXXXXXXXXXX-XX--XX---------------------------------------------------------X-----------------------------------------------------XXX-----------------------------------------------------------------------------------------XX------------------XXX-----------------------------XX---XXXXX----------------X-XXX----XXXXX---XX---XXXXXXX----------------------------XXXXXXXXXXXXXXXXXXXXXXXXXXXX---------XXX-------------------------XXXXXXXXXXXX------X-------------------------XXX-----------------XXXX-------XXXXXXXX----XX---XXXXXXXXXXXXXXXXXXXXX---X----XXXXXXXXX-
