--------------------------------------------------------------------------------------------------------------------------------------------------------------------------------------------------------------------------------------------------------------------------------------------------------------------------------------------------------------------------------------------------------------------------------------------------------------------------------------------------------------------------------------------------------------------------------------------------------------------------------------------------------------------------------------------------------------------------------------------------------------------------------------------------------------------------------------------------------------------------------------------------------------------------------------------------------------------------------------------------------------------------------------------------------------------------------------------------------------------------------------------------------------------------------------------------------------------------------------------------------------------------------------------------------------------------------------------------------------------------------------------------------------------------------------------------------
--------------------------------------------------------------------------------------------------------------------------------------------------------------------------------------------------------------------------------------------------------------------------------------------------------------------------------------------------------------------------------------------------------------------------------------------------------------------------------------------------------------------------------------------------------------------------------------------------------------------------------------------------------------------------------------------------------------------------------------------------------------------------------------------------------------------------------------------------------------------------------------------------------------------------------------------------------------------------------------------------------------------------------------------------------------------------------------------------------------------------------------------------------------------------------------------------------------------------------------------------------------------------------------------------------------------------------------------------------------------------------------------------------------------------------------------------------
-----------------------------------------------------------------------------------------------------------------------------------------------------------------------------oo-------------------------------------------------------------------------------------------------------------------------------------------------------------------------------------------------------------------------------------------------------------------------------------oo----------------------SSSSSSSSSSSSSSSSSSSSSSSSSSSS----------------------------------------------------------------------------------------------------------------------------------------------------------------------------------------------------------------------------------------------------------------------------------------------X-------------------------------------------------------------------------------------------------------------oo------------------------------------------------------------------------------------------------------------------------------------------------------------------------------------------------------------------------------------------------------------------------------------------------------------------------------------------SSSSSSSS---SSSSSSSSSSSSSSSSS--------------------------------------------------------------------------------------------------------------------------------------------
-----------------------------------------------------------------------------------------------------------------------------------------------------------------------------XXX-------------------------------------------------------------------------------E----------------------------------------------------------------------------------------------------------------------------------------------------------------------------------------------------XXX--------------------------------SSSSSSSSSSSSS----------------------------------------------------------------------------------------------------------------------------------------------------------------------------------------------------------------------------------------------------------------------------------------------------------------------------------------------------------------------------------------------------------------XXXX----------------------------------------------------------------------------------------------------------------------------------------------------------------------------------------------------------------------------------------------------------------------------------------------------------------------------------------------------SSSSSSSSSSSSSSS---------------------------------------------------------------------------------------------------------------------------------------------
-------------------------------ooo-----------------------------------------------ooo--------------------------------------------------------ooo-------oo--oo--------------------------------------------------------------------------------------------ooo---XXXXXXXX-----------------------oo---oo------------Eooo----------oo---------Eoooo-------o----oo--oo--------Eooo----Eo------------------oooo--------------------------------------------------------oo--------------ooo-----ooo------------SSSSSSSSSSSSS-------Eooo-------------------------------------ooooo-------------------------------------------------------------------------------------------XXXX-----o-------------------------------------o---oo----------------------------ooo----Eoo-------------------------ooo--------------------o---------Xo--X-----------------------ooo---------ooooooo--------------------------------------------------------oo----------------------------------------------------------------------------------------------------------------------------------------------------------------------------------------------------------------------------------Eoo----o---------------o--oo----------------------------------oo---------Eoo--------------------------------------------XSSSSSSSSSSSSSS-oooo-----ooo-ooo-----E----------------------------------------------------------------------------------------------------------------------
-------------------X-------X---XXX----------------XXXXo-X-----XXXXX-------oooo---XX--X-------------------------------------SSS--------------------------------------X---XX------------------SS-------------------------------------ooo--XXXo----------XXX----------------------E------------XXX-----------------XXX------o---XX------oo--XXXXX----XXXX-----X-------oo--XXXXX----XXo----------oo----XXXXXX---------------------------XXX------------------------------------------XXXX---XXXX----Q-S----SSSSSSSSSSSSS-------XXXXX-------------------------------------XXXX--------------------QQQQ---------Q---------------------------------------------------------------------------------------------XXX-----XX---------------oo----------oo----XXX------XXXX-----------------------XXXX---------------------XX----------------------Xoo-ooo------------------XXXXX-------SSS--SSSS-----------------------------------------------------------oo----oo---XXX--------------------------------------------------Q--------------------------------------XXX------XXX------------------------------------------------------------------------------------------------XXX-----------------XXX---XX-----------------------------------------oo--XXXX---XX--------------------------------------SSSSSSSSSSSSSSS-XXXXX----------------XXXX---o------?-?--E--------------------------------XXXX----------------------------Q----------------------------------
--------------------------------------E--SS---------------------------S-----------------------o-------------------------------------------------E--------S-----------------------E-------------------------------------------------XXX-------X-----------------------------------XX-----------------SSS-----------------------------XX----------------------SSS-------------------------------X-------------------------------------------o------------------------------------------------------------------------------------------X---------XXX-------------------XXX--------------------------------------------------------------------------------------------------------------------------X------------------------------------------------------------------XXX------------------------XXX-----------------------o--S-S-XXX----------------------S---------------------------------------------------------------------------------------------------------------------------------------------------------------------------------------XXX---------------------------------------------------------------------------------o---o---------------o--------------E--SSSSS---------------------o--------------------XX--------SX----------------------------------------------------------------------------------S-S-------------------X------XX------------------------------------------------------------------------------------------------
---------------------------------XXXXXXX-Xo---------------------------------------------------------------------------------E------------------XXXXXXX--XXX-----------------XXXXXX----------------------------------------------X----------------------------------------S--------------------------XXX-----------------------------------------------XXXX--XXX---------------------------------------------------------------------------XXXXX---------------------XXXX-------------------------o----------------------------------------------------------------------------------------------------------------------------------------------------------------------------------------------------------------------------------------------------------------------------------------------XXX----------------------XXX-X----------------------XX-------------------------------------------------------------------------------------------------------------------------------------------------------------------------------------------------------------------------------------------------------------------------------XXX-XXX-----------XXXXX--o---------XXXXXXX----------------------XXX-------X---------------XXXXX-X----------------------------o----------------oo-----------------------------XXXXXX-X------------------------------------------------------------------------------------------------------------------------------
-------------------------o--------------------------------------------------XXXX--------------------------XXXX------------XXS--------------------------------------------------------------------------------------------------------------XX----------------------------S----------------------------------------------------------------------E--------------------XX-----------------------XXXX-----------------------------------------------------Q------------------XX---------------------------------------------------------------------------oo----------------------------------------------------------------------------XXX------------------------------------------------------X------XXXX-------------------------XXX--------XXX----------------------------------------------------------------------------------XXX----XXX------------------XXX-------------------------------------------------------------------------------------------------------------------------------------------------------------------------------------------------------o---------------------------------------------------------X-S-----------------------------------------------------------------------------------------------------XXX-------------------------XXX-------------------------------------------------------------------------------------------------------------------------------------------------------------------------------
----------------------------XXXXXX------------------------XXXXXXXXXXo-o--------------------------------------------------XXXX-----------XXX-XXX------------------XXXXXXXXXXX-----------------XX------XXXX-----------------------XXX--XXXX------------------------------XX---------------XXXXXXXXXX-------------------XXXXX--XX------------------XXXXX-------o---------------XXXXX--XXXXXXXX-----------XX---------------------------X---XX--------------------------------------------XX-------SSSSSS-----SSSSSSSSSSSSS--XX-XXXX--------XX-X-----------------XXXXXX---------------QQQ---------QQQ-QQQ---------X------------E------------------------------------------------------------------------------XXXXX-----XXX------XXXXX------XXX------------XXXXXXXXXXXX------------------XXXXXXXXXX---------------------XXX------------------------XXXXXXXX--------------------------------------------------------------------------XXXX--------XXX----XXXXXXXXX-------------------------------------------------Q--QQQQ--------------------------------------------------------------------------------------Q-----S-S--------------XX-----------------------------XXXXXXXXX---o-o--------------------------------------------XXX------------------XXX--XXXXXXX--------------------SSQQS-------ESSSSSSSSSSSS----XXXX------------------XXXX--------SSS-Q-------------------------------XXXXX--------Q------------Q-----Q----------Q--Q----------------------
----------------------------------------------------------------------E---------------------------XXXXX----------------EXXXXXSSSS-------XXX---------------------------------------------------------------------------------------------------------------------------XXX--XX----------------------------------------------------------------------------------------------------------------------------------XXXX----------------X----------------------------------------------------------E---SS-------SS------SSS----------------XX--X------------------------------------------------------------------X---------XXXXXXX?-------------------------------------XXXXXX---------X?-?---------------------------------------------------------------------------------------------------------------------------------------XX------------------------------------------------------S------------------------------------------------------------------------------XX--------------------------------------------------------------------------------------------------------------------------------------------------------XXXX---------XXXX-------XX-----------------------------------XXXXX-----------------XX?-------------------------------------------------------------------E-------------------------------------XXX----------X-------------------------------------------X---XX-----------------------------------------------------------
-----------------------------------X----------------------------XXXXXXXX----------------------------------------------XXXXXX---------E-XXXX-----XXXX------------------o------XXXXXX--------------XXX----------------------------XXX---------------------XXXX---------XXXX--XX------------------XX-X-------------------------------------------o------XXXXXXXXX---------------------------------------------------------------------X------XXXXXXXX----------------XXXXXX--------------------------SSS-----SSS------SSS----------------XX--X-----------------------------------------------------------------------------------------------------------------------------------------------------------------------------------------------------------------------------------------------XXXXXX------XXX-----------------------------------X------------------------------------XX------------------------------------------------o-XXX------------------------------------------------------------------------------------------X-------------XXXXX-XXXXXXX---------XXXX----------------------------------------------------XXXXX-----------------------------------XXXXXXXX---------------Q-----------------X--------X-------------------------o-----------------------------------XXX---------------------------------------------o----X-------------------------------------------X----------------------------------------------------------------
----------------------------------------------------XXXXXXXXXXX-----------------------------------------------Xo-----XXXXXXX--SS------X-XXX--------------------------XXX--------------------------------------------------------------------------------------------XXXXX--X------E--E---------------------------XXX-------------------------XXX------------------------------------------------------XX---------------------------X------------------------o-oo---------------------------o-----------------oo-S-------------------X-XX--X----------------------------------------E----------E-------EE-----X-----------------------ooo----------------------------------------------------------------------------------------------------------------------------------------EEoo-------------------------XXX--------------------------XX-------------------------XXX--------XX---SSS-----------X------------------------------XXX--------------------------------------------------------------------------------------------------------E---------------------------------------------------------E----------------------XXXXXX---------------------------E-------------------------XXX-------------------X--------------------------------XXXX-------------------------oooEE---XXXX---------------E----------------------------XXX---X-----------------E---X---------------------X---------------------------------------------------E---------E--
XXX------XXXXXXXXXXXXXXX--XX--------------------------XX-------------------------------------XXXX-------------XXXXXXXXXXXXX-------XXXXXXXXXX--------------------------------------------------------XXX------XXXXXXQ-----X---XXX-------------------------------XXXXXXXXXX--X--XXXXXXXXXX---------------------------X------------------------------------------------------------------------------------XXXXXX-----XX----XXXXXXXXX-X------------------------XXXX--------------------------XXXXXXXXXXXXXXXXXX-XXXXXXXXXXX--------XXXXXXXX--X--XX---XXXX-----------XXXX---------XXXXXXXXXXXXXXXXXXXXXXXXXXXXXXXXXXXXX--XXX------------XXXXXXXX------XXXXX------X-X-XXX-----X---XXXX-----------XXXX--------------------------------------------XX------------------------------XXX-XXXX-----------------------------------------------------XXX----------------------------XXXXXXXXXXXE---XXXXXXXXXXXXX----XX----XXXX-----X-----XX--------------------------------XXX-------X-------XXXXXXX---------XXXXX--XXXXXX----XX-XXX---XXXXXXXXX---------XXX-----------------XXXX----------XXX--XXXX----------X-XXXXXXXXXXXXXXXXXXXX--XXXXXXXXXX--XXXXX-----------------XXXX-------------------------------------XXX-XX-XXXX-X----------------------------------------------------------XXXXXXXXXXXXXXX-XX-XXXXXXXXXXXXX----------------------------XXXXXXXXXXXXXXXXXXXXXXXX-XX---------XXX--------X---XXXX-XXXXXXX----XXXX---XX--------XXXXXXXXXXXXXXXXXXXXXXXXX--X
