--------------------------------------------------------------------------------------------------------------------------------------------------------------------------------------------------------------------------------------------------------------------------------------------------------------------------------------------------------------------------------------------------------------------------------------------------------------------------------------------------------------------------------------------------------------------------------------------------------------------------------------------------------------------------------------------------------------------------------------------------------------------------------------------------------------------------------------------------------------------------------------------------------------------------------------------------------------------------------------------------------------------------------------------------------------------------------------------------------------------------------------------------------------------------------------------------------------------------------------------------------------------------------------------------------------------------------------------------------------------------------------------------------------------------------------------------------
--------------------------------------------------------------------------------------------------------------------------------------------------------------------------------------------------------------------------------------------------------------------------------------------------------------------------------------------------------------------------------------------------------------------------------------------------------------------------------------------------------------------------------------------------------------------------------------------------------------------------------------------------------------------------------------------------------------------------------------------------------------------------------------------------------------------------------------------------------------------------------------------------------------------------------------------------------------------------------------------------------------------------------------------------------------------------------------------------------------------------------------------------------------------------------------------------------------------------------------------------------------------------------------------------------------------------------------------------------------------------------------------------------------------------------------------------------
--------------------------------------------------------SSSSSSSSSSSSSSSSSSSSSSSSSSSS--------------------------------------------------------------------------------------------------------------------------------------------------------------------------------------------------------------------------------------------------------------------------------------------------------------------------------------------------------------------------------------------------------------------------------------------------------------------------------------------------------------------------------------------------------------------------------------------------------------------------------------------------------------------------------------------------------------------------------------------------------------------------------------------------------------------------------------------------------------------------------------------------------------------------------------------------------------------------------------------------------------------------------------------------------------------------------------------------------------------------------------------------------------------------------------------------------------------------------------------------------------------------------------------------------------------------------------------------------------------
--------------------------------------------------------------------------------------Eo----------------------------------------------------------------------------------------------------------------------------------------------------------------------------------------------------------------------------------------------------------------------------------------------------------------------------------------------------------------------------------------------------------------------------------------------------------------------------------------------------------------------------------------------------------------------------------------------------------------------------------------------------------------------------------------------------------------------------------------------------------------------------------------------------------------------------------------------------------------------------------------------------------------------------------------------------------------------------------------------------------------------------------------------------------------------------------------------------------------------------------------------------------------------------------------------------------------------------------------------------------------------------------------------------------------------------------------------------------------
-----------------------------------------------oo-------------------------------------XXX------------------------------------------------------------------------------------o---oo-------------ooo---------------------------------------------------------o-o-------------------?---------------------------------------------------------------------------------------------------oo-------------oo-------------------------------o------------------------------------------------------oo---------------o---------------------------------------Eooo---------------------------------------------------oo---------------------------------------------------------------------------------------------------------------------------------------------------------------------------------------------------------------------------------oooo--oo--o---------oooo----------------------------------------------------------------------------------------------o--------oooooooo--------------------------------------------------------------------------------------ooo------o-----------------------------------o---------ooo-------oo--oo-----------o----------------oooo------o-----Eooo----------------Eooo----------ooo-oo---------ooo-Eoo-o----oo--oo---------ooo-------X-------------------------ooo--oo---------------o--------------------------------------------------------o---------oo--oo--------oooo----------------------------
------------------------XXX--------------------------------------------------------------------------------------------------------------XX-o--------------------------------------------------XXXX-----------S--------------------------------------XX------XXXXo-----------oo--XXX-----------------XXXX----------------XX---------------XXX-----QQQXXX------------SSS-------XXX------------------XXXX-------SS--------------QQQQ--------------------------oo-------E--E--------------------XXXX-------Xo---XXX--------Q--Q-------Q-Q---------SSS---XXXXXX---------------XXX-------------------------XX-------o-----X--------------------------XX----------X----------QQQ-------------Q-------------SSS-----S-----QQQQQ---------------------XXX------------?SQSS-----SQ----QQQQ---------------------------------------------------------------XXXXX---------ooo--XXXXX------------------------oo----Q-----------QQQ---QQSSS----------------E------------oo---------------------X--XXXXX--------------------------------------------------------Q----------------------------XXXX----------------------------------------XXXX-------XXXXX------------ooo---XXXX-----------------XXXXX----XXX---XXXXXX--------ooo---XXXXX-----------------------XXXX--XXXXX-------------oo--XXXX----Q----------S-------------X----oo----------------XXXo---------------------------------------------------------------------------------XXXX-----------Q----------------
-------------SX-------------------------------------------------------------------------------------------------------------------------------------------------------------------o--SX--------------------------------------------------------------------------------------------------------------------------------------------XXXX--------------------------------------------------S------------------------------------------------o---o--------E------------------X----o--------X-X-----------------------------------------------------------------------------------------------------------------------o------E----------------------------XX-----------------------------------------------------------------------------------------------------------------------------------------o-------------------------------------------------------S---X--------------------------------------------------------------------------------------------XX----------------------------------------------------------------------------------------------------------------------o---o----------------------------------------------------------------------------------------------------------------------XXX----------------------S--XX----------------------S----------------------------------X--------------------SS--XXX-----------XXX-------oo------------------------------------------------------S------------------------------------------
---------XXX-oo-----------------------------------------------------------------------------------------------------------------------------------------------------------------XXXX-oo----o--------------------------------------------------------------------------------------------------------------------------------------------------------------------------------------XXXXXX-X-------------------------------------------X---XXX-XXX------XXX---------------------XXX--XX-----------------------------------------------------------------------------------------------------------------------XXXX-XXX-XXX-------E-----------------------------------------------------------------------------------------------------------------------------------------------------------XX----XX-------------------------------------------------------------------------------------------------------------------------------------------------------o------XXXXXXX--------------------------------------------XXXXXXXXXX---------------------------------------------------XXXXXXX---------------------XXXX------------XXX-------------------------------------XXX-----------------------------------------------------------X---------------------------------------------------------------XX-------------------------------------------------------------------------------------------X----XXXXX----------------------------------------------
------------------XXX----XXX----------------------oooo------------------------------o-----------------------------------------------------------------------------------------------------XXX----XX----SS--------------------------------------------------------------------XXXXX------------------------------------------------------------------------------------------------------------XXX-------------------------------------------------------------XX---------------------------------------------------------------------------------X-------------------XXX----------------------------XX---------------------XXXXXX--------------------------------------------------------------------------------------------------------------------------------------------------------------X----------------------------------------------------------------------X-----------------------------------------------------------E----------------------XXX----------------X-XXX----XX-------------------------------------------XX------------------------------------------------------------X------------------------------------------XXXX---------X-----------------XX----------------------------------XXXX------------------------XXX-----X------------X--------XXXXX----------------------XX---------E------------------------------------XX---------------------------------------------------------------------------------------------------
--XXXXXXXX---------------------EE---------------------------Q---------------------------------------------------------------------------------------------------------------XXX-----------------------E--X----E----------------------------------XXXX--XXX--XXXXX-------XXX---------XXXX---------------XXXXXXX------XXXXXXXXXXX----------------?-X?-XXXX----------XXX--------XXXX-------------------------------------------XXX--QQ?-------------------------------------------------------QXXX-----------XXX---XXXXX---QQQ----Q---QQQ---QQQ----XXX-XXXX--XXX---------------XXXX-------------------XXX---------------------------------------XXXXXX-----------------QQQQQQ----------------------Q----Q-----QQQ---QQQ--QQS----QQ----------------------------SSSQS-----QQ-----QQQQQQ----XXXX--------------------------------------------------XXXXXXXXXX---------------------------XXXX-------X---XXXXQQQ-----------QSSQQQQ--------<>--------XX---------------------------o------------------------------------------XXo--------------------------QQQ-------------SQQ--------------------------------XXX--XXXX------------------------XXXX----------------------------------------------------XXXXXXXXXXXXXXX-----------XX----X-----------------------XXXXX--------------------------QS----------XXXXXX--SS---XXXXXXXXXX-------------------o--E-----------------------S---------------------------XXXXX------------------------------Q--QQ-------Q-Q-----Q
----------------------------XXXXXX------------------------------------------------------------------------------------------------------------------------------------------------------------------o<>--X---<>--------------------------------------------------------------------------------------------------------------------------------------------------XXX----------------------------------------------------------------XX-------------XX-----------XX------XXX--------------------------------------------------------------------XXXX----------------------------------------------XXXXX-X----------------------------------------------------o-------------------------------------------------------------------------------------------S---------------------------------------------------------X-------XXXXX--------------------------------------------------------------XXXX--------------------------------[]-------------------------------------------------------------------------------XX--------------------------------------------------------------------------XXX---------------------------------------------------------------XXXXXX--------------------------------------------------XXXXX-------------------------------------------------------------XX--XXXXXXX------------------------------------XXXXXXXXX-------------------------XX-------------E-------------------------------------------------------------
--------------------------------------------------------------------------------------------------X----------------XXXXX------------------------------------------------XXX-------------------------X[]--X---[]------------------------------------------------------------o------------------------------------------------------------------------------------XXXXX--------------------------------------------------------------------------------------------------------------------------XXXXX-----------------X------------------------XXXXX---------------------------------------------XXXXXXXX-----XXX-------------------------------------------XXXXX----------------------------------------------------------------------------------E-----S-----------------------------------X---------------------X-------------------------------XX------------------------------------------------------------------------X----[]-------------------------XXX----XX-XXX----------------------------------E-----XXXXXXX-XXXX-X---------------------------------------------XXXX----------------------------XXXXXXX-------------------------------------------o-----X------------------XXX-----------------------------------------------------------------------------------------------XXXXX-XXXXXX-----------------------------------XX------------------X----XXX------XX-E-----------<>-----------XXX-----------------------------------------------
-------------------------Xoo-------------------------------------E--------------------------------X----------E----------------EE-E--------E------------------------------------------------------XXX[[]------[]--------------------------XX-------------------------------XXX--------XXX-----------------------------------------------------------------------XXXXX---------------------------------XXX---------E-E-----E-----------------------------------o-o------------------------E-E------------o------------------------------E--E---XXXXXX-------------------o------------------------XXXXXXXXX----------------------------------oo------------------------------------------------EE-------------------E--------------------------------------------------------------------------------------------XX--X--------------------------------------------------XXX----------------------------EE----------------------XX---[]----------------------ooo-------------------------XXX-------------------X----XXXX-----------------------------E-----------E---E-----------------------------------------------------------------o-------------------------XXX---------------------------------------------------------------------------------XXX-------------------------XXX--------XXXXX--XXXXXX--------------------------------XXX---------------------------------XXX-------------[]-----------------------------------------------E-E-----------
-------------------------XXX-------------XXXXXXXXX---XXXXXXXXXXXXXXXXXXXX-------XXXX---XXX---XXXXXXX--XXXXXXXXXXXX--------XXXXXXXXXXXXXXXXXXXXXX-XXXXXX--XXXXXX-------XX---------------------------XXXX--XXX-XX--XXXXXXXXXXXXXX--XXXXXXXXXX---------------------------------------------XXX---XXXX---XX---------XXXX---------XXXXXXX----------XXXXXX-----XXXXXXXXX------XXXX----------------------------XXX--XXXXXXXXXXXXXXXX--XXX-----------XXXX-----------XXXXX-XXXX-----XXXXX----X-XXXXXX-----------XX---------------XXXXXXXXXXXXXXXXXXXXXXXXXX------------------XX-----------XXXXXo-XXXXXXXXXXXX-X-XXXXX---------------------------X--XXX--------XXX------------XXXXXXXXXXXXXXXX--XXXXXXXXXXXXXXXXXX---XXXXXXXXXXXXXX---XXXXX----XXXXXX--XXXXXXX---XXXXXXXXXXXXXXXXXXXXXXXXXXXXX----------------------------XXX--XXXXX--------X-----XXXX--------------------------------------XXXXXXXXX---------XXXXXXXX----XX-XXXXXXXXXXX-X-XXXXXXXXXX--XXXXXX------XXX----------------------------XXXXXX---XXXXXXXXX-X-XXXXXXX----------------------------XXXXXXXX-XXXXXXXXXXXXXXX----------------------------------------------------XX----XX------------------------------------------------------XX------------------------------------------------------------------------------------XXXXXXXXXXXXXXXXXXXXXXXXXXX---------------------------------------------XXXXX-------XXXXXXXX---XXXXXXXXXXXXXXXX-----------------------------XXXXXX---XXXXXXXXXXXXX----XX
