--------------------------------------------------------------------------------------------------------------------------------------------------------------------------------------------------------------------------------------------------------------------------------------------------------------------------------------------------------------------------------------------------------------------------------------------------------------------------------------------------------------------------------------------------------------------------------------------------------------------------------------------------------------------------------------------------------------------------------------------------------------------------------------------------------------------------------------------------------------------------------------------------------------------------------------------------------------------------------------------------------------------------------------------------------------------------------------------------------------------------------------------------------------------------------------------------------------------------------------------------------------------------------------------------------------------------------------------------------------------------------------------------------------------------------------------------------
--------------------------------------------------------------------------------------------------------------------------------------------------------------------------------------------------------------------------------------------------------------------------------------------------------------------------------------------------------------------------------------------------------------------------------------------------------------------------------------------------------------------------------------------------------------------------------------------------------------------------------------------------------------------------------------------------------------------------------------------------------------------------------------------------------------------------------------------------------------------------------------------------------------------------------------------------------------------------------------------------------------------------------------------------------------------------------------------------------------------------------------------------------------------------------------------------------------------------------------------------------------------------------------------------------------------------------------------------------------------------------------------------------------------------------------------------------
--------------------------------------------------------------------------------------------------------------------------------------------------------------------------------------------------------------------------------------------------------------------------------------------------------------------------------------------------------------------------------------------------------------------------------------------------------------------------------------------------------------------------------------------------------------------------------------------------------------------------------------------------------------------------------------------------------------------------------------------------------------------------------------------------------------------------------------------------------------------------------------------------------------------------------------------------------------------------------------------------------------------------------------------------------------------------------------------------------------------------------------------------------------------------------------------------------------------------------------------------------------------------------------------------------------------------------------------------------------------------------------------------------------------------------------------------------
--------------------------------------------------------------------------------------------------------------------------------------------------------------------------------------------------------------------------------------------------------------------------------------------------------------------------------------------------------------------------------------------------------------------------------------------------------------------------------------------------------------------------------------------------------------------------------------------------------------------------------------------------------------------------------------------------------------------------------------------------------------------------------------------------------------------------------------------------------------------------------------------------------------------------------------------------------------------------------------------------------------------------------------------------------------------------------------------------------------------------------------------------------------------------------------------------------------------------------------------------------------------------------------------------------------------------------------------------------------------------------------------------------------------------------------------------------
------------------X----------------------------------------------------------------------------------------------------------------------------------------------------------------------------------------------------------------------------------------------------------------------------------------------------------------------------------------------------------------------------------------------------------------------------------------------------------------------------------------------------------------------------------------------------------------------------------------------------------------------------------------------------------------------------------------------------------------------------------------------------------------------------------------------------------------------------------------------------------------------------------------------------------------------------------------------------------------------------------------------------------------------------------------------------------------------------------------------------------------------------------------------------------------------------------------------------------------------------------------------------------------------------------------------------------------------------------------------------------------------------o--------------------------------------------------------
-----------------------S--ooS-----------------------------------------------------------------------Q---------------------------------------S----S------------------------Q-------------------------SSS------------------------------------------------------------------------------------------------------------------SS----------------------QQ-------------------------SS--------------------------------------------------------------------S-Q---------------------------------------SSSSS---------SQQ---------------------------------------SSSSSS--------S----------------------------------------------S-------------------------------------------------------SS-------------------------------------------------SSSSS--?--------Q-----------------------------------------------------------------------------------------------------------------------------------------------------------SS----------Q---------------------------------------SSSS----------SQQ-----------------------------------------------------------------------------------------------SS--------------------------------------------------------------------------------------------------------------SSS-----------------------------------------------------SSS------------------------------------------------------SSSS---------S-Q---------------------------------------SS------------------------XX----------------------------S---------------------------
----------------------SS----------------------------o----------------------------------------------------------------------------------------------------------------------------------------------------------------------------------------------------------------------------------------------------------------------------------------------------------------------------------------------------------------------------------------------------------------------------------------------------------------------------------------------------------------------------------------------------------------------------------------------------------------------------------------------------------------------------------------------------------------------------------------------------------------------------------------------------------------------------------------------------------------------------------------------------------------------------------------------------------------------------------------------------------------------------------------o-------------------------------------------------------o------o---------------------------------------------------E-------------------------------------------------------o---o------------------------------------------------------------------------------------------------------------------------------------------------------------S---o----------
----------------------SS-----------------------XXX-XXX-------------------------------------------------------------------------------------------------------------XXX-----------------------------------------------------XXX------------------------------------------------------------------------------------------------------------XXXX-------------------------------------------------X---XXX-------------------------------------------------------------------------------------------------------------XX----------------------------------------------------------------------------------------------------------------------------------------------------------------------XXX-----------------------------------------------------XXX-------------------------------------------------------------------------------------------------------------XX--------------------------------------------------------------------------------------------------------------XXX---------------------------------------------------------------------------------------------XXX--------XXXXXXXX------------------------------------------------XXXX-XXX------------------------------------------------XXXXXXXX-------------------------------------------------XXX-XXX------------------------------------------------------------------------------------------------------------XXX------------------------------------------------------XX---
-------------------------------------------------------------------------------------------------------------------------------------------------------------------------------------------------------------------------------------------------------------------------------------------------------------------------------------------------------------------------------------------------------------------------------------S-------------------------------------------------------S-------------------------------------------------------------------------------------------------------------------------------------------------------------------------------------------------------------------------------S-------------------------------------------------------------------------------------------------------------------------------------------------------------------------------------------------------------------------------S------------------------------------------------------------------------------------------------S-S-------------------------------------------------------------------------------------------------------------------------------------------------------------------S-SSSS-----------S-------------------------------------------------------S------------------------------------------------------------------------------------------------------------------------------------------
---ooo------------XX------------------ooo------------------Qo------------------------------Q-----Q--S--------------Qo----------------------------E?Q-----Q---------------QQQo------------------------------Q-----Q-----------------Qo-----------------------------------------------------QQo----------------------------Q-Q-----Q--------------QQQQQ------------------------------------Q-----------------ooo-----------------------------Q-----Q----------------QQQ------------------------------Q-----Q--Q-------------QQQ?-----------------------------Q-----Q------------------o------------------E---------E?Q-----Q-----------------ooo---------------------------E-Q-----Q-----------------ooo--------------------------X--Q--QQQQ--Q--------------ooo---------------------------Q-Q-----Q----------------QQQ------------------------------Q-----Q----------------QQQ----------------------------QQQ-----Q-----------------ooo-----------------------------Q-----Q--Q--------------ooo-----------------------------Q-----Q-----------------Qo---------------------------------ooo-------------------o---------------------------------ooo------------------ooo--------------------------------ooo------------------ooo-----------------------------Q-----Q----------------QQoo---------------------------E-QQ----Q--Q-------------QQQ?---------------------------------oo------------------QQ-----------------------------------o---------------
-----------E-----------------------------------------------------------E----------------------------------------------------------------------------------------------------------------------------------------------o------------------------E--------------------------------------------------------------------SS------------------------------------------------------?------------------------------------------E-------E-----------------------------------------------------------------------------------------------------------------------------------------------------------E----------<>----------------------o-------------------------------------------------------------------------------------------------X------------------------------------------------------------------------------------------------------E----------------------o--------------------------------E----------------------------------------------------------------------------------------------------------------------------------------------------------------------------------------E-----o--------------------E----------------------------E-------------------------------------------------------------o-------------------------------------------------------o---------------------------------------------------------------------------------------------------------E-----o--------------------------------E--------------------------------
----------<>--X-------------------XXXXXXXXX---XXX-----XX--------------<>-------------------------------XXX--------------------X-------------S------------------XX-----------------------------------S-----------------XXXX--------------------<>-----------------------X------------------------------X-------------S-----------------XXXX---------------------------------------------X------XXXX--------------------<>------<>-----------------------XX-------------------------------------------------------------------------------------------S-----------------XXXX----------------<>----------[]----S----------------XXXXX--------------------X-------------S-----------------XXXX--------------------X-----------------X-------------------------------------X--------------------------------XX-----------------------------<>---------------------XXXXX--------------------X-------<>----------------------------------------------X-------------S------------------XX-----------------------------------------------------XXXX----------------------------------------XXXXXXXXX--XXXXX----------------<>----------------------XXXXXXXX---XXXXX--------------------<>-----------------------XXX---XXXXX---------------------------------------------------XXXXX--------------------X--------------------------------XXX--------------------X-------------------XXXXXXXX---XXXXX----------------------------<>---------------XXX----XXX-------
----E-E---[]--X--------X------------------------------------E---------[]--E-----------------------------------------E-------E-X--------E----S--------------------------E------------E---------------S-------------------------------E-----E---[]---------------------------------------E------------E-X--------E----S-----------------------------------E---E-E---------------------------------------------E-E-E-----[]------[]------------------------------------E-----E-E-X--------E-------------------------------E-E--E-------E---------------S------------------------------EE-E---[]----------[]----S-----------------------------------------X-------------S-------------------------------E-----E---X-----------------X----------------------E------------E-X----------------------------------------E----E-----E-E---------[]------------------------------------E-----E-E-X-------[]-------------------------------E------------E-X-------------S-------------------------------E-----E----------------------------------------------E--E-------E---------------XXX----------------------------EE-E---[]--X-------------X------------------------------EE-----E---[]----------------------------------------------------E-----------------------------------------------E-------E-X---------------------------------------------------E-E-X-------------XX---------------------------E-EE-E---E-E---------[]-------------------------------E
XXXXXXXXXXXXXXXXXXXXXXXXXXXXXX--------------------------XXXXXXXXXXXXXXXXXXXXXXXXXXXXXXXXXXXX-XXXXXXXXX---------XXXXXXXXXXXXXXXXXXXXXXXXXXXXXXXXXXXXXXXXXXXXX------XXXXXX-XXXXX-XXXXXXXXXXXXXXXXXX-XXXXXXXXXXXXXXXXXX---------XXXXXXXXXXXXXXXXXXXXXXXXXXXXXXXXXXXXXXX---XXX--------XXXXXXXXXXXXXXXXXXXXXXXXXXXXXXXXXXXXXXXXXXXXXXXXXX-----------XXXXXXXXXXXXXXXXXXXXXXXXXXXXXXXXXXXXX---XXXX-----------XXXXXXXXXXXXXXXXXXXXXXXXXXXXXXXXXXXXXXXXXXXXXXXX-------X-XXXXXXXXXXXXXXXXXXXXXXXXXXXXXXXXXXXXXXXXXXXXXXXX-XXXXXXXXXXXXXXXXXXXXXXXXXXXXXXXXXXXXXXXXXXXXXXXXXXXXX----------XXXXXXXXXXXXXXXXXXXXXXXXXXXXXXXXXXXXXXXXXXXXXX-----------XXXXXXXXXXXXXXXXXXXXXXXXXXXXXXXXXXXX---XXXXX-----------XXXXXXXXXXXXXXXXXXXXXXXXXXXXXXXXXXXXXXXXXXXXXXX--XXXXXXXXXXXXXXXXXXXXXXXXXXXXXXXXXXXXXXXXXXXX-XXXXXXXX--------XXXXXXXXXXXXXXXXXXXXXXXXXXXXXXXXXXXXXXXXXXXXXXX----------XXXXXXXXXXXXXXXXXXXXXXXXXXXXXXXXXXXXXX-XXXXXXXXXX-XXXXXXXX-XXXXXXXXXXXXXXXXXXXXXXXXXXXXXXXXXXXXXXXXXXXXX------XXXXXXXXXXXXXXXXXXXXXXXXXXXXXXXXXXXXXXXXXXXXXXXX------------XXXXXXXXXXXXXXXXXXXXXXX---XXXX--------------------------XXXXXXXXXXXXXXXXXXXXXXXXXXXXXXX-------------------------XXXXXXXXXXXXXXXXXXXXXXXXXXXXXXXXXXXX----XXX-----------XXXXXXXXXXXXXXXXXXXXXXXXXX--XXXXXXXXXXXXXXXXXX-----------XXXXXXXXXXXXXXXXXXXXXXXXXXXXXXXXXXXXXXXXXXXXXXX------XXXXXXXXXXXXXXXXXXXXXXXXXXXXXXXXXXX-------------------------XXXXXXXXXXXXXXXXXXXXXXXXXXXXXXXXX-------XX------------XX
