--------------------------------------------------------------------------------------------------------------------------------------------------------------------------------------------------------------------------------------------------------------------------------------------------------------------------------------------------------------------------------------------------------------------------------------------------------------------------------------------------------------------------------------------------------------------------------------------------------------------------------------------------------------------------------------------------------------------------------------------------------------------------------------------------------------------------------------------------------------------------------------------------------------------------------------------------------------------------------------------------------------------------------------------------------------------------------------------------------------------------------------------------------------------------------------------------------------------------------------------------------------------------------------------------------------------------------------------------------------------------------------------------------------------------------------------------------
--------------------------------------------------------------------------------------------------------------------------------------------------------------------------------------------------------------------------------------------------------------------------------------------------------------------------------------------------------------------------------------------------------------------------------------------------------------------------------------------------------------------------------------------------------------------------------------------------------------------------------------------------------------------------------------------------------------------------------------------------------------------------------------------------------------------------------------------------------------------------------------------------------------------------------------------------------------------------------------------------------------------------------------------------------------------------------------------------------------------------------------------------------------------------------------------------------------------------------------------------------------------------------------------------------------------------------------------------------------------------------------------------------------------------------------------------------
--------------------------------------------------------------------------------------------------------------------------------------------------------------------------------------------------------------------------------------------------------------------------------------------------------------------------------------------------------------------------------------------------------------------------------------------------------------------------------------------------------------------------------------------------------------------------------------------------------------------------------------------------------------------------------------------------------------------------------------------------------------------------------------------------------------------------------------------------------------------------------------------------------------------------------------------------------------------------------------------------------------------------------------------------------------------------------------------------------------------------------------------------------------------------------------------------------------------------------------------------------------------------------------------------------------------------------------------------------------------------------------------------------------------------------------------------------
--------------------------------------------------------------------------------------------------------------------------------------------------------------------------------------------------------------------------------------------------------------------------------------------------------------------------------------------------------------------------------------------------------------------------------------------------------------------------------------------------------------------------------------------------------------------------------------------------------------------------------------------------------------------------------------------------------------------------------------------------------------------------------------------------------------------------------------------------------------------------------------------------------------------------------------------------------------------------------------------------------------------------------------------------------------------------------------------------------------------------------------------------------------------------------------------------------------------------------------------------------------------------------------------------------------------------------------------------------------------------------------------------------------------------------------------------------
----------------------E------------------------------------------------------------------------------------------------------------------------------------------------------------------------------------------------------------------------------------------------------------------------------------------------------------------------------------------------------------------------------------------------------------------------------------------------------------------------------------------------------------------------------------------------------------------------------------------------------------------------------------------------------------------------o--------------------------------------------------------------------------------------------------------------------------------------------------------------------------------------------------------------------------------------------------------------------------------------------------------------------------------------------------------------------------------------------------------------------------------------------------------------------------------------------------------------------------------------------------------------------------------------------------------------------------------------------------------------------------------------------------------------------------------------------------------
----------------------SS---o--------------------------------------------------------SSSS--------------------------------------------------------------------------------------------------------------SSSSS?------------------------------------------------SSS-----------------------------------------------------SSS-----------------------------------------------------SSSS------------------------------------------------------------------------------------------------------------SSS-----------------------------------------------------SSSS----------------------------------------------------SSS-----------S-Q---------------------------------------S--------------------------X--------------------------------------------Q-----------------------------------------------------------------------------------------------SSSS----------------------------------------------------SSSS------------Q-----------------------------------------------------------------------------------------------SSS------------------------------------------------------SS--SS--------------------X----------------------------SSSS----------S-Q------------QQQ----------------------------------------------------------------------------------------------------------XX-------------------------------SSS----------Q-----------------------------------------------------------------------------------------------SSSS------------------------
--------------------------------------------------------------------------------------------------------o---o-------------------------------------------------------------------------------------------------------------------------------------------------------------------E---o---------------------------------------------------------------------------------------------------------------------------------------------------------------------------------------------------------------------------------------------------------------------------------------------------------------------------------------------------------------------------------------------------------------------------------------------------------------------------------------------------------------------------------------------------------------------------o---o---------------------------------------------------------------------------------------------------------------------------------------------------------------------------------------------------------------------------------------------------------------------------------------o-------------------------------------------------------------------------------------------------------------------------------------------------------------------------------------------------------------------------------------------------------------------------------------------
----------------------SS--------------------------XXX--------------------------------------------------XXX-XXX-----------------------------------------------------XXX-----------------------------------------------------X--------------------------------------------------XXXXXXXX-----------------------------------------------------XX-------------------------------------------------------X--------------------------------------------------X---XX------------------------------------------------------------------------------------------------------------------------------------------------------------------------------------------------------------------------------XX--------------------------------------------------------------------------------------------------------------X---------------------------------------------------XXX-XXX-X-------------------------------------------------------------------------------------------------------------------------------------------------------------------------------------------------------------------------------------------------------------------------------XXX-XXX-------------------------------------------------------------------------------------------------------------XX------------------------------------------------------------------------------------------------------------------------------------------------------------------XXXXXXX--
----------------------SS------------------------------------------------------------------------------------------------------SSSS---------------------------------------------------------------------------------------------------------------------------------------------------------------------------------------------------------------------------------------------------------------------------------------------------------------------------------------------------------------------------------------------------------------------------------------------------------------------------------------------------------------------------------------------------------------------------------------------------------------------------------------------E-------------------------------------------------------------------------------------------------------------------------------------------------------------------------------------------------------------------------------E---------------------------------------------------------------------------------------------------------------------S------------------------------------------------------------------------------------------------------------------------------------------------------------------------------------------------------------------------------------------------------------------------------------------------------------------
---ooo---------------------------XXX---oo------------------Qo------------------------------Q-----Q-----------------ooo-----------------------------Q-----Q-----------------ooo---------------------------S?QQ----Q----------------QQoo-----------------------------------Q----------------QQQ-----------------------------------oQ-----------------QQ------------------------------Q-----Q----------------QQo------------------------------Q-----Q-----------------ooo---------------------------Q-------Q-----------------ooo-----------------------------Q-----Q-----------------Qo------------------------------Q-----Q-----------------ooo-----------------------------------Q----------------QQQ?---------------------------E?Q-----Q--S----------------------E----------<>----------------o------------------oo------------------------------Q-----Q-----------------ooo---------------------------E-Q-----Q-----------------Qo----------------------------E-Q-------------------------------E----------<>-----------Q-----Q-----------------Qo----------------------------Q?Q-----Q-----------------QQ----------------------------E-QQ----Q--Q-------------QQoo-----------------------------Q-----Q-----------------oo----------------------------Q-Q-----Q-----------------QQ----------------------------E?Q-----Q----------------QQo----------------------------E?Q-----Q-----------------ooo-----------------------------Q-----Q--------------
-----------E----------------------------E------------------------------E------------------------------o-------------------------------------------------------o------------------------E--------------------------------------------------------------------------------------o-------------------------------------------------------o-------------------------------------------------------o---------------------------------------------------------------------------------------------------------------o-------------------------------------------------------o-----------------------X---------------------------------------------------------------------------------------o---------------------------------------------------------------------------<>----------[]-----------------------------------------------E-----------------------------------------------------------------------------------------------------------------------E----------------------o-------------------<>----------[]----------------------o--------------------------------E-----S----------------o--------------------E-----------E------------------------------------------------------------------------------o--------------------E-----------E----------------------o----------------------------------------------------------------------------------------E----E-------------------------------------------------------------------------o---------
----------<>--X-------------------XXXXXXXXX---XXX---------------------<>--------<>-------------------XXXXX----------------------------------------------------XXXX--------------------<>------<>-----------------------X----------------------X------------------------------XXXXX--------------------------------------------XXXX---XXXXX---------------------------------------------------XXXXX----------------------------------------------------XXXX--------------------X-------------S----------X-----XXXXX---------------------------------------------------XXXXX--------------------X--------------------------------XX---------------------X-----------------------XXXX---XXXXX--------------------X-------------------------------XXXX----------------[]----------[]---------------XXX----XXX---------------------<>------------------------------XXXX--------------------X-------------------------------XXX---------------------<>------<>---------------------XXXXX----------------[]----------[]---------------------XXXXX----------------------------<>---------------------XXXXX----------------<>----------<>----------------------XXXX--------------------X-------------------------------XXXX----------------<>----------<>---------------------XXXXX--------------------X--------------------------------X------------------------------<>----------------------------------------------X------------------------------XXXXX------
----E-----[]--X-------------XXXX-----------------------X----E---------[]--E-----[]------------------------------------------------------------------------------------------E---------[]------[]-------------------------------E------------E-X--------E---------------------------------E--E-----E-E----------------------------------------------EE-E---E-E-X-----------------------------------------------------E----------E------------------------------------E-------E-X-------------S---------------------------------------E-----------------------------------------------E-----E-E-X-----------------------------------------------------E-X--------E---------------------------------E--E-----E-E-X--------E-----------------------------------EE-E---[]----------[]-------------------------------E----E-----E---[]------------o---------------------------------------E-X----------------------------------------E----E-----E-E-[]------[]-----------------------------------EE-E---[]----------[]-----------------------------------EE-----E---X-------[]-----------------------------------EE-E---[]--X-------[]--------------------------------------------E-X--------------------------------------------EE-E-E-[]----------[]------------------------------------E-----E-E-X---E------------------------------------E----E-E-----E---------[]-------------------------------E----E-----E---X-----------------------------------------
XXXXXXXXXXXXXXXXXXXXXXX-XXXXX---------------------------XXXXXXXXXXXXXXXXXXXXXXXXXXXXXXXXXXXXXXXXXXXXX-----------XXXXXXXXXXXXXXXXXXXXXXXXXXXXXXXXXXXX-X-XXXX-----------XXXXXXXXXXXXXXXXXXXXXXXXXXXXXXXXXXXXXXXXXXXXXXX-----XXXXXXXXXXXXXXXXXXXXXXXXXXXXXXXXXXXXXXXXXXXX-XXXX------------XXXXXXXXXXXXXXXXXXXXXXXXXXXXXXXXXXXXX----XXX-------------XXXXXXXXXXXXXXXXXXXXXXXXXXXXXXXXXXXXXXXXXXXX-----------X-XXXXXXXXXXXXXXXXXXXXXXXXXXXXXXXXXXX-X-XXXXX------------XXXXXXXXXXXXXXXXXXXXXXXXXXXXXXXXXXXX---XXXX-------------XXXXXXXXXXXXXXXXXXXXXXXXXXXXXXXXXXXXXXXXXXXXX-----------XXXXXXXXXXXXXXXXXXXXXXXXX-XXXXXXXXXXXXXXXXXXXX------XXXXXXXXXXXXXXXXXXXXXXXXXXXXXXXXXXXX--------XX--------------XXXXXXXXXXXXXXXXXXXXXXXXXXXXXXXXXXXXXXXXXXXXXX---------XXXXXXXXXXXXXXXXXXXXXXXXXXXXXXXXXXXXX----XX-----------XXXXXXXXXXXXXXXXXXXXXXXXXXXXXXXXXXXXXXXXXXXXXXX-----------XXXXXXXXXXXXXXXXXXXXXXXXXXXXXXXXXXXXXXXXXXXXXX-------XXXXXXXXXXXXXXXXXXXXXXXXXXXXXXXXXXXXXXXX-X-XXXXX----------XXXXXXXXXXXXXXXXXXXXXXXXXXXXXXXXXXXXXXXXXXXXXX-----------XXXXXXXXXXXXXXXXXXXXXXXXXXXXXXXXXXXXXXXXXXXXX------------XXXXXXXXXXXXXXXXXXXXXXXXXXXXXXXXXXXXXXXXXXXXXX---------X-XXXXXXXXXXXXXXXXXXXXXXXXXXXXXXXXXXXXXXXXXXXX----------XXXXXXXXXXXXXXXXXXXXXXXXXXXXXXXXXXXXXXXXXXXXX-----------XXXXXXXXXXXXXXXXXXXXXXXXXXXXXXXXXXXXXXXXXXXXXXX----XXXXXXXXXXXXXXXXXXXXXXXXXXXXXXXXXXXXXXXXXXXXXXXXXXX-------XXXXXXXXXXXXXXXXXXXXXXXXXXXXXXXXXXXXXXXXXXXXXXXX-----------X
