--------------------------------------------------------------------------------------------------------------------------------------------------------------------------------------------------------------------------------------------------------------------------------------------------------------------------------------------------------------------------------------------------------------------------------------------------------------------------------------------------------------------------------------------------------------------------------------------------------------------------------------------------------------------------------------------------------------------------------------------------------------------------------------------------------------------------------------------------------------------------------------------------------------------------------------------------------------------------------------------------------------------------------------------------------------------------------------------------------------------------------------------------------------------------------------------------------------------------------------------------------------------------------------------------------------------------------------------------------------------------------------------------------------------------------------------------------
--------------------------------------------------------------------------------------------------------------------------------------------------------------------------------------------------------------------------------------------------------------------------------------------------------------------------------------------------------------------------------------------------------------------------------------------------------------------------------------------------------------------------------------------------------------------------------------------------------------------------------------------------------------------------------------------------------------------------------------------------------------------------------------------------------------------------------------------------------------------------------------------------------------------------------------------------------------------------------------------------------------------------------------------------------------------------------------------------------------------------------------------------------------------------------------------------------------------------------------------------------------------------------------------------------------------------------------------------------------------------------------------------------------------------------------------------------
--------------------------------------------------------------------------------------------------------------------------------------------------------------------------------------------------------------------------------------------------------------------------------------------------------------------------------------------------------------------------------------------------------------------------------------------------------------------------------------------------------------------------------------------------------------------------------------------------------------------------------------------------------------------------------------------------------------------------------------------------------------------------------------------------------------------------------------------------------------------------------------------------------------------------------------------------------------------------------------------------------------------------------------------------------------------------------------------------------------------------------------------------------------------------------------------------------------------------------------------------------------------------------------------------------------------------------------------------------------------------------------------------------------------------------------------------------
--------------------------------------------------------------------------------------------------------------------------------------------------------------------------------------------------------------------------------------------------------------------------------------------------------------------------------------------------------------------------------------------------------------------------------------------------------------------------------------------------------------------------------------------------------------------------------------------------------------------------------------------------------------------------------------------------------------------------------------------------------------------------------------------------------------------------------------------------------------------------------------------------------------------------------------------------------------------------------------------------------------------------------------------------------------------------------------------------------------------------------------------------------------------------------------------------------------------------------------------------------------------------------------------------------------------------------------------------------------------------------------------------------------------------------------------------------
-----------------------------------------------------------------------------------------------------------------------------------------------------------------------------------------------------------------------------------------------------------------------------------------------------------------------------------------------------------------------------------------------------------------------------------------------------------------------------------------------------------------------------------------------------------------------------------------------------------------------------------------------------------------------------------------------------------------------------------------------------------------------------------------------------------------------------------------------------------------------------------------------------------------------------------------------------------------------------------------------------------------------------------------------------------------------------------------------------------------------------------o--------------------------------------------------------------------------------------------------------------------------------------------------------------------------------------------------------------------------------------------------------------------------------------------------------------------
--------------------------------------------------------SSSS--------------------------------------------------------SSSS------------------------------------------------SSSS----------------------------------------------------SSS--------------------------------------------------------S--------------------------------------------------------SSSQ------------------------------------------------SSSS----------------------------------------------------SSSSS--S------SQQ-----------------------------------------------------------------------------------------------SSS-----------S-Q---------------------------------------SSS-----------------------------------------------------SSSS------------------------------------------------------------------------------------------------------------SSS----------------------------------------------------------SSQ----------------------------------------------------------------------------------------------------------------------------------------------------------------SSSS-------------------------QQQQ-----------------------SS------------------------XX------------------------------------------------------------------------------------SSS-----------------------------------------------------SSS-----------------------------------------------------SSS--S----------------------------------------------------------------------------------------------------------
--------------------------------------------------------------------------------o-----------------------------------------------------------------------------------------------------------------------------------------------------------------------------------------------------------------------------------------------------------------------------------------------------------------------------------------------o-----------------------------------------------------------------------------------------------------------------------------------------------------------------------o---------------------------------------------------------------------------------------------------------------------------------------------------------------------------------------------------------------------------E-----------------------------------------------------------------------------------------------------------------------------------------------------------------------------------------------------------------------------------o------------------------------------------------------------------------------------------------------------------------------------------------------------S------------------------------------------------------------------------------------------------------------------------------------------------------------------------------------------------------------------
---------------------------------------------------------------------------XXX-XXX---------------------------------------------------------------------------------------------------------XX--XXX-----------------------------------------------------XX------------------------------------------------------------------------------------------------------------------------------------------------------------------XXX-XXX-----------------------------------------------------XXX---------------------------------------------------------------------------------------------------------XXX-XXX-----------------------------------------------------XX--------------------------------------------------XXXXXXX-------------------------E---------------------------XX-------------------------------------------------XXXXXXXX-------------------------------------------------------------------------------------------------------------------------------------------------------------------------------------------------------------------------XXX-XXX-------------------------------------------------XXX-XXX---------------------------------------------------------------------------------------------------------XXXXX-------------------------------------------------------XXX----------------------------------------------------------------------------------------------------------------------------------------------
---------------------------------------------------------S------------------------------------------------------------------------------------------------SSSS-----------S----------------------------------------------------------------------------------------------------------------------------------------------------------------------------------------------------------------SSSS-S---------S-------------------------------------------------------S----------------------------------------SSSS-------------------------------------------------------------------S----------------------------------------------------------------------------------------------------------------------------------------------------------------<>-----------------------------------------------------------------------------------------------------------------------------------------------------------------------------------------------------------------------------------------------------------------------------------------------------------------------------------------------------------------------------------------------------------------------------------------------------------------------------------------------------------------------------S----------------------------------------------------------------------------------------------------------------------------------------------------------------------
----XXXX----oooo---------------ooo-----------------------------Q-----Q--Q--------------ooo---------------------------S?S-----Q----------------QQoo---------------------------Q-Q-----Q-----------------oo----------------------------E-Q-----Q-----------------Qo------------------------------Q-----Q-----------------oo----------------------------S?Q-----Q-----------------ooo-----------------------------Q-----Q-----------------ooo---------------------------E-QQ-Q-QQ--Q-Q--------------------------------------------------------------------oo------------------------------Q-----Q--S--------------ooo-----------------------------Q-----Q-----------------Qo------------------------------Q-----Q-------------------------E----------[]---------E-Q-----Q------------------o------------------------------Q-----Q-----------------Qo----------------------------SQQ----QQ-----------------oo------------------------------------Q-----------------Qo----------------------------S?Q-----Q-----------------oo------------------------------Q-----Q----------------QQQQ---------------------------E-Q-----Q-----------------Qoo-----------------------------------------------------ooo----------------------------------------------------QQQ------------------------------Q-----Q----------------QQo----------------------------E?Q-----Q-----------------ooo-----------------------------Q-----Q-----------------Qo-----------------------
-------------------------------------------E----------------------------------------------------------------------------------------------------------------------------------------------o-------------------------------------------------------------------------------------------------------------------------------------------------------------------------------------------------------------------------------o---------------------------------------------------------------------------------------------------------------o----------------------------------------------------------------------------------------------------------------------------------------E--------------------------------------------------<>----------[]-------------------------------------------E---E-------E-----------------------------------------------E--------------------------------------------------------------------------------------o------------------------E--------------------------------------------------------------------------------------o----------------------------------E--------------------o--------------------------------------------------------------------------------E------------SS------------------------------------------------------------------------o------------------------------------------------------------------------------------------------------------------------------------E-----------E----
------XXXXXXXXXXX-------------------------<>------------S-----------------XXXX--------------------X--------------------------------------------------------------------------------------XXXXX--------------------X-------------------------------XXXX--------------------X-------<>----------------------XXXX--------------------X---------------------------------------------------------------------------------------XXXX--------------------X-------------------------------------------------------------------------------XXXX----XXXX----------------------------------------------------XXXX--------------------X-------------------------------XXXX--------------------<>------------S-----------------XXXX----------------[]----------[]----------------------XXXX----------------<>--<>------<>----------------------XXXX--------------------<>------------------------------------------------------X------------------------------XXXXX--------------------<>------<>----------------------XXXX----------------------------------S----------------XXXXX----------------E---X---------<>-------------------XXXXX--------------------X------------------------X------XXXX--------------------<>------------S----------XX------X-----------------------------------------------------XXXXX----------------------------------S-----------------XXXX--------------------X-------------------------------XXXX----------------<>----------<>----
--------------------------------------E---[]------------S---------------------------------------E-X-------------o--------------------------E------------E----------E------------------------------------------E-E-X---------------------------------------------E-----E-E-X-------[]------------------------------------E-------E-X----------------------------------------E-------------------------E----------------------------------E-----E---X-------------------------------------E-----------------------------------------------------------------------E-E-----------------------------------------------------E-X---------------------------------------------E-------E-[]--E---------S------------------------------EE-E---[]E---------[]-----------------------------------EE-E-E-[]--[]------[]----------------------------------------------[]------------o-----------------------E--E----E-----E-E-X--------E------------------------------------E-E---E---[]------[]------------------------------------E-----E-E-X--------E----S---------------------------------------E-X---------[]-------------------------------E--E-------E-X---------------------------------------------E---------[]------------S--------------------------E---EE-----E-E-------------------------------------------------------E----------E----S-------------------------------E-----E-E-X----------------------------------------E---EE-E-E-[]----------[]----
XX--------------------------XXXXXXXXXXXXXXXXXXXXXXX---XXXXXXXXXXXXXXXXXXX----------XXXXXXXXXXXXXXXXXXXXXXXXXXXXXXXXXXXXXXXXXXXXX------XXXXXXXXXXXXXXXXXXXXXXXXXXXXXXXXXXXXXXXXXXXXXXXXXXX-----------XXXXXXXXXXXXXXXXXXXXXXXXXXXXXXXXXXXXXXXXXXXXX----------XXXXXXXXXXXXXXXXXXXXXXXXXXXXXXXXXXXXXXXXXXXXXX--------XXXXXXXXXXXXXXXXXXXXXXXXXXXXXXXXXXXXXXXXXXXXXXX------XXXXXX-XXXXX--XXXXXXXXXXXXXXXXXXXXXXXXXXXXXXXXXXXXX----------XXXXXXXXXXXXXXXXXXXXXXXXXXXXXXXXXXXXXXXXXXXXXXXXXXXXXXXXX-XXXXXXXXXXXXXXXXXXXXXXXXXXXXXXXXX------X------------XXXXXXXXXXXXXXXXXXXXXXXXXXXXXXXXXXXXXXXXXXXXXXXX----------XXXXXXXXXXXXXXXXXXXXXXXXXXXXXXXXXXXXXXXXXXXXXX--------XXXXXXXXXXXXXXXXXXXXXXXXXXXXXXXXXXXXXXXXX-XXXXX-----------XXXXXXXXXXXXXXXXXXXXXXXXXXXXXXXXXXXXXXXXXXXXX---------XXXXXXXXXXXXXXXXXXXXXXXXXXXXXXXXXXXXXXXXXXXXXX-----------XXXXXXXXXXXXXXXXXXXXXXXXXXXXXXXXXXXXXXXXXXXXXXXX--XXXXXXXXXXXXXXXXXXXXXXXXXXXXXXXXXXXXXXXX-XXX---XXXX------------XXXXXXXXXXXXXXXXXXXXXXXXXXXXXXXXXXXXXXXXXXXXXX--------XXXXXXXXXXXXXXXXXXXXXXXXXXXXXXXXXXXXXXXXXXXXXXX------------XXXXXXXXXXXXXXXXXXXXXXXXXXXXXXXXXXXXXXXXXXXX-----------XXXXXXXXXXXXXXXXXXXXXXXXXXXXXXXXXXXXX---XXX------------XXXXXXXXXXXXXXXXXXXXXXXXXXXXXXXXXXXX-------XX-------X--XXXXXXXXXXXXXXXXXXXXXXXXXXXXXXXXXXXXXXXXXXXXXXX-----------XXXXXXXXXXXXXXXXXXXXXXXXXXXXXXXXXXXXXXXXXXXXXX--------XXXXXXXXXXXXXXXXXXXXXXXXXXXX-XXXXXXXXXXXXXXXXXX--------XXXXXXXXXXXXXXXXXXXXXXXXXXXXXXXX
