--------------------------------------------------------------------------------------------------------------------------------------------------------------------------------------------------------------------------------------------------------------------------------------------------------------------------------------------------------------------------------------------------------------------------------------------------------------------------------------------------------------------------------------------------------------------------------------------------------------------------------------------------------------------------------------------------------------------------------------------------------------------------------------------------------------------------------------------------------------------------------------------------------------------------------------------------------------------------------------------------------------------------------------------------------------------------------------------------------------------------------------------------------------------------------------------------------------------------------------------------------------------------------------------------------------------------------------------------------------------------------------------------------------------------------------------------------
--------------------------------------------------------------------------------------------------------------------------------------------------------------------------------------------------------------------------------------------------------------------------------------------------------------------------------------------------------------------------------------------------------------------------------------------------------------------------------------------------------------------------------------------------------------------------------------------------------------------------------------------------------------------------------------------------------------------------------------------------------------------------------------------------------------------------------------------------------------------------------------------------------------------------------------------------------------------------------------------------------------------------------------------------------------------------------------------------------------------------------------------------------------------------------------------------------------------------------------------------------------------------------------------------------------------------------------------------------------------------------------------------------------------------------------------------------
--------------------------------------------------------------------------------------------------------------------------------------------------------------------------------------------------------------------------------------------------------------------------------------------------------------------------------------------------------------------------------------------------------------------------------------------------------------------------------------------------------------------------------------------------------------------------------------------------------------------------------------------------------------------------------------------------------------------------------------------------------------------------------------------------------------------------------------------------------------------------------------------------------------------------------------------------------------------------------------------------------------------------------------------------------------------------------------------------------------------------------------------------------------------------------------------------------------------------------------------------------------------------------------------------------------------------------------------------------------------------------------------------------------------------------------------------------
--------------------------------------------------------------------------------------------------------------------------------------------------------------------------------------------------------------------------------------------------------------------------------------------------------------------------------------------------------------------------------------------------------------------------------------------------------------------------------------------------------------------------------------------------------------------------------------------------------------------------------------------------------------------------------------------------------------------------------------------------------------------------------------------------------------------------------------------------------------------------------------------------------------------------------------------------------------------------------------------------------------------------------------------------------------------------------------------------------------------------------------------------------------------------------------------------------------------------------------------------------------------------------------------------------------------------------------------------------------------------------------------------------------------------------------------------------
--------------------------------------------------------------------------------------------------------------------------------------------------------------------------------------------------------------------------------------------------------------------------------------------------------------------------------------------------------------------------------------------------------------------------------------------------------------------------------------------------------------------------------------------------------------------------------------------------------------------------------------------------------------------------------------------------------------------------------------------------------------------------------------------------------------------------------------------------------------------------------------------------------------------------------------------------------------------------------------------------------------------------------------------------------------------------------------------------------------------------------------------------------------------------------------------------------------------------------------------------------------------------------------------------------------------------------------------------------------------------------------------------------------------------------------------------------
-----------------------S---oS-------------------------------------------------------SSS------------------------------------------------------SSSSS-------------------------------------------------------S----------Q-----------------------------------------SSSS----------Q-----------------------------------------------------------------------------------------------SS-------------------------------------------------------------------------------------------------------------------S--------------------------------------------------S-------------------------------------------------------SSS--------------------------QQQ------------------------SSS-----------------------------------------------------SSSS----------------------------------------------------SSSSSS-?------S----------------------------------------------S------------------------------------------------------------------Q--------------------------------------------S-------------------------------------------------------SS-------------------------------------------------SSS-----------------------------------------------------SSS----------------------------------------------------------S--------------------------------------------------SSS-------------------------------------------------------------------------------------------------------------------------------------------------------------------------------------------------
-----------------------S------------------------o---o-------------------------------------------------------E---------------------------------------------------------------------------------------------------------------------------------------------------------------------------------------------------------------------------------------------------------------------------------------o---------------------------------------------------------------------------------------------------------------------------------------------------------------------------------------------------------------------------o---o-------------------------------------------------------o-------------------------------------------------------------------------------------------------------------------------------------------------------------------------------------------------------------------------------------------------------------------------------------------------------------------------------------------------------------------------------------------------------o---------------------------------------------------o---o-------------------------------------------------------------------------------------------------------------------------------------------------------------------------------------------------------------------------------------------------------------------------------------------
----------------------SS-----------------------XXXXXXX-X-----------------------------------------------XXXXXXX------------------------------------------------------X--------------------------------------------------------------------------------------------------------------------------------------------------------------------------------------------------------------------------XXX-XXX---------------------------------------------------------------------------------------------------------------------------------------------------------------------XXX-------------------------------------------------XXX-XXX-------------------------------------------------XXXXXXX-------------------------------------------------------------------------------------------------------------XX---------------------------------------------------------------------------------------------------------------X--------------------------------------------------------------------------------------------------------------XXX-------------------------------------------------XXX-XXX------------------------------------------------XXXXXXXX-------------------------------------------------------------------------------------------------------------XXX--------------------------------------------------------------------------------------------------------------------------------------------------------------------------
------------------------------------------------------------------------------------------------------------------------------S-SS------------------------------------------------------------------------------------------------------------SSSS-----------------------------------------------------------------------------------------------------------------------------------------------------------------------------------------------------------------------------------------------------------------------------------------------------------------------------------------------------------S-----------------------------------------------------------------------------------------------------------------------------------------------------------------------S--------------------------------------SSSSSS------------------------------------------------------------------------------------------------------------------------------------------------------------------------------------------------------------------------------------------------------------------------------------S-SS------------------------------------------------------------------------------------------------------------------------------------------------------------------------------------------------------------------------------------------------------------------------------------------------------------------------------
----o-------------XX------------------oooQ-----------------Qo----------------------------Q-Q-----Q-----------------Qoo---------------------------Q?Q-----Q----------------QQo----------------------------E?Q-----Q-----------------ooo-----------------------------Q-----Q-----------------Qoo-----------------------------Q-----Q-----------------oo------------------------------Q-----Q-----------------oo----------------------------E?Q-----------------------Qo----------------------------S?Q-----Q----------------QQQ----------------------------Q-------Q-----------------Qo------------------------------Q-----Q--S-------------QQQo-----------------------------------Q-----------------Qo------------------------------Q-----Q-----------------oo----------------------------E?QQ----Q-----------------ooo---------------------------S?Q-----------------------Qo------------------------------Q-----Q-----------------QQ----------------------------S?S-----Q-----------------Qoo---------------------------S?S-----Q-----------------Qo------------------------------------Q----------------QQo-----------------------------------oQ-----------------Qo----------------------------Q-Q-----------------------Qo------------------------------------Q----------------QQQ----------------------------Q-Q-----Q----------------QQQ------------------------------Q-----Q--------------QQQQQ------------------------------------Q--------------
-----------E-------------------------------------------------------------------------S----------------o---------------------------------------------------------------------------------------------E------------------------------------------------------------------------------------------------------------------------------------------------------E-----------E----------------------o------------------------E-------E----------------------o------------------------E------------------------------o--------------------------------E----------------------o------------------------E------------------------------o--------------------------------------S----------------o--------------------E---E-------E----------------------o---------------------------------------------------------------------------------------------------------------o------------------------E---------------------------------------------------------------E--------------------------------------------------------------------------------------------------------------------------------------o-------------------------------------------------------o--------------------------------------------------------------------------------E------------------------------o-----------------------------------------------------------------------------------------------------------------------------------------------------------------------o---------
----------<>--X-------------------XXXXXXXX----XXXX-----X----------<>----------<>----------------------XXXX--------------------X-------------------------------XXX---------------------X--------------------------------XX---------------------X-------------------------------XXX-----------------------------------------------------XXXX----------------<>--X-------<>---------------------XXXXX--------------------<>------<>----------------------XXXX--------------------<>------------------------------XXXX----------------------------<>---------------XXX---XXXXX--------------------<>-----------------------------XXXXX---------------------------------------------------XXXXX----------------<>--<>------<>----------------------XXXX--------------------X--------------------------------X------------------------------------------------------XXXX--------------------<>------<>----------------------XXXX----------------------------<>----------------------XXXX--------------------X-------------S-----------------XXXX--------------------X-------<>---------------------XXXXX---------------------------------------------XXX---XXXXX----------------------------------S-----------------XXX---------------------<>------------S----------------XXXXX--------------------X--------------------------------XX---------------------<>------------------------------XXXX------------------------E--------------------------XXXXX------
---EE-E---[]--X--------------------------------------------EE-----[]----------[]---------------------------------E--E-------E-X----------------------------------------E----E-------E-X-----------------------------------------------------E-X----------------------------------------E----E-------E---------------o--------------------------E---EE-----[]--X-------[]-----------------------------------EE-----E---[]------[]-----------------------------------EE-E-------[]-------------------------------------------EE-E-----E---------[]------------------------------------E-----E---[]----------------------------------------------------E-X--------E-----------------------------------EE-E---[]--[]------[]--------------------------------------------E-X-------------o-------------------------------E------------------------------------------------------EE-----E---[]------[]-----------------------------------EE-E---E-E-X-------[]--------------------------------------------E-X-------------S-------------------------------E-----E-E-X-------[]--------------------------------------------E----------------------------------------------EE-E-E-E-E---------------S--------------------------E----E---------[]------------S-------------------------------E-------E-X---------------------------------------------E-------E-[]--------------------------------------------E-E-----E-------------------------------------------
XXXXXXXXXXXXXXXXXXXXXXXXXXXXXXX-------------------------XXXXXXXXXXXXXXXXXXXXXXXXXXXXXXXXXXXX----XXX------------XXXXXXXXXXXXXXXXXXXXXXXXXXXXXXXXXXXXXXXXXXXXXX-------XXXXXXXXXXXXXXXXXXXXXXXXXXXXXXXXXXXXXXXXXXXXXXXXX--------X-XXXXXXXXXXXXXXXXXXXXXXXXXXXXXXXXXXXXXXXXXXXXXX-------XXXXXXXXXXXXXXXXXXXXXXXXXXX-X-XXXXXXXXXXXXXXXXXX--------XXXXXXXXXXXXXXXXXXXXXXXXXXXXXXXXXXXXXXXXXX-XXXXX------------XXXXXXXXXXXXXXXXXXXXXXXXXXXXXXXXXXXX-XXXXXXX-----------XXXXXXXXXXXXXXXXXXXXXXXXXXXXXXXXXXXXXXXXXXXXXX----------XXXXXXXXXXXXXXXXXXXXXXXXXXXXXXXXXX-------XXX------------XXXXXXXXXXXXXXXXXXXXXXXXXXXXXXXXXXXXXXXXXXXXXX-----------XXXXXXXXXXXXXXXXXXXXXXXXXXXXXXXXXXXX-X-XXXX-------------XXXXXXXXXXXXXXXXXXXXXXXXXXXXXXXXXXXXXXXXXXXXX----------XXXXXXXXXXXXXXXXXXXXXXXXXXXXXXXXXXXXXXXXXXXXXXX----XXXXXXXXXXXXXXXXXXXXXXXXXXXXXXXXXXXXXXXXX-----XXX------------XXXXXXXXXXXXXXXXXXXXXXXXXXXXXXXXXXXXXXXXXXXXXX-----------XXXXXXXXXXXXXXXXXXXXXXXXXXXXXXXXXXXX---XXXXX-----------XXXXXXXXXXXXXXXXXXXXXXXXXXXXXXXXXXXX-----XXX------------XXXXXXXXXXXXXXXXXXXXXXXXXXXXXXXXXXXXXXX-XXXXX------------XXXXXXXXXXXXXXXXXXXXXXXXXXXXXXXXXXXXXX-XXXX-------------XXXXXXXXXXXXXXXXXXXXXXXXXXXXXXXXXXXX-XXXXXXX-------XXXXXXXXXXXXXXXXXXXXXXXXXXXXXXXXXXXXXXXXXXX-XXXX------------XXXXXXXXXXXXXXXXXXXXXXXXXXXXXXXXXXXXXXXXXXXXX--------XXXXXXXXXXXXXXXXXXXXXXXXXXXXXXXXXXXXXXXXXXXXXXXXX--------XXXXXXXXXXXXXXXXXXXXXXXXXXXXXXXXXXX-XXX---XXXXX-----------X
