--------------------------------------------------------------------------------------------------------------------------------------------------------------------------------------------------------------------------------------------------------------------------------------------------------------------------------------------------------------------------------------------------------------------------------------------------------------------------------------------------------------------------------------------------------------------------------------------------------------------------------------------------------------------------------------------------------------------------------------------------------------------------------------------------------------------------------------------------------------------------------------------------------------------------------------------------------------------------------------------------------------------------------------------------------------------------------------------------------------------------------------------------------------------------------------------------------------------------------------------------------------------------------------------------------------------------------------------------------------------------------------------------------------------------------------------------------
--------------------------------------------------------------------------------------------------------------------------------------------------------------------------------------------------------------------------------------------------------------------------------------------------------------------------------------------------------------------------------------------------------------------------------------------------------------------------------------------------------------------------------------------------------------------------------------------------------------------------------------------------------------------------------------------------------------------------------------------------------------------------------------------------------------------------------------------------------------------------------------------------------------------------------------------------------------------------------------------------------------------------------------------------------------------------------------------------------------------------------------------------------------------------------------------------------------------------------------------------------------------------------------------------------------------------------------------------------------------------------------------------------------------------------------------------------
--------------------------------------------------------------------------------------------------------------------------------------------------------------------------------------------------------------------------------------------------------------------------------------------------------------------------------------------------------------------------------------------------------------------------------------------------------------------------------------------------------------------------------------------------------------------------------------------------------------------------------------------------------------------------------------------------------------------------------------------------------------------------------------------------------------------------------------------------------------------------------------------------------------------------------------------------------------------------------------------------------------------------------------------------------------------------------------------------------------------------------------------------------------------------------------------------------------------------------------------------------------------------------------------------------------------------------------------------------------------------------------------------------------------------------------------------------
--------------------------------------------------------------------------------------------------------------------------------------------------------------------------------------------------------------------------------------------------------------------------------------------------------------------------------------------------------------------------------------------------------------------------------------------------------------------------------------------------------------------------------------------------------------------------------------------------------------------------------------------------------------------------------------------------------------------------------------------------------------------------------------------------------------------------------------------------------------------------------------------------------------------------------------------------------------------------------------------------------------------------------------------------------------------------------------------------------------------------------------------------------------------------------------------------------------------------------------------------------------------------------------------------------------------------------------------------------------------------------------------------------------------------------------------------------
-----------------------------------------------------------------------------------o---------------------------------------------------------------------------------------------------------------------------------------------------------------------------------------------------------------------------------------------------------------------------------------------------------------------------------------------------------------------------------------------------------------------------------------------------------------------------------------------------------------------------------------------------------------------------------------------------------------------------------------o----------------------------------------------------------------------------------------------------------------------------------------------------------------------------------------------------------------------------------------------------------------------------------------------------------------------------------------------------------------------------------------------------------------------------------------------------------------------------------------------------------------------------------------------------------------------------------------------------------------------------------------------------------------------------------------------------------------------------
S-------------------o------------------------------------------------------------XXX----------------------------SSS---------------------------------------------------------------------------------------------------------------------------------------------------------------------SSSS------------------------------------------------------------------------------------------------------------SSSSSSS----------------------Q----------------------------------------------------------------------------------SSSS-S----------------------------------------------------SS-------------------------QQ-------------------------SSS-------------------------------------------------------------------------------XX------------------------------SSSS--------S-Q-----------------------------------------------------------------------------------------------SSSS----------------------------------------------------S--------------------------------------------------------SSS----------SQQ---------------------------------------SSS-----------------------------------------------------SSS-----------------------------------------------------SSSS----------SQS------------QQQQ----------------------------X-------------------------------------------------------S---------------------------------------------------SSSSS--------S-Q---------------------------------------SSSSS-------------Q-------------------------------------
--------------------------------------------------------------------------------------------------------------------------------------------------------------------------------------------------------------------------------------------------------o---------------------------------------------------------------------------------------------------------------o---------------------------------------------------------------------------------------------------------------------------------------------------------------------------------------------------------------------------------------------------------------------------------------o---------------------------------------------------------------------------------------------------------------------------------------------------------------------------------------------------------------------------o---o-----------------------------------------------------------------------------------------------------------------------------------------------------------------------o---------------------------------------------------E---------------------------------------------------------------------------------------------------------------------------------------------------------------------------------------------------------------------------------------------------------------------------------------------------------------------------
-------------------------------------------------------------------------------XX------------------------------------------------------XX--------------------------------------------------------------------------------------------------------------XXX-----------------------------------------------------XXX-------------------------------------------------XXX-XXX---------------------------------------------------------------------------------------------------------------------------------------------------------------------------------------------------------------------------------------------------------------------------------XXX-XXX-----------------------------------------------------XXX-----------------------------------------------------------------------------------------------------------------------------------------------------------------XXX-XXX-----------------------------------------------------------------------------------------------------------------------------------------------------------------XXX-XXX------------------------------------------------XXXXXXXX------------------------------------------------------------------------------------------------------------------------------------------------------------------------------------------------------------------------------X------------------------------------------------------XXX------------------------------
---------------------------------------------------------------------------------------------------------------------------------------------------------------------------------------------------------------------------------S---------------------------------------------------------------------------------------------------------------------------------------------------------------------------------------------------------------------------------------------------------------------------------------------------------------------------------------------------------------------------------------------------------------------------------------------------------------------------------------------------------------------------------------------------------------------------------------------------------------------------------------S---------------------------------------------------------------------------------------------------------------E-------------------------------------------------------S-------------------------------------------------------------------------------------------------------------------------------------------------------------------------------------------------------------------------E-------------------------------------------------------------S--------------------------------------------------------------------------------------------------------------
-----XX-----oooo---------------ooo---------------------------E-Q-----------------------ooo---------------------------Q-Q-----Q----------------QQQ------------------E---------E-Q-----------------------oo----------------------------Q?Q-----Q----------------QQQ------------------------------Q-----Q-----------------ooo-----------------------------------Q-----------------ooo---------------------------S?Q-----Q----------------QQQ------------------------------------Q-----------------ooo---------------------------Q?Q-----Q---------------QQQQ----------------------------E-Q-----Q--Q-------------QQQ------------------------------Q-----Q----------------QQQ?-----------------------------------Q-----------------oo----------------------------E?QQ----Q--Q--------------ooo-----------------------------Q-----Q-----------------ooo-----------------------------Q-----Q----------------QQQ------------------------------------Q-------------------------------------E--------X--QQ-Q--Q--Q--------------Qo------------------------------Q-----Q-----------------Qo---------------------------------ooo-------------------o------E---------------------QQQQ----Q----------------QQQo---------------------------S?Q-----Q-----------------QQ-----------------<>---------QQQ-----Q-----------------Qo----------------------------E?QQ----Q--Q--------------Qoo-----------------------------Q-----Q--Q--------------ooo----------------------
--------------------------------------------------------------------------o-------------------------------------------------------o-------------------------------<>----------------------o-----------------------X-----------------------------------------------------------------------------------------------------------------------------------------------o--------------------------------------------------------------------------------E-------E----------------------o------------------------E----------------------------------------------------------------------------------------------------------------------------------------------o-------------------------------------------------------o------------------------E-------E------------------------------------------------------------------------------o-------------------------------------------------------o-------------------------------------------------------o--------------------E----------<>--------X-------------------------------------X-------------------------------o-------------------------------------------------E-----o-------------------<>-----------E----?S------------------------------------------------------?S------------------------------------------------[]----------------------o------------------------E---------------------------------------------------------------------------------------------------------------E------------
-------XXXXXXXXXX-XXX---------------------X------------------------------XXXXX--------------------X-------------------------------XXXX--------------------X-------[]---------------------XXXXX--------------------X-------------S-----------------XXXX--------------------X-------------------------------------------------------X------------------------------XXXXX--------------------X-------------S-----------------XXXX--------------------<>------<>---------------------XXXXX--------------------<>------<>----------------------XXXX--------------------<>--------------------------------------------------------------------------------------XXXX--------------------X------------------------------XXXXX----------------<>--<>------<>------------------------------------------------------------------------------XXXX----------------------------------S----------------XXXXX--------------------X------------------------------XXXXX----------------<>----------[]--------X-------------------------------------X------------------------------XXXXX--------------------<>------------------XXXXXXXX---XXXXX----------------[]----------<>----------------------------------------------X-------------------------------XXXX----------------------------[]---------------------XXXXX--------------------<>------<>-----------------------X----------------------X--------------------------------X----------------------<>------------
XX------------------------------E-----E---X---------------------------------------------E-----E---X--------------------------------------------EE-E---E-E-X-------[]----X-------------------------------------E-E-X-------------S-------------------------------E-------E-X--------E-------------------------------E---EE-----E---X---------------------------------------------------E---X-------------S-------------------------------E-------E-[]------[]------------------------------------E-----E---[]------[]----o---------------------------------------E-[]-------E-------------------------------E------------E----------E---------------------------------E--E-----E-E-X-------------o-------------------------------E---E-[]--[]------[]-------------------------------E----E-------E----------E------------------------------------E-------E----------E----S---------------------------------------E-X--------------------------------------------EE-E---[]----------[]---------------E------------E--E----E-----E-E-X--------E--------------------------------------------E-[]-------------------------------------------EE-E---[]----------[]----o--------------------------E------------E-X----------E---------------------------------EE-E-E-E-E---------[]------------------------------------E-E-------[]------[]------------------------------------E-----E-E-X----------------------------------------E----E-----E---[]------------
XX--------------------------XXXXXXXXXXXXXXXXXXXXXXXXX-XXXXXXX--X---XXXX-----------XXXXXXXXXXXXXXXXXXXXXXXXXXXXXXXXXXXXXXXXXXXXXXX----------XXXXXXXXXXXXXXXXXXXXXXXXXXXXXXXXX--------XXX-------------XXXXXXXXXXXXXXXXXXXXXXXXX-XXXXXXXXXXXXXXXXXXX-----------XXXXXXXXXXXXXXXXXXXXXXXXXXXXXXXXXXXXXXXXXXX------XXXXXXXXXXXXXXXXXXXXXXXXXXXXXXXXXXXXXXXXXXX-X-XXXX-------------XXXXXXXXXXXXXXXXXXXXXXXXXXXXXXXXXXXXXXXXXXXXX----------XXXXXXXXXXXXXXXXXXXXXXXXXXXXXXXXX-XXX---XXXXX------------XXXXXXXXXXXXXXXXXXXXXXXXXXXXXXXXXXXXXXXXXXXXX--------XXXXXXXXXXXXXXXXXXXXXXXXXXXXXXXXXXXXXXXXXXXXXXXXX--XXXXXXXXXXXXXXXXXXXXXXXXXXXXXXXXXXXXXXXXXXXXXXXXXXXXX---------XXXXXXXXXXXXXXXXXXXXXXXXXXXXXXXXXX--XX-X-XXXXX-----------XXXXXXXXXXXXXXXXXXXXXXXXXXXXXXXXXXXXXXXXXXXXXXX--XXXXXXXXXXXXXXXXXXXXXXXXXXXXXXXXXXXXXXXXXXXX-X-XXXXX------------XXXXXXXXXXXXXXXXXXXXXXXXXXXXXXXXXXXXXXXXXXXX-----------XXXXXXXXXXXXXXXXXXXXXXXXXXXXXXXXXXXXX---XXXX------------XXXXXXXXXXXXXXXXXXXXXXXXXXXXXXXXXXXXXXXXXXXXXXXXXXXXXXXXXXXXXXXXXXXXXXXXXXXXXXXXXXXXXXXXXXXXXXXXXXXXX------------XXXXXXXXXXXXXXXXXXXXXXXXXXXXXXXX------------------------XXXXXXXXXXXXXXXXXXXXXXXXXXXXXXXXXXXXXXXXXXXXXX--XXXXXXXX-XXXXX--XXXXXXXXXXXXXXXXXXXXXXXXXXXXXXXXXXXXX--------XXXXXXXXXXXXXXXXXXXXXXXXXXXXXXXXXXXXXXXXXXXXXXX------------XXXXXXXXXXXXXXXXXXXXXXXXXXXXXXXXXXXXXXXXXXXXXX----XXXXXXXXXXXXXXXXXXXXXXXXXXXXXXXXXXXXXXXXXXXXXXXXXXXX----XXXXXXXXXXXXXXXXXXXXXXXXXXXXX---XX
