--------------------------------------------------------------------------------------------------------------------------------------------------------------------------------------------------------------------------------------------------------------------------------------------------------------------------------------------------------------------------------------------------------------------------------------------------------------------------------------------------------------------------------------------------------------------------------------------------------------------------------------------------------------------------------------------------------------------------------------------------------------------------------------------------------------------------------------------------------------------------------------------------------------------------------------------------------------------------------------------------------------------------------------------------------------------------------------------------------------------------------------------------------------------------------------------------------------------------------------------------------------------------------------------------------------------------------------------------------------------------------------------------------------------------------------------------------
--------------------------------------------------------------------------------------------------------------------------------------------------------------------------------------------------------------------------------------------------------------------------------------------------------------------------------------------------------------------------------------------------------------------------------------------------------------------------------------------------------------------------------------------------------------------------------------------------------------------------------------------------------------------------------------------------------------------------------------------------------------------------------------------------------------------------------------------------------------------------------------------------------------------------------------------------------------------------------------------------------------------------------------------------------------------------------------------------------------------------------------------------------------------------------------------------------------------------------------------------------------------------------------------------------------------------------------------------------------------------------------------------------------------------------------------------------
--------------------------------------------------------------------------------------------------------------------------------------------------------------------------------------------------------------------------------------------------------------------------------------------------------------------------------------------------------------------------------------------------------------------------------------------------------------------------------------------------------------------------------------------------------------------------------------------------------------------------------------------------------------------------------------------------------------------------------------------------------------------------------------------------------------------------------------------------------------------------------------------------------------------------------------------------------------------------------------------------------------------------------------------------------------------------------------------------------------------------------------------------------------------------------------------------------------------------------------------------------------------------------------------------------------------------------------------------------------------------------------------------------------------------------------------------------
--------------------------------------------------------------------------------------------------------------------------------------------------------------------------------------------------------------------------------------------------------------------------------------------------------------------------------------------------------------------------------------------------------------------------------------------------------------------------------------------------------------------------------------------------------------------------------------------------------------------------------------------------------------------------------------------------------------------------------------------------------------------------------------------------------------------------------------------------------------------------------------------------------------------------------------------------------------------------------------------------------------------------------------------------------------------------------------------------------------------------------------------------------------------------------------------------------------------------------------------------------------------------------------------------------------------------------------------------------------------------------------------------------------------------------------------------------
--------------------------------------------------------------------------------------------------------------------------------------------------------------------------------------------------------------------------------------------------------------------------------------------------------------------------------------------------------------------------------------------------------------------------------------------------------------------------------------------------------------------------------------------------------------------------------------------------------------------------------------------------------------------------------------------------------------------------------------------------------------------------------------------------------------------------------------------------------------------------------------------------------------------------------------------------------------------------------------------------------------------------------------------------------------------------------------------------------------------------------------------------------------------------------------------------------------------------------------------------------------------------------------------------------------------------------------------------------------------------------------------------------------------------------------------------------
S-------------------SSo---------------------------------SSSS----------S-Q--------------------------------------------------------------------------------------------------SSS--------------------------------------------------SSSSS---------------------------------------------------SS------------------------------------------------------SSSSSSS-------------------------------------------------SS-------------------------------------------------------SSS------------Q-Q-------------------------------------S----------------------------QQ-------------------------SSSS----------------------------------------------------SSSSS---------------------------------------------------SSSSSS----------Q---------------------------------------SS---S--------------------------------------------------SSS-----------------------------------------------------SSS---------------Q-------------------------------------SSSS----------------------------------------------------SS------------------------------------------------------SSSS----------------------------------------------------SSSSS-----------Q---------------------------------------SS--------------Q---------------------------------------SS---------------------------QQQ------------------------SSSSSS--------------------------------------------------SSSS----------------------------------------------------SSSS----------------------------------------------------
--------------------------------------------------------------------------------------------------------------------------------------------------------------------------------------------------------------------------------------------------------o------------------------------------------------o----------------------------------------------------------------------------------------------------------------------------------------------------------------------------------------------------------------------------------------------------------------------------------------------o-------------------------------------------------------E-------------------------------------------------------------------------------------------------------------------------------------------------------------------------------------------------------------------------------o-------------------------------------------------------o-------------------------------------------------------------------------------------------------------------------------------------------------------------------o---o-----------------------------------------------------------------------------------------------------------------------------------------------------------------------E---------------------------------------------------------------------------------------------------------------E-------------------------------
-------------------------------------------------------------------------------XXX-----------------------------------------------------XX----------------------------------------------------------------------------------------------------------XXX-XXX-------------------------------------------------XXX-XXX-----------------------------------------------------XXX---------------------------------------------------------------------------------------------------------------------------------------------------------------------XXX--------------------------------------------------XX-XXX-------------------------------------------------XXX-XXX-----------------------------------------------------XX------------------------------------------------------XXX-----------------------------------------------------XX--------------------------------------------------XX--XXX-------------------------------------------------XXX-XXX------------------------------------------------------X--------------------------------------------------XXX-XXX-------------------------------------------------XXX-XXX---------------------------------------------------------------------------------------------------------XXX-XXX--------------------------------------------------XX-XXX-----------------------------------------------------XXX-------------------------------------------------XXX-XXX------------------------------
------------------------------------------S-SS-----------S------------------------------------------------------------------------------------------------SSSS-------------------------------------------------------------------S----------------------------------------S-SS--------------------------------------------------------------------------------------------------------------------------------------------------------------------------------------------------------------------------------------------------------------------------------------------------------------------------------------------S----------------------------------------------------------------------S----------------------------------------SSSS-----------------------------------------------------------------------------------------------------------------------------------------------------------------------------------------------------------------------------------------------------------------------------------------------------------------------------------------------------------S--------------------------------------SSSSSS--------------------------------------------------------------------------------------------------------------------------------------------------------------------------------------------------------------------------------------------------------------------------------------------------
------------oooo--X-------------o----------------------------Q?QQ----Q-----------------Qo----------------------------E-Q-----Q-----------------ooo---------------------------SQQ-----Q-----------------ooo-----------------------------Q-----Q--Q--------------ooo-----------------------------------Q-----------------ooo---------------------------QQQ-----Q----------------QQQ?---------------------------Q-Q-----Q-----------------oo------------------------------Q-----Q-----------------Qo------------------------------Q-----Q----------------QQo------------------------------Q-----Q----------------Qooo-----------------------------Q-----Q-----------------ooo---------------------------E?QQ----Q--Q--------------ooo-----------------------------Q-----Q----------------QQo------------------------------Q-----Q-----------------QQ------------------------------Q-----Q------------------o------------------------------Q-----Q----------------QQo------------------------------------Q-----------------oo------------------------------Q-----Q-----------------oo------------------------------Q-----Q--Q-------------Q--------------------------------Q-----Q-----------------oo-----------------------------------o----------------QQQQ----------------------------Q?Q-----Q-----------------ooo-----------------------------Q-----Q-----------------oo------------------------------Q-----Q-----------------ooo----------------------
--------------EE-------------------------------------------------------------------------------E---------------------------------------------------------------------------------------------------------------E-----------E---------------------------------------------------------------------------------------------E---------E--------------------------------------------------------------------------------------o------------------------E--------------------------------------------------------------------------------------o----------------------------------E--------------------o------------------------------------------------------------------------------------------------------------------------------------------------------S------------------------------------------------------------------------o--------------------------------------------------------------------------------E-------E----------------------o-------------------------------------------------------o-----------------------X--------------S----------------o---------------------------------------------------------------------------------------------------------------o------------------------E-------E----------------------o------------------------------------------------------------------------------------------------------------------------------------------------------S------------------------------------------------------
----------XXXXXXX---------------------------------------S-----------------XXXX----------------<>--X-------------------------------XXXX----------------------------------S-------------------------------------<>----------<>----------------------XXX---------------------X-------------------------------XXX---------------------<>------------------------------XXXX----------------------------------------------------XXXX--------------------<>--------------------------------------------------------------------------------------XXXX--------------------X---------<>--------------------XXXX----------------------------------------------------XXX------------------------------------------------------X------------------------------------------------------XXXX---------------------------------------------------XXXXX--------------------X-------------------------------XXXX--------------------<>------<>---------------------XXXXX---------------------------------------------XX----XXXXX--------------------X------------------------------XXXXX--------------------X-------------------------------XXXX----------------------------------------------------XXXX--------------------<>------<>----------X---XXXX---XXXXX----------------------------<>----S-----------------XXXX--------------------<>------------------------------XXX---------------------X-------------------------------XXX---------------------X-------------
----------------------------------------E---------------S------------------------------EE-----[]--X---E-----------------------------------------------------------------S--------------------------E---EE-----[]----------[]-------------------------------E------------E-X----------------------------------------E--------E-----[]---------------------------------------E-E-EE-------E-----E-E-------o-----------------------------------------[]--E---------------------------------E--E---EE-----E-E-------------------------------------------------------E-X---------[]------------------------------------------E------------------------------------------E----E-------E----------E-------------------------------E------------E-----------------------------------------------E-------E-----------------------------------------------E-----E-E-X---------------------------------------------E-----EE--[]------[]--------------------------------------------E-----------------------------------------------E-----EE--X--------------------------------------------EE-----E-E-X--------E--------------------------------------------------------------------------------------------E-E-E-----[]------[]--------------------------------------------E---------[]----S-------------------------------E-----E---[]-------E------------------------------------E-------E-X---------------------------------------------E-----E-E-X-------------
XXXX--X---------------------XXXXXXXXXXXXXXXXXXXXXXXXXXXXXXXXXXXXXXXXXXXXX----------XXXXXXXXXXXXXXXXXXXXXXXXXXXXXXXXXXXXXXXXXXXXXX----------XXXXXXXXXXXXXXXXXXXXXXXXXXXXXXXXXXXXXXXXXXXXXX---X-XXXXXXXXXXXXXXXXXXXXXXXXXXXXXXXXXXXXXXXXXXXXXXXXXXX-----XXXXXXXXXXXXXXXXXXXXXXXXXXXXXXXXXXXXXXXXXX-X-XXXXX----------XXXXXXXXXXXXXXXXXXXXXXXXXXXXXXXXXXXXXXXXXXXXXX---------XXXXXXXXXXXXXXXXXXXXXXXXXXXXXXXXXXXXXXX-X-XXXX------------XXXXXXXXXXXXXXXXXXXXXXXXXXXXXXXXXXXXX-XXXXXXXXXXXXXXXXXXXXXXXXXXXXXXXXXXXXXXXXXXXXXXXXXXXXXXX-X-XXXXX-----------XXXXXXXXXXXXXXXXXXXXXXXXXXXXXXXXXXXXXXXXXXXXXX-----------XXXXXXXXXXXXXXXXXXXXXXXXXXXXXXXXXXXXXXXXXXXX------XXXXXXXXXXXXXXXXXXXXXXXXXXXXXXXXXXXXXXXXXXXXXXXXXXXX---XXXXXXXXXXXXXXXXXXXXXXXXXXXXXXXXXXXXXXXXXXX---XXXX-----------XXXXXXXXXXXXXXXXXXXXXXXXXXXXXXXXXXXXXXXXXXXXXX------------XXXXXXXXXXXXXXXXXXXXXXXXXXXXXXXXXXXXXXXXXXXXX----------XXXXXXXXXXXXXXXXXXXXXXXXXXXXXXXXXXXXXXXXXXXXX-----------XXXXXXXXXXXXXXXXXXXXXXXXXXXXXXXXXXXXX---XXXX-------------XXXXXXXXXXXXXXXXXXXXXXXXXXXXXXXXXXXXXX-XXXXX-----------XXXXXXXXXXXXXXXXXXXXXXXXXXXXXXXXXXXXXXXXXXXXXX--------XXXXXXXXXXXXXXXXXXXXXXXXXXXXXXXXXXXXXXXXXXXXXXXX--------X-XXXXXXXXXXXXXXXXXXXXXXXXXXXXXXXXX--------X---------------XXXXXXXXXXXXXXXXXXXXXXXXXXXXXXXXXXXXXXXXXXXXX---------XXXXXXXXXXXXXXXXXXXXXXXXXXXXXXXXXXXXXXXXXXXXXXX-------XXXXXXXXXXXXXXXXXXXXXXXXXXXXXXXXXXXXXXXXXXXXXXXX---------XXXXXXXXXXXXXXXXXXXXXXXXXXXXXXX
