--------------------------------------------------------------------------------------------------------------------------------------------------------------------------------------------------------------------------------------------------------------------------------------------------------------------------------------------------------------------------------------------------------------------------------------------------------------------------------------------------------------------------------------------------------------------------------------------------------------------------------------------------------------------------------------------------------------------------------------------------------------------------------------------------------------------------------------------------------------------------------------------------------------------------------------------------------------------------------------------------------------------------------------------------------------------------------------------------------------------------------------------------------------------------------------------------------------------------------------------------------------------------------------------------------------------------------------------------------------------------------------------------------------------------------------------------------
--------------------------------------------------------------------------------------------------------------------------------------------------------------------------------------------------------------------------------------------------------------------------------------------------------------------------------------------------------------------------------------------------------------------------------------------------------------------------------------------------------------------------------------------------------------------------------------------------------------------------------------------------------------------------------------------------------------------------------------------------------------------------------------------------------------------------------------------------------------------------------------------------------------------------------------------------------------------------------------------------------------------------------------------------------------------------------------------------------------------------------------------------------------------------------------------------------------------------------------------------------------------------------------------------------------------------------------------------------------------------------------------------------------------------------------------------------
--------------------------------------------------------------------------------------------------------------------------------------------------------------------------------------------------------------------------------------------------------------------------------------------------------------------------------------------------------------------------------------------------------------------------------------------------------------------------------------------------------------------------------------------------------------------------------------------------------------------------------------------------------------------------------------------------------------------------------------------------------------------------------------------------------------------------------------------------------------------------------------------------------------------------------------------------------------------------------------------------------------------------------------------------------------------------------------------------------------------------------------------------------------------------------------------------------------------------------------------------------------------------------------------------------------------------------------------------------------------------------------------------------------------------------------------------------
--------------------------------------------------------------------------------------------------------------------------------------------------------------------------------------------------------------------------------------------------------------------------------------------------------------------------------------------------------------------------------------------------------------------------------------------------------------------------------------------------------------------------------------------------------------------------------------------------------------------------------------------------------------------------------------------------------------------------------------------------------------------------------------------------------------------------------------------------------------------------------------------------------------------------------------------------------------------------------------------------------------------------------------------------------------------------------------------------------------------------------------------------------------------------------------------------------------------------------------------------------------------------------------------------------------------------------------------------------------------------------------------------------------------------------------------------------
--------------------------------------------------------------------------------------------------------------------------------------------------------------------------------------------------------------------------------------------------------------------------------------------------------------------------------------------------------------------------------------------------------------------------------------------------------------------------------------------------------------------------------------------------------------------------------------------------------------------------------------------------------------------------------------------------------------------------------------------------------------------------------------------------------------------------------------------------------------------------------------------------------------------------------------------------------------------------------------------------------------------------------------------------------------------------------------------------------------------------------------------------------------------------------------------------------------------------------------------------------------------------------------------------------------------------------------------------------------------------------------------------------------------------------------------------------
SSS-----------------------------------------------------S-------------------------------------------------------SS----------------------------Q-------------------------SSS-------------------------------------------------------------------------------------------------------------SS------------------------------------------------------SSS---------------Q-------------------------------------SS--------------------------------------------------------SS----------S-Q---------------------------------------SSSS------------Q----------------------------------------SSS------------Q---------------------------------------SSSS-S-----------------------QQQ------------------------SSS--S--------------------XX-QQQ-----------------------------XX-------------------------------------------------SSS------------------------------------------------------------------------------------------------------------------S----------------------------------------------------SSSSS---------------------------------------------------------------SQS--------------------------------------------------------------------QQQ-----------------------------SQQ-------------------------------------------------------------------------------------------------------------S--------------------------------------------------SS-------------------------------------------------------SSS-S--------------------------------------------------
------------------------------------------------------------------------------------------------------------------------------------------------------------------------------------------------E-----------------------------------------------------------------------------------------------------------------------------------------------------------------E-o---o--------------------------------------------------------------------------------------------------------------------------------------------------------------------------------------------------------------------------------------------------------------------------------------------------------------------------------------------------------------------------------------------S------------------------------------------------------------------o-------------------------------------------------------------------------------------------------------------------------------------------------------------------------------------------------------------------------------------------------------------------------------------------------------------------------------------------------------------------------------------------------------------------------------------------------------------------------------------------------------------------o---o---------------------------------------------------------------------------------------
--------------------XX-XXX-------------------------------------------------XXX-XXX-----------------------------------------------------XXX-------------------------------------------------XXX-XXX-----------------------------------------------------XX--------------------------------------------------XX--XXX------------------------------------------------XXXX-XXX-X-----------------------------------------------XXX-XXX---------------------------------------------------------------------------------------------------------------------------------------------------------------------XX--------------------------------------------------------------------------------------------------------------XX--------------------------------------------------------------------------------------------------------------XXX------------------------------------------------------X--------------------------------------------------------------------------------------------------------------XX--------------------------------------------------------------------------------------------------------------XXX------------------------------------------------------------------------------------------------------------XXXX---------------------------------------------------------------------------------------------------------XXX-XXX-----------------------------------------------------XX-------------------------------
---------------------------------------------------------------------------------------------------------------------------------------------------------------------------------------------------------------------------------------------------------------------------------------------------------------------------------------------------------------------------------------------------------------------------------------------------------------------------------------------------------------------------------------------------------------------------------S---------------------------------------SSSSS---------------------------------------------------------------------------------------------------------------------E---------------------------------------------------------------------------------------------------------------------------------------------------------------------------------------------------------------------------------------------------------------------------------------------S------------------------------------------------------------------------------------------------S-S----------------------------------------------------------------------------------------------------------------------------------------------------------------------------------------------------------------------------------------------------------------------------------------S----------
-----QQQ-----Q-----------------ooo-----------------------------Q-----Q----------------Qooo-----------------------------------Q-----------------Qo----------------------------E-QQ----Q-----------------Qo----------------------------Q-Q-----Q------------------o------E-----------------------Q-----Q-----------------Qo------------------------------Q-----Q-----------------oo------------------------------Q-----Q----------------QQo----------------------------E?QQ----Q--Q--------------Qo----------------------------E-Q-----Q----------------QQQ----------------------------E-Q-----Q--Q--------------ooo--S------------------------Q-Q-----Q----------------QQQ----------------------------Q-Q-----Q---------------QQQQ-----------------<>---------X------------------------QQo----------------------------Q-Q-----Q-----------------Qo----------------------------E-Q-----Q-----------------ooo---------------------------S?Q-----Q-----------------Qoo---------------------------Q?Q-----Q-----------------ooo---------------------------QQQ-----Q-----------------Qo------------------------------------Q---------------QQQQ----------------------------S?S-----------------------oo------------------------------Q--QQQQ-----------------Qo?---------------------------E-Q-----Q-----------------ooo-----------------------------Q-----Q----------------QQQ--------------------E-------Q-Q-----Q-----------------ooo----------------------
---------------------------------------E---E--------------------------------------------------------------------------------------o--------------------------------------------------------------------------------E------------------------------o-------------------<>-----------E----------------------o------------------------E---------------------------------------------------------------------S---------------------------------------------------------------------------------------------E-------------------------------------------------------------------E---------------------------------------------------------------------------------------------------------------E----------------------o-------------------------------[]----------------------o------------------------E--------------------------------------------------------------------------------------o-----------------------------------------------------------------------------------------------------------------------------------------------------E------------------------------------------------------------------------------------------------------------E--------------------o--------------------------------E---------------------------------------------------------------------------------------------------E----------------------------------o------------------------E--------<>----------------------------------------------------------
-----------XXX----XXX-----------------<>--<>------------------------------XXXX--------------------X-------------S----------XXX---XXXXX--------------------X-------<>----------------------XXXX--------------------<>------<>----S----------------XXXXX----------------[]----------<>----------------------XXXX--------------------<>------------------------------XXXX--------------------X-------------------------------XXXX-----------------------------------------------------XXX----------------<>--X---------------------------------------------------------------<>----------------------XXXX----------------------------------S-----------------XXXX----------------------------<>---------------------XXXXX----------------------------[]---------------XXX---XXXXX--------------------<>------<>----------------------XXXX--------------------X------------------------------XXXXX----------------------------------S-----------------XXXX--------------------X-------------S-----------------------------------------X---------------------------------------------------------------------------------------XXXX------------------------------<>--------------------XXXX----------------------------<>----------------------------------------------X-------------------------------XXXX----------------<>--<>-----------------------------XXXXX--------------------<>--------[]--------------------XXX---------------------X-------------
--------------------------------E-----[]--[]--------------------------------------------E-------E---------------S---------------------------------------E-X-------[]------------------------------------E-----E---[]------[]----S------------------------------EE-E---[]----------[]------------------------------------E-----E---[]----------------------------------------------------E-X---------------------------------------------E-----E-E------------------------------------------E---EE-E---[]--X----------------------------------------E----E-------E---------[]------------------------------------E------------------E----S------------------------------EE-E---E-E-X-------[]----o----------------------------E-EE-E---E-E---------[]------------------------------------E-E-E---E-[]------[]------------------------------------E-------E-X---E-E---------------------------------------E-------E---------------S-------------------------------E-----E-E-X--------E----S--------------------------E------------E-X---------------------------------------------E---E---E-X-----------------------------------------------------E-----------[]---------------------------------EE-----E-----------[]-------------------------------E-E--E-----E-E-X--------------------------------------------EE-----[]--[]--------------------------------------------E---------[]--E-----[]------------------------------------------E-X-------------
XXXXXXXX--------------------XXXXXXXXXXXXXXXXXXXXXXXXXXXXXXXXXXXX-X-XXXXX---------XXXXXXXXXXXXXXXXXXXXXXXXXXXXXXXXXXXXXXX----XXX------------X-XXXXXXXXXXXXXXXXXXXXXXXXXXXXXXXXXXXXXXXXXXXX--------XXXXXXXXXXXXXXXXXXXXXXXXXXXXXXXXXXXXXXXXXXXXXXX------------XXXXXXXXXXXXXXXXXXXXXXXXXXXXXXXXXXXXXXXXXXXXX--------XXXXXXXXXXXXXXXXXXXXXXXXXXXXXXXXXXXXXXXXX-XXXXX-----------XXXXXXXXXXXXXXXXXXXXXXXXXXXXXXXXXXXXX---XXXX----------XXXXXXXXXXXXXXXXXXXXXXXXXXXXXXXXXXXXXXXXXXXXXXXXX------XXXXXXXXXXXXXXXXXXXXXXXXXXXXXXXXXXXXXXXXXXXXXXXXXX--XXXXXXXXXXXXXXXXXXXXXXXXXXXXXXXXXXXXXXXXXXXXXXXXXXXXX--------XXXXXXXXXXXXXXXXXXXXXXXXXXXXXXXXXXXXXXXXXXXXXXXX----------XXXXXXXXXXXXXXXXXXXXXXXXXXXXXXXXXXXXXXXXXXXXX-----------XXXXXXXXXXXXXXXXXXXXXXXXXXXXXXXX----------X-------------XXXXXXXXXXXXXXXXXXXXXXXXXXXXXXXXXXXXXXXXXXXXXX----------XXXXXXXXXXXXXXXXXXXXXXXXXXXXXXXXXXXXXXXXXXXXXX----------XXXXXXXXXXXXXXXXXXXXXXXXXXXXXXXXXXXXX-XXXXXXX----------XXXXXXXXXXXXXXXXXXXXXXXXXXXXXXXXXXXXXXXXXXXXXX------XXXXXXXXXXXXXXXXXXXXXXXXXXXXXXXXXXXXXXXXXXXXXXXXXXXXX-XXXXXXXXXXXXXXXXXXXXXXXXXXXXXXXXXXXXXXXXXXXX---XXXX------------XXXXXXXXXXXXXXXXXXXXXXXXXXXXXXXXXXXXX---XXXXX------------XXXXXXXXXXXXXXXXXXXXXXXXXXXXXXXXXXXXXXXXXXXXXX--XXXXXXXXXXXXXXXXXXXXXXXXXXXXXXXXXXXXXXXXXXXXXXXXXXXXX---------XXXXXXXXXXXXXXXXXXXXXXXXXXXXXXXXXXXXXXXXXXXXXX------------XXXXXXXXXXXXXXXXXXXXXXXXXXXXXXXXXXXXXXXXXXXX---------XXXXXXXXXXXXXXXXXXXXXXXXXXXXXXX
