--------------------------------------------------------------------------------------------------------------------------------------------------------------------------------------------------------------------------------------------------------------------------------------------------------------------------------------------------------------------------------------------------------------------------------------------------------------------------------------------------------------------------------------------------------------------------------------------------------------------------------------------------------------------------------------------------------------------------------------------------------------------------------------------------------------------------------------------------------------------------------------------------------------------------------------------------------------------------------------------------------------------------------------------------------------------------------------------------------------------------------------------------------------------------------------------------------------------------------------------------------------------------------------------------------------------------------------------------------------------------------------------------------------------------------------------------------
--------------------------------------------------------------------------------------------------------------------------------------------------------------------------------------------------------------------------------------------------------------------------------------------------------------------------------------------------------------------------------------------------------------------------------------------------------------------------------------------------------------------------------------------------------------------------------------------------------------------------------------------------------------------------------------------------------------------------------------------------------------------------------------------------------------------------------------------------------------------------------------------------------------------------------------------------------------------------------------------------------------------------------------------------------------------------------------------------------------------------------------------------------------------------------------------------------------------------------------------------------------------------------------------------------------------------------------------------------------------------------------------------------------------------------------------------------
---------------------------------oo-------------------------ooo-------------------------oo--------------------------oo--------------------------oo--------------------------oo--------------------------oo--------------------------oo--------------------------oo--------------------------oo--------------------------oo----------------------SSSSSSSSSSSSSSSSS---------------ooo---------------------SSSSSSSSSSSSSSSSS---------------oo--------------------------ooo-------------------------ooo-------------------------ooo-------------------------oooS------------------------ooo-------------------------ooo---------------------SSS-SSSSSSSSSSS-----------------ooo-------------------------ooo-------------------------ooo-------------------------oSSS------------------------ooo-------------------------ooo-------------------------oo-S--------------------SSS-SSSSSSSSSSSS----------------ooo-------------------------ooo------S------------------ooo-------------------------ooo-------------------------ooo-------------------------ooo---------------------SSSSSSSSSSSSSSSSSSSSS-----------ooo---------------------SSS-SSSSSSSSSSSSS-----------SSSSSSSSSSSSSSSSS---------------ooo-------------------------oooS--SSSS--------------SSS-SSSSSSSSSSSSS-----------SSSSSSSSSSSSSSSSS---------------ooo-------------------------oooo------------------------ooo-------------------------oooS------------------------ooo---------------------
--------------------------------XXXX----------------------XXXXXX----------------------XXXXX-------------------------XXX------------------------XXXXX-----------------------XXXX-----------------------XXXXX-----------------------XXXXX------------------------XXXX-----------------------XXXXXX-------------------E---XXXXX---------------------------------------------------XXXXX---------------------------------------------------XXXXX------------------------XXXX-----------------------XXXXX------------------------XXX-------------------------XXXX-----------------------XXXXX------------------------XXXX------------------------XXXX-----------------------XXXXX------------------------XXXX------------------------XXXX------------------------XXX------------------------XXXXX-----------------------XXXXX-----------------------XXXXX------------------------XXX-------------------------XXXX------------------------XXXX-----------------------XXXXX-----------------------XXXXX-----------------------XXXXX-----------------------XXXXX----------------------------------------------------XXXX------------------------XXXX------------------------XXX------------------------XXXXX------------------------XXXX------------------------XXX-------------------------XXX-------------------------XXXX------------------------XXXX------------------------XXXX------------------------XXXX------------------------XXXX--------------------
--------------------------------------------------------------------------------------------------------------------------------------------------------------------------------------------------------------------------------------------------------------------------------------------------------------------------------------------------------------------------------------------------------------------------------------------------------------------------------------------------------------------------------------------------------------------------------------------------------------------------------------------------------------------------------------------------------------------------------------------------------------------------------------------------------------------------------------------------------------------------------------------------------------------------------------------------------------------------------------------------------------------------------------------------------------------------------------------------------------------------------------------------------------------------------------------------------------------------------------------------------------------------------------------------------------------------------------------------------------------------------------------------------------------------------------------------------
------------------------SSSS---------------------SSSSSSS-----------oo----E------SSSS---------o-------XX-----SSSS--oo-----oo-o-----------SSSS---------ooooo----------SSSS-----------ooo---XXS----SSS------------------E------SSSS-----------ooo---XXS----SSS------------ooo---ESS----SSS----------ooooo---XX-----SSS-------------------------SSSS-----------oooo----------SSS------------------------SSQS-------------------------SQS-----------oooo---------SSS-------------------------SSSS------------o-----------SSSS------------o------------SSS------------------------SSSS------------------------SSSS--------------E---------SSSS---------------------S---SSS-----------ooo-----------SSS------------o-----------SSSS------------------------SSSS-------------------------SSS----------------------SSSSSS-----------oo----------SSSSS------------o------------SQS-------------------------SSS---------------------SSSSSSS-------------------------SSS------------o-----------SSSS------------------------SSSS------------------------SSSS------------o-----------SSSS-------------------------SSS------------------------SSSS-------------------------SSS-------------------------SSS------------o-----------SSSS-------------------------SSS------------oo-----------SSS-------------------------SSS---------------------S--SSSQ---------------------S--SSSS------------o-----------SSSS------------o-----------SSSS------------oo----------SSSQ
----------------------------------------------------------------------------o---------------------------o-----------------------------------------------------------------------------------o---------------------------o---------------------------o---------------------------o-----------------------------------------------------------------------------------------------------------------------------------------------------------------------------------------------------------------------------------------------------------------------------------------------------------------------------------------------------------------------------------------------------------------------------------------------------------------------------------------------------------------------------------------------------------------------------------------------------------------------------------------------------------------------------------------------------------------------------------------------------------------------------------------------------------------------------------------------------------------------------------------------------------------------------------------------------------------------------------------------------------------------------------------------------------------------------------------------------------------------------------------------------------------------
------------------------------------------------------------------------------------------------------------------SS--S-SSS-------------------------SSSS-------------------------------------------------------------------------------------------------------------------------------------------------------------------------------------------E----SS--S--------------------------------------------------------------------------------S-SSSS------------------------------------------------------------------------------------------------------------------------------------------------------------------------------------------------------------------------------------------------o-----S-------------------------------------------------------------------------------------------------------------------------------------E----SS---------------------E----SS---------------------------------------------------------------------------------------------------------------------------------------------------------------------------------------------------------------------------------------------------------------------------------o-------------------------------------------------------o----SS---------------------o-----S-----------------------------------------------------------------------------o------------------------------------------------------------------------------------------------------------
------------------E---------------------------E---------------------------E---------------------------E----------oSS--SoS---------E--o------------SoS---------E-------------------------------------------------------E-----------------------------------------------------------------------------------E---------------------------E---------------SoS---------E--o------------------------E---------------------------E--o--------------S--SQ-----E---------------------------E---------------------------E---------------------------E---------------------------E---------------------------E---------------------------E---------------------------E---------------------------E---------------------------E--o------------------------E---------------------------E---------------------------E---------------------------E---------------SoS---S-----E--o-------------oS---------E--o------------------------E---------------------------E---------------------------E---------------------------E---------------------------E---------------------------E---------------------------E--o------------------------E---------------------------E---------------------------E--o------------------------E---------------SoS---------E--o--------------S---------E--o------------------------E--o------------------------E---------------------------E---------------------------E---------------------------E---------------------------E---------
-----------------<>--------S-----------------<>------ESS--------------X--<>-XXX--E?------------------<>---------SSSS--SSS--------<>------E?S------SSS--------<>------S?SX------------XXX----XXX----------------------<>----------------------XXX----XXX------------------XXX----XXX------------------XX--<>-XXX--X?XXXS--------------<>------E?S-SSS--SSS--------<>------E?S-----------------<>------E?S-----------------<>------E?S-----------------<>------S?S-----------------<>------E?S-----------------<>------E?S-----------------<>------E?S-----------------<>------E?S-----------------<>------E?S-----------------<>------E?S-----------------<>------E?S-----------------<>------E?S-----------------<>------E?S-----------------<>------E?S-----------------<>-----E--S-----------------<>-----E--S-----------------<>------S?S-oS---SSS--------<>------E?SSSSS--SSS--------<>------E?S-----------------<>--------S-----------------<>------E?S-----------------<>------E?S-----------------<>------E?S-----------------<>-------?S-----------------<>------E?S-----------------<>------E?S-----------------<>------E?S-----------------<>------E?S-----------------<>------E?S-----------------<>------E?S-SS----SS--------<>------E?S-SS--------------<>------E?S-----------------<>------E?S-----------------<>------E?S-----------------<>------E?S-----------------<>------E?S-----------------<>------E?S-----------------<>------E?S
-----------------[]--------------------------[]--------------------------[]------------o-------------[]--------------------------[]-----E------o-------------[]-----------Eo--------------E------------o-------------[]-----E------o--------------E------------o--------------E------------o-------------[]--------------------------[]--------------------------[]--------------------------[]--------------------------[]------------o-------------[]--------------------------[]--------------------------[]--------------------------[]--------------------------[]--------------------------[]-----E--------------------[]--------------------------[]--------------------------[]--------------------------[]--------------------------[]--------------------------[]----<>--------------------[]----<>--------------------[]--------------------------[]--------------------------[]--------------XX----------[]--------------------------[]--------------------------[]--------------------------[]--------------------------[]--------------------------[]--------------------------[]--------------------------[]--------------------------[]--------------------------[]--------------------------[]--------------------------[]--------------------------[]--------------------------[]--------------------------[]--------------------------[]--------------------------[]--------------------------[]--------------------------[]---------
-----------------[]--------------------------[]-----------XXXXXX---------[]-----------XXXXX----------[]-----------XXXX-----------[]-----------XXXXX----------[]-----------XXXXXX---------<>-----------XXXXX----------[]----<>-----XXXXXX---------<>-----------XXXXXX---------<>-----------XXXXXX---------[]-----------XXXXX----------[]------------X-------------[]------------XXX-----------[]--------------------------[]-----------XXXX-----------[]------------XXXX----------[]------------XXXX----------[]--------------------------[]--------------------------[]-----------XXXXX----------[]-------------XXX----------[]------------XX------------[]-----------XXXX-----------[]-------------XX-----------[]--------------------------[]--------------------------[]----[]--------------------[]----[]------XX------------[]----------XXXX------------[]--------------------------[]--------------------------[]--------------------------[]------------XXXX----------[]------------XXX-----------[]--------------------------[]-----------XXXXX----------[]--------------------------[]--------------------------[]--------------------------[]--------------------------[]------------XXX-----------[]------------XXX-----------[]------------XX------------[]--------------------------[]--------------------------[]--------------------------[]------------XXXX----------[]------------XXX-----------[]--------------------------[]---------
---------E-EE-E--[]----X---------------EE-E--[]--------------------------[]--------------------------[]--------------------------[]--------------------------[]--------------------------[]-----------------------E--[]----[]--------------------[]--------------------------[]--------------------------[]-----------------------E--[]--------------------------[]--------------------E-----[]-------------------EE-----[]--------------------------[]-------------------EE-----[]--------------------------[]--------------------------[]-------------------EE-E---[]------------------EEE-----[]-------------------EE-----[]-------------------EE-E---[]--------------------------[]--------------------------[]-------------------EE-----[]-----------------------E--[]----[]--------------E--E--[]----[]--------------------[]-----------------------EE-[]--------------------E-----[]--------------------E-EE--[]--------------------E-E---[]-----------------------E--[]--------------------E-----[]--------------------E--E--[]--------------------------[]--------------------E-----[]--------------------E-----[]-------------------EE-----[]--------------------E-----[]--------------------------[]--------------------------[]--------------------E-----[]--------------------E-----[]--------------------E-E---[]-------------------EE-E---[]--------------------E-----[]--------------------E-----[]--------------------E-E---[]---------
XXXXXXXXXXXXXXXXXXXXXXXXXXXXXXXX----XXXXXXXXXXXXXXX-XXXX----------XXXXXXXXXXXXXXXXXX----------XXXXXXXXXXXXXXXXXX----------XXXXXXXXXXXXXXXXXX----------XXXXXXXXXXXXXXXXXX---------------XXXXXXX-XXXXX----------XXXXXXXXXXXXXXXXXX---------------XXXXXXXXXXXXX---------------XXXXXXXXXXXXX------------X--XXXXXXXXXXXXX----------XXXXXXXXXXXXXXXXXX---------XXXXXXXXXXXXXXXXXXXX--------XXXXXXXXXXXXXXXXXXXXX------XXXXXXXXXXXXXXXXXXXX----------XXXXXXXXXXXXXXXXXXXX-------XXXXXXXXXXXXXXXXXXXXX--------XXXXXXXXXXXXXXXXXXXX-------XXXXXXXXXXXXXXXXXXXXXX-----XXXXXXXXXXXXXXXXXXXXX--------XXXXXXXXXXXXXXXXXXXXXX------XXXXXXXXXXXXXXXXXXXXX-------XXXXXXXXXXXXXXXXXXX----------XXXXXXXXXXXXXXXXXXXX-------XXXXXXXXXXXXXXXXXXXXXX-----XXXXXXXXXXXXXXXXXXXXXXXX----XXXXXXXXXXXXXXXXXXXXXXX------XXXXXXXXXXXXXXXXXXXX---------XXXXXXXXXXXXXXXXXX---------XXXXXXXXXXXXXXXXXXX---------XXXXXXXXXXXXXXXXXXXXXX------XXXXXXXXXXXXXXXXXXXXXX-----XXXXXXXXXXXXXXXXXXXX----------XXXXXXXXXXXXXXXXXXXX-------XXXXXXXXXXXXXXXXXXXXX-------XXXXXXXXXXXXXXXXXXXX---------XXXXXXXXXXXXXXXXXX---------XXXXXXXXXXXXXXXXXXXXX-------XXXXXXXXXXXXXXXXXXXXXX-----XXXXXXXXXXXXXXXXXXXXXX------XXXXXXXXXXXXXXXXXXXXX--------XXXXXXXXXXXXXXXXXXXX--------XXXXXXXXXXXXXXXXXXXX--------XXXXXXXXXXXXXXXXXXXXX------XXXXXXXXXXXXXXXXXXXXXXX------XXXXXXXXXXXXXXXXXXXXX-----XXXXXXXXXXXXXXXXXXXXXXX-------XXXXXXXXXXXXXXXXXXXXX-------XXXXXXXXXXXXXXXXXXXXX-------XXXXXXXXXXXXXXXXXXX
