--------------------------------------------------------------------------------------------------------------------------------------------------------------------------------------------------------------------------------------------------------------------------------------------------------------------------------------------------------------------------------------------------------------------------------------------------------------------------------------------------------------------------------------------------------------------------------------------------------------------------------------------------------------------------------------------------------------------------------------------------------------------------------------------------------------------------------------------------------------------------------------------------------------------------------------------------------------------------------------------------------------------------------------------------------------------------------------------------------------------------------------------------------------------------------------------------------------------------------------------------------------------------------------------------------------------------------------------------------------------------------------------------------------------------------------------------------
--------------------------------------------------------------------------------------------------------------------------------------------------------------------------------------------------------------------------------------------------------------------------------------------------------------------------------------------------------------------------------------------------------------------------------------------------------------------------------------------------------------------------------------------------------------------------------------------------------------------------------------------------------------------------------------------------------------------------------------------------------------------------------------------------------------------------------------------------------------------------------------------------------------------------------------------------------------------------------------------------------------------------------------------------------------------------------------------------------------------------------------------------------------------------------------------------------------------------------------------------------------------------------------------------------------------------------------------------------------------------------------------------------------------------------------------------------
---------------------------------oo-------------------------ooo-------------------------oo--------------------------oo--------------------------oo--------------------------oo--------------------------oo--------------------------oo--------------------------oSSS------------------------oo--------------------------oo--------------------------ooo---------------------SSS-ooSS-SSSSSSS----------------ooo-------------------------oooS------------------------ooo-------------------------ooo-------------------------oooS--SSSS------------------oooS------------------------------------------------SSSSSSSSSSSSSSSSSS-S------------ooo-------------------------ooo-------------------------ooo-------------------------ooo-------------------------ooSS--SSSS--------------SSSSSSSSSSSSSSSSSSSSS-----------oSoS--SSSSS-----------------ooo-------------------------ooo---------------------SSSSSSSSSSSSSSSSS---------------ooo-------------------------ooo-------------------------ooo-------------------------ooo---------------------------o-------------------------ooo-------------------------ooo---------------------SSSSSSSSSSSSSSSSSSSS------------ooo-----------------------------------------------------ooo-------------------------ooo---------------------SSS-SSSSSSSSSSSSS-----------SSSSSSSSSSSSSSSSS--S--------SSSSSSSSSSSSSSSSS---------------oSoS-SSSSSS-----------------oooS---SSS--------------SSSSSSSSSSSSSSSSSS-S--------
--------------------------------XXXX-----------------------XXXXX-----------------------XXXX------------------------XXXX------------------------XXXXX----------------------XXXXX------------------------XXXX-----------------------XXXXX--------------------E----XXX-----------------------XXXXX------------------------XXXX------------------------XXXXX------------------------XXXX------------------------XXXX------------------------XXXX-----------------------XXXXX-----------------------XXXXX------------------------XXXX------------------------XXXX----------------------------------------------------XXX-------------------------XXXX------------------------XXXX------------------------XXXX------------------------XXXX-----------------------XXXXX----------------------------------------------------XXX-------------------------XXXX-----------------------XXXXX------------------------XXX-------------------------XXXX-----------------------XXXXX------------------------XXXX-----------------------XXXXX------------------------XXXX-----------------------XXXXX------------------------XXXX-------------------------X--------------------------XXXX------------------------XXX------------------------XXXXX------------------------XXXX------------------------XXXX-------------------------XX--------------------------XX-------------------------XXXX------------------------XXXX------------------------XXXX--------------------
--------------------------------------------------------------------------------------------------------------------------------------------------------------------------------------------------------------------------------------------------------------------------------------------------------------------------------------------------------------------------------------------------------------------------------------------------------------------------------------------------------------------------------------------------------------------------------------------------------------------------------------------------------------------------------------------------------------------------------------------------------------------------------------------------------------------------------------------------------------------------------------------------------------------------------------------------------------------------------------------------------------------------------------------------------------------------------------------------------------------------------------------------------------------------------------------------------------------------------------------------------------------------------------------------------------------------------------------------------------------------------------------------------------------------------------------------------
------------------------SSSS------------------------SSSS------------------------SSSS---------oo-o-----------SSSS---------oooo----E-------SSS------------------------SSSS---------oooo----X------SSS----------o--------------SSSS----------oooo---XXS----SSS----o--------------------SSSS---------oooo----XX-----SSS------------ooo---XX-----SSS----o--------o-----------SSSS------------o-----------SSSS--------------E------S--SSSS------------o-----------SSSS------------oo-------S--SSS-------------oo----------SSSS---------------------S---SSS---------------------S--SSSS-------------------------SSS-------------------------SSS------------------------SSSS---------------------SSSSSSS------------o-----------SSSS------------------------SSSQ------------o------------SSS-------------------------SSS-------------------------SSS---------------------SS-SSSS------------o-----------SSSS-------------------------SSS-------------------------SSS------------oo----------SSSS---------------------S--SSSS------------------------SSSS--------------------------QQ------------o-----------SSSS------------o--------S--SSSS-------------------------SSS------------------------SSSS------------------------SSSS------------oo-------SSSSSSQ------------------------SSSS-------------------------SSS-------------------------SQS-------------------------SSS-------------------------QQQ-------------------------SSS---------------------S---SSS
--------------------------------------------------------------------------------------------------------------------------------------------------------------------------------------------o-------------------------------------------------------o-------------------------------------------------------o--------------------------ooo--------------------------------------------------------------------------------------------------------------------------------------------------------------------------------------------------------------------------------------------------------------------------------------------------------------------------------------------------------------------------------------------------------------------------------------------------------------------------------------------------------------------------------------------------------------------------------------------------------------------------------------------------------------------------------------------------------------------------------------------------------------------------------------------------------------------------------------------------------------------------------------------------------------------------------------------------------------------------------------------------------------------------------------------------------------------------------------------------------------
------------------------------------------------------------------------------------------S-SS---------------------S--S-SS----------------------------------------------------------------------------------S-------------------------------------------------SS--S-SS-----------------------------------------------------------------------------S--S-SS-----------------------------------------------------------------------------------------------------------------------------------------------------------------o---------------------------------------------------------------------------------------------------------------------------------------------------------------------------------------------------------------------------------------------------------------------------------------------------------------------------------------------------------------------------o-----------------------------------------------------------------------------------------------------------------------------------------------------------------------------------------------------------------------------------------------------------------------------------------------------------------------------------------------------------------------------------------------------------------------------------------------------------------------------------------------------------------------o------------------------
------------------E--S------------------------E---------------------------E---------------SoS---------E--o-------o----SoS---------E--o------------------------E---------------------------E---------------SoS---------E--------------------------------------oSS--SoS---------E--o------------------------E--------------------------------------ooS--SoS---------E--o------------------------E--o------------------------E--o------------------------E---------------------------E---------------------------E---------------------------E---------------------------E---------------------------E---------------------------E--o------------------------E---------------------------E---------------------------E---------------------------E---------------------------E--o------------------------E--o------------------------E--o------------------------E-----------------S---------E---------------------------E--o------------------------E---------------------------E---------------------------E---------------------------E---------------------------E---------------------------E---------------------------E---------------------------E--o------------------------E------------------S--------E---------------------------E---------------------------E---------------------------E--o------------------------E--o------------------------E--o------------------------E---------------------------E--o------------------------E--o------
-----------------<>-----E--------------------<>------E?S-----------------<>-----E??SXSS---SSS--------<>------E?SXSS---SSS----XX--<>------E?SXXS--------------<>------E?X-----------------<>-XX---E?-XXS---SSS--------<>------E?X-------------XX--<>-XXX-----SSSS--SSS--------<>------E?S-------------XX--<>-XXX--E---------------XXX----XXX-----SSS---SSS--------<>------E?S-----------------<>------E?S-----------------<>------E?S-----------------<>------E?S-----------------<>--S---E?S-----------------<>--S---E?S-----------------<>------E?S-----------------<>------E?S-----------------<>-----E--------------------<>------E?S-----------------<>------E?S-----------------<>-----E--S-----------------<>------E?S-----------------<>------E?S-----------------<>------E?S-----------------<>------E?S-----------------<>------E?S-----------------<>------E?S-----------------<>------E?S-----------------<>------E?S-----------------<>-------?S-----------------<>------E?S-----------------<>------E?S-----------------<>------E?S-----------------<>------E?S-----------------<>--------S-----------------<>------S?S-----------------<>------E?S-----------------<>------E?S-----------------<>--S-----------------------<>------S?S-----------------<>-----E--S-----------------<>------E?S-----------------<>------S?S-----------------<>------E?S-----------------<>------E?S-----------------<>------E?S-----------------<>------E?S
-----E-----------[]----<>--------XXX-?-------[]--------------------------[]----<>------o-------------[]------------o-------------[]--------------------------[]-----------Eo-------------[]------------o-------------[]------------o-------------[]--------------------------[]-----------Eo-------------[]------------o--------------E--------------------------[]--------------------------[]--------------------------[]--------------------------[]--------------------------[]--------------------------[]--------------------------[]--------------------------[]--------------------------[]----<>--------------------[]--------------------------[]--------------------------[]--------------------------[]--------------------------[]--------------------------[]--------------------------[]--------------------------[]--------------------------[]--------------------------[]--------------------------[]--------------------------[]--------------------------[]--------------------------[]--------------------------[]--------------------------[]--------------------------[]--------------------------[]--------------------------[]--------------------------[]--------------XXX-?-------[]-------X------------------[]--------------------------[]----<>--------------------[]--------------------------[]--------------------------[]--------------------------[]--------------------------[]--------------------------[]---------
----<>-----------[]----[]--------------------[]------------XXXX----------[]----[]-----XXXXX----------[]-----------XXXXX----------[]-----------XXXXX----------[]-----------XXXXX----------[]-----------XXXXX----------[]-----------XXXXXX---------[]------------XXX-----------[]-----------XXXXXX---------[]-----------XXXXX----------<>-----E-----XXXX-----------[]--------------------------[]--------------X-----------[]------------XX------------[]------------XXXX----------[]------------XXXX----------[]--------------------------[]--------------------------[]--------------------------[]----[]--------------------[]--------------XX----------[]--------------------------[]------------XXXX----------[]-------------XX-----------[]------------X-------------[]--------------------------[]--------------------------[]-------------XX-----------[]-----------XXXXX----------[]--------------------------[]--------------------------[]------------XX------------[]--------------------------[]------------X-------------[]--------------------------[]-------------XX-----------[]------------XXXX----------[]--------------------------[]--------------------------[]--------------------------[]------------XXXX----------[]--------------------------[]----[]--------------------[]--------------------------[]--------------------------[]--------------------------[]--------------------------[]--------------------------[]---------
----[]---EEE--E--[]----[]-E------------E--E--[]---E----------------E--E--[]----[]--------------------[]--------------------------[]--------------------------[]--------------------------[]--------------------------[]--------------------------[]--------------------------[]--------------------------[]--------------------------[]-----------------------E--[]--------------------E-----[]-------------------EE-----[]--------------------------[]----------------------EE--[]--------------------E-E---[]-------------------EE-E---[]-------------------EE-----[]--------------------E-E---[]----[]--------------E-----[]-------------------EE-----[]--------------------E-EE--[]--------------------E-----[]-------------------EE-----[]--------------------------[]--------------------E-----[]-------------------EE-----[]-------------------EE-E---[]--------------------------[]--------------------E-----[]--------------------E-E---[]--------------------E-----[]--------------------E-E---[]--------------------E-----[]--------------------E-E---[]--------------------E--E--[]--------------------E-E---[]--------------------------[]--------------------E-----[]----------------------EE--[]-------E------------E--E--[]--------------------E-----[]----[]--------------------[]--------------------E-----[]-------------------EE-----[]--------------------E-E---[]--------------------E-----[]-------------------EE-E---[]---------
XXXXXXXXXXXXXXXXXXXXXXXXXXXXXXX------XXXXXXXXXXXXXXXXXXXXX-------XXXXXXXXXXXXXXXXXXX----------XXXXXXXXXXXXXXXXXX----------XXXXXXXXXXXXXXXXXX----------XXXXXXXXXXXXXXXXXX-----------XXX-XXXXXXXXXXXXX----------XXXXXXXXXXXXXXXXXX---------------XXXXXXXXXXXXX---------XXXXXXXXXXXXXXXXXXX-----------XX--XXXXXXXXXXXXX-----------X---XXXXXXXXXXXXX----------XXXXXXXXXXXXXXXXXXXX-------XXXXXXXXXXXXXXXXXXXXXX------XXXXXXXXXXXXXXXXXXXXX-------XXXXXXXXXXXXXXXXXXXX---------XXXXXXXXXXXXXXXXXXXX--------XXXXXXXXXXXXXXXXXXXXX----XXXXXXXXXXXXXXXXXXXXXXXX-----XXXXXXXXXXXXXXXXXXXXXXXX-----XXXXXXXXXXXXXXXXXXXXX------XXXXXXXXXXXXXXXXXXXXXXX------XXXXXXXXXXXXXXXXXXXXXX------XXXXXXXXXXXXXXXXXXXXX-------XXXXXXXXXXXXXXXXXXXXX-------XXXXXXXXXXXXXXXXXXX---------XXXXXXXXXXXXXXXXXXXXXX-----XXXXXXXXXXXXXXXXXXXXXXX-----XXXXXXXXXXXXXXXXXXXXXXX------XXXXXXXXXXXXXXXXXXX----------XXXXXXXXXXXXXXXXXXXX-------XXXXXXXXXXXXXXXXXXXXXX------XXXXXXXXXXXXXXXXXXXXX-------XXXXXXXXXXXXXXXXXXXXX-------XXXXXXXXXXXXXXXXXXXXX-------XXXXXXXXXXXXXXXXXXXXXX------XXXXXXXXXXXXXXXXXXXX---------XXXXXXXXXXXXXXXXXXXX--------XXXXXXXXXXXXXXXXXXXX------XXXXXXXXXXXXXXXXXXXXXX-------XXXXXXXXXXXXXXXXXXXXXX------XXXXXXXXXXXXXXXXXXXXX--------XXXXXXXXXXXXXXXXXXXXX-----XXXXXXXXXXXXXXXXXXXXXX-------XXXXXXXXXXXXXXXXXXXXX-------XXXXXXXXXXXXXXXXXXXXX------XXXXXXXXXXXXXXXXXXXXXX-------XXXXXXXXXXXXXXXXXXXXX-------XXXXXXXXXXXXXXXXXXXXX-------XXXXXXXXXXXXXXXXXXX
