--------------------------------------------------------------------------------------------------------------------------------------------------------------------------------------------------------------------------------------------------------------------------------------------------------------------------------------------------------------------------------------------------------------------------------------------------------------------------------------------------------------------------------------------------------------------------------------------------------------------------------------------------------------------------------------------------------------------------------------------------------------------------------------------------------------------------------------------------------------------------------------------------------------------------------------------------------------------------------------------------------------------------------------------------------------------------------------------------------------------------------------------------------------------------------------------------------------------------------------------------------------------------------------------------------------------------------------------------------------------------------------------------------------------------------------------------------
--------------------------------------------------------------------------------------------------------------------------------------------------------------------------------------------------------------------------------------------------------------------------------------------------------------------------------------------------------------------------------------------------------------------------------------------------------------------------------------------------------------------------------------------------------------------------------------------------------------------------------------------------------------------------------------------------------------------------------------------------------------------------------------------------------------------------------------------------------------------------------------------------------------------------------------------------------------------------------------------------------------------------------------------------------------------------------------------------------------------------------------------------------------------------------------------------------------------------------------------------------------------------------------------------------------------------------------------------------------------------------------------------------------------------------------------------------
--------------------------------ooo-------------------------ooo-------------------------oo--------------------------o-SS--------------------SSS-SSSSSSSSSSSSS---------------oo--------------------------ooo-------------------------ooSS------------------------ooo-------------------------ooo-------------------------ooo---------------------SSSSSSSSSSSSSSSSS---------------ooo-------------------------oo--------------------------oo----------------------SSS-SSSSSSSSSSS-----------------ooo-------------------------oo--------------------------oo--------------------------oooS--SSSSS-------------SSS-SSSSSSSSSSS-----------------ooo-------------------------oo--------------------------oSSSS-S-----------------SSSSSSSSSSSSSSSSS---------------oo--------------------------ooo-------------------------ooo---------------------SSSSSSSSSSSSSSSS----------------ooSS--------------------SSSSSSSSSSSSSSSS----------------ooo---------------------SSS-ooSS-SSSSSS-----------------oo--------------------------oo--------------------------oo--------------------------oooS--SSSS------------------ooo-------------------------ooo-------------------------oo--------------------------oo--------------------------oo--------------------------ooo-------------------------oSSSSSSSSSS-----------------ooo-------------------------ooo-------------------------ooo---------------------SSS-SSSSSSSSSSSS----------------ooo---------------------
--------------------------------XXXX------------------------XXXX-----------------------XXXX-----------------------------------------------------XXX------------------------XXXXX-----------------------XXXXX-----------------------XXXX-------------------------XXXX-----------------------XXXXX-----------------------XXXXX------------------------XXX------------------------XXXXX-----------------------XXXXX-----------------------XXXX-------------------------XXX-----------------------XXXXXX-----------------------XXXXX-----------------------XXXX-------------------------XXXX------------------------XXX------------------------XXXXX-----------------------XXXXX------------------------XX-----------------------------------------------------XXXXX----------------------XXXXXX-----------------------XXXXX----------------------------------------------------XXX-------------------------XX-------------------------XXXXX------------------------XXX------------------------XXXX------------------------XXXX------------------------XXXX-------------------------XXXX-----------------------XXXXX-----------------------XXXXX----------------------XXXXXX-----------------------XXXXX-----------------------XXXXX-----------------------XXXXX------------------------XXXX-----------------------XXXXX-----------------------XXXXX-----------------------XXXXX------------------------XXX------------------------XXXX---------------------
--------------------------------------------------------------------------------------------------------------------------------------------------------------------------------------------------------------------------------------------------------------------------------------------------------------------------------------------------------------------------------------------------------------------------------------------------------------------------------------------------------------------------------------------------------------------------------------------------------------------------------------------------------------------------------------------------------------------------------------------------------------------------------------------------------------------------------------------------------------------------------------------------------------------------------------------------------------------------------------------------------------------------------------------------------------------------------------------------------------------------------------------------------------------------------------------------------------------------------------------------------------------------------------------------------------------------------------------------------------------------------------------------------------------------------------------------------
---------------------SSSSSSS---------------------SSSSSSS---------------------SSSSSSS---------oo-o----E------SSSS--oo-----o--------------SSSS-----------ooo-----------SQS------S--o----E----------SS-------------o-----------SSQQ---------o--o------------SSS------------------------SSSS------------o-----------SSSS------------------------SSSS------------------------SSSS-----------ooo----------SSSS------------------------SSSS------------o-----------SSSS------S--o--o------------SSS------------------------SSSS------------------------SSSS------------o-----------SSSS------------------------SSSS------------oo-----------SSS--------------E---------SSSS------S---ooooo---------SSSS---o--------o------------SSS---o--S--o--o------------SSS-----------ooo----------SSSS------------------------SSSS-----------------------SSSSS------------o------------SSS------------o-E---------SSSS------------ooo----------SSS------------o-E---------SSSS--------------E----------SQS---------o--o-----------SSSS------------------------SSSS------------o-----------SSSS------------o-----------SSSS------------------------SSSS-----------oooo---------SSSQ-----------ooo----------SSS-------------o-----------SSSS------------------------SSSS------------o-----------SSSS------------------------SSSS------------------------SSSS------------o-----------SSSS------------o-E----------SSS------------o------------SSS------------o-E----------SSS
--------------------------------------------------------------------------------------------------------o----------------------------------------------------------------------------<>--------------------------------------------------------------------------------------------------------------------------------------------------------------------------------------------------------------------------------------------------------------------------------------------------------------------------------------------------------------------------------------------------------------------------------------------------------------<>------------------------------------------------------------------------------------------------------------------------------------------------------------------------------------------------------------------------------------------------------------------------------------------------------------------<>-----------------------------------------------------------------------------------------------------------------------------------------------------------------------------------------------------------------------------------------------------------------o-----------------------------------------------------------------------------------------------------------------------------------------------------------------------------------------------------------
--------------------------------------------------------------------------------------------S---------------------SS--S-SS---------------------E----SS---------------------E--S-SS---[]---------------------SS---------------------S--S-SS--------------------------------------------------------------------------------------------------------------S-----------------------------------------------------------------------------------SS--------------------SS--S-SSS---------------------------------------------------------------------------SS--S-SS---------------------o--------------------------------SS---------------------o----SS---[]-------------------S-SSS-------------------SS--S-SS--------------------SS--S-SSS-------------------------SS-SSS-------------------------------------------------------------------------E----SS---------------------E--S-SS---------------------------S--S------------------o--------------------------------SS---[]-------------------S-SS--------------------------S---------------------------SS--------------------------SS---------------------------------------------------------SSS-----------------------S--------------------------S---------------------------S----------------------E----SS---------------------------------------------------------------------------------------------------------E----SS---------------------E----SS---------------------E----SS------------------
------------------E---------------------------E---------------------------E---------------SoS---------E----------oSS--SoS---------E--o------------SoS---------E--o------------SoS----[]---E--o--------------S---------E-----------S---SoS---------E--o------------------------E--o--------------S---------E---------------------------E-----------------S---------E--o------------------------E---------------------------E---------------SoS---------E----------oSS--SoS---------E--o------------------------E---------------------------E----------oSS--SoS---------E--o------------------------E--o------------SoS---------E--o------------SoS----<----E---------------SoS---------E----------oSS--SoS---------E--o------ooSS--SoS---------E--o------------S-S---Q-----E---------------------------E---------------------------E---------------SoS---------E--o------------SoS---------E--o--------------S---Q-----E--o------------------------E-----------------S---->----E--o------------SoS---------E--o------------SoS---------E--o------------SoS---------E---------------SoS---------E--o------------------------E---------------------Q-----E-----------------S---------E-----------------S---------E---------------SoS---------E---------------SoS---------E--o------------------------E--o------------------------E---------------------------E---------------SoS---------E--o------------SoS---------E--o------------SoS---------E--o------
--E---E----------<>-----E--S-----------------<>-------?S-----------------<>------E?---S---SSS--------<>------E?XSSSS--SSS--------<>------E?S-SS---SSS--------<>------S?SXSS---SSS--------<>------S?S-----------------<>------S?S-SS---SSS--------<>------E?S-----------------<>------E?S-----------------<>------E?S-----------------<>------E?S-------SS--------<>------S?S-----------------<>------E?S-----------------<>------E?S--S---SSS--------<>------E?SSSS---SSS--------<>------E?S-----------------<>------E?S-----------------<>------E?SSSS---SSS--------<>------E?S-----------------<>------E?S-SS----SS--------<>------E?SSSS----SS--------<>------ESSXSS---SSS--------<>------S?SSSSS--SSS--------<>------E?SSSSS--SSS--------<>------E?S-------SS--------<>------E?S-----------------<>-----E??S-----------------<>------E?S-SS---SSS--------<>------E?SSSS---SSS--------<>------E?S-----------------<>------E?S-----------------<>------E?S-------SS--------<>------S?SSSS---SSS--------<>------E?S-SS---SSS--------<>------E?S-SS---SSS--------<>------E?S-------SS--------<>------S?S-----------------<>------E?S-----------------<>------S?S-----------------<>------E?S-----------------<>------E?SXXS---SSS--------<>------E?S-SS---SSS--------<>------E?S-----------------<>-----ES?S-----------------<>------E?S-----------------<>------E?SSSS---SSS--------<>------E?S-SS---SSS--------<>------E?S--S----SS--------<>------E?S
-<>--<>----------[]----<>--------------------[]--------------X-----------[]-----------Eo-------------[]--------------------------[]-----E--------------------[]------------o-------------[]--------------------------[]--------------------------[]--------------------------[]--------------------------[]--------------------------[]--------------------------[]--------------------------[]--------------------------[]------------o-------------[]--------------------------[]--------------------------[]--------------------------[]--------------------------[]--------------------------[]--------------------------[]--------------------------[]--------------------------[]--------------------------[]--------------------------[]--------------------------[]--------------------------[]----<>--------------------[]--------------------------[]------------o-------------[]--------------------------[]--------------------------[]--------------------------[]------------o-------------[]------------o-------------[]--------------------------[]--------------------------[]--------------------------[]-----E--------------------[]--------------------------[]------------o-------------[]------------o-------------[]--------------------------[]--------------------------[]----<>--------------------[]--------------------------[]--------------------------[]--------------------------[]------------o-------------[]---------
-[]--[]----------[]----[]--------------------[]--------------------------[]-----------XXXXX----------[]-----------XXXX-----------[]------------XX------------[]-----------XXXXX----------[]-----------XXXXX----------[]-----------XXXX-----------[]------------XXX-----------[]-----------XXXXX----------[]------------XXX-----------[]------------X-------------[]-----------XXXXX----------[]-----------XXXX-----------[]-----------XXXXX----------[]-----------XXXX-----------[]------------XXXXX---------[]-----------XXXXX----------[]-----------XXXX-----------[]--------------------------[]------------X-------------[]------------XXX-----------[]-----------XXXXX----------[]-----------XXXX-----------[]-----------XXXX-----------[]----------XXX-------------[]------------XXXX----------[]----[]------XXXX----------[]-----------XXXX-----------[]-----------XXXXX----------[]--------------------------[]-----------XXXXX----------[]-----------XXXXX----------[]-----------XXXXX----------[]-----------XXXXX----------[]-----------XXXXX----------[]------------XX------------[]------------XXX-----------[]-----------XXXXX----------[]-----------XXXXX----------[]-----------XXXXX----------[]-----------XXXXX----------[]-----------XXXX-----------[]--------------------------[]----[]--------XX----------[]------------XXXX----------[]-----------XXXXX----------[]-----------XXXX-----------[]-----------XXXXX----------[]---------
-[]--[]----E-E---[]----[]--------------E--E--[]-----------------------E--[]--------------------------[]------------------E-------[]--------------------------[]--------------------------[]--------------------------[]--------------------------[]--------------------E-----[]--------------------------[]------------------E-E-----[]------------------E-E-----[]--------------------------[]------------------E-------[]--------------------------[]--------------------------[]--------------------E--E--[]------------------E-------[]------------------E-------[]--------------------E-----[]--------------------------[]----------------------E---[]--------------------------[]--------------------------[]--------------------------[]--------------------------[]-----------------------E--[]----[]--------------E-----[]------------------E-------[]------------------E-E-----[]--------------------------[]--------------------E-----[]--------------------E-----[]--------------------------[]------------------E-------[]--------------------------[]--------------------------[]------------------EEE-----[]--------------------------[]--------------------------[]--------------------------[]------------------E-------[]--------------------------[]--------------------E-----[]----[]--------------E-----[]--------------------E-----[]--------------------------[]--------------------------[]------------------E-------[]---------
-XXXXXXXXXXXXXXXXXXXXXXXXXXXXXXX---XXXXXXXXXXXXXXXXXXXXXX---------XXXXXXXXXXXXXXXXXX----------XXXXXXXXXXXXXXXXXX-------XXXXXXXXXXXXXXXXXXXXX---------XXXXXXXXXXXXXXXXXXX----------XXXXXXXXXXXXXXXXXX----------XXXXXXXXXXXXXXXXXX----------XXXXXXXXXXXXXXXXXXXX-------XXXXXXXXXXXXXXXXXXX----------XXXXXXXXXXXXXXXXXXX--------XXXXXXXXXXXXXXXXXXX---------XXXXXXXXXXXXXXXXXXXX---------XXXXXXXXXXXXXXXXXX---------XXXXXXXXXXXXXXXXXXX----------XXXXXXXXXXXXXXXXXX----------XXXXXXXXXXXXXXXXXXXX--------XXXXXXXXXXXXXXXXXX----------XXXXXXXXXXXXXXXXXX---------XXXXXXXXXXXXXXXXXXXXX------XXXXXXXXXXXXXXXXXXXX---------XXXXXXXXXXXXXXXXXXX----------XXXXXXXXXXXXXXXXXX----------XXXXXXXXXXXXXXXXXX---------XXXXXXXXXXXXXXXXXXX---------XXXXXXXXXXXXXXXXXXX----------XXXXXXXXXXXXXXXXXXX---------XXXXXXXXXXXXXXXXXXX--------XXXXXXXXXXXXXXXXXXX---------XXXXXXXXXXXXXXXXXXX---------XXXXXXXXXXXXXXXXXXXX--------XXXXXXXXXXXXXXXXXXXX---------XXXXXXXXXXXXXXXXXX---------XXXXXXXXXXXXXXXXXXX----------XXXXXXXXXXXXXXXXXX---------XXXXXXXXXXXXXXXXXXX----------XXXXXXXXXXXXXXXXXX---------XXXXXXXXXXXXXXXXXXXXX-------XXXXXXXXXXXXXXXXXXX----------XXXXXXXXXXXXXXXXXX----------XXXXXXXXXXXXXXXXXX----------XXXXXXXXXXXXXXXXXX----------XXXXXXXXXXXXXXXXXX----------XXXXXXXXXXXXXXXXXXXX-----XXXXXXXXXXXXXXXXXXXXXXXX------XXXXXXXXXXXXXXXXXXXX--------XXXXXXXXXXXXXXXXXXX----------XXXXXXXXXXXXXXXXXX---------XXXXXXXXXXXXXXXXXXX----------XXXXXXXXXXXXXXXXXX
