--------------------------------------------------------------------------------------------------------------------------------------------------------------------------------------------------------------------------------------------------------------------------------------------------------------------------------------------------------------------------------------------------------------------------------------------------------------------------------------------------------------------------------------------------------------------------------------------------------------------------------------------------------------------------------------------------------------------------------------------------------------------------------------------------------------------------------------------------------------------------------------------------------------------------------------------------------------------------------------------------------------------------------------------------------------------------------------------------------------------------------------------------------------------------------------------------------------------------------------------------------------------------------------------------------------------------------------------------------------------------------------------------------------------------------------------------------
--------------------------------------------------------------------------------------------------------------------------------------------------------------------------------------------------------------------------------------------------------------------------------------------------------------------------------------------------------------------------------------------------------------------------------------------------------------------------------------------------------------------------------------------------------------------------------------------------------------------------------------------------------------------------------------------------------------------------------------------------------------------------------------------------------------------------------------------------------------------------------------------------------------------------------------------------------------------------------------------------------------------------------------------------------------------------------------------------------------------------------------------------------------------------------------------------------------------------------------------------------------------------------------------------------------------------------------------------------------------------------------------------------------------------------------------------------
----ooo--------------------------oo-------------------------ooo-------------------------oo--------------------------oo--------------------------oo--------------------------ooo-------------------------oo--------------------------oo--------------------------oo--------------------------oo--------------------------oo--------------------------oo--------------------------oo--------------------------oo--------------------------oo--------------------------ooo-------------------------oo--------------------------oo--------------------------oo--------------------------oo--------------------------oo--------------------------ooo-------------------------oo--------------------------oo--------------------------oo--------------------------ooo-------------------------oo--------------------------oooS------------------------ooo-------------------------ooo-------------------------o--S--------------------S---oSSSSSSSSS------------------ooo-------------------------ooo-------------------------oo--------------------------ooo-------------------------oo--------------------------ooo-------------------------oooS--------------------SSSSSSSSSSSSSSSSSSS-------------------------------------------------------------------------------------------------ooo-------------------------ooo-------------------------ooo-------------------------ooo-------------------------oo--------------------------oo----------------------
----XXXX------------------------XXXX-----------------------XXXXX----------------------XXXXXX-----------------------XXXX------------------------XXXX------------------------XXXXX----------------------XXXXXX-----------------------XXXXX-----------------------XXXX------------------------XXXX-----------------------XXXXXX----------------------XXXXX------------------------XXXX------------------------XXXXX-----------------------XXXXX-----------------------XXXXX-----------------------XXXX------------------------XXXX-----------------------XXXXXX-----------------------XXXX------------------------XXXX------------------------XXXXX----------------------XXXXXX-----------------------XXXXX------------------------XXX------------------------XXXXX-----------------------XXXXX------------------------XXXX-----------------------XXXXX------------------------XXXX-----------------------XXXX-------------------------XXX-------------------------XXXX-----------------------XXXXX-----------------------XXXX------------------------XXXXX-----------------------XXXX-------------------------XXXX-----------------------XXXXX----------------------------------------------------------------------------------------------------------------------------------------XXXX-----------------------XXXXX-----------------------XXXXX----------------------XXXXXX-----------------------XXXXX-----------------------XXXX---------------------
--------------------------------------------------------------------------------------------------------------------------------------------------------------------------------------------------------------------------------------------------------------------------------------------------------------------------------------------------------------------------------------------------------------------------------------------------------------------------------------------------------------------------------------------------------------------------------------------------------------------------------------------------------------------------------------------------------------------------------------------------------------------------------------------------------------------------------------------------------------------------------------------------------------------------------------------------------------------------------------------------------------------------------------------------------------------------------------------------------------------------------------------------------------------------------------------------------------------------------------------------------------------------------------------------------------------------------------------------------------------------------------------------------------------------------------------------------
---------------------SSSSSSS---------------------SSSSSSS------------o--------SSSSSSS---------oooo----E------SSSS---------oo-o----E------SSSS------------------------SSSS----------ooooo---------SSS----------oooo----E------SSSS------------------------SSSS------------o-----------SSS----------oooo----E------SSS------------oo----E------SSSS---------oooo----E------SSSS-------------------------SSS------------o-----------SSSS------------o-----------SSSS------------------------SSSS---------o--o----E------SSSS---------oooo-----------SSSS-----------------E------SSSS---------oooo----E------SSSS------------------------SSSS------------o-----------SSSS-----------------E------SSSS------------o-----------SSSS---------oooo------------SSS------------o-----------SSSS------------o-----------SSSS------------o-E---------SSSS------------o-----------SSSS------------------------SSSS------------o------------SSS---------o--o------------SSS--------------E---------SSSS------------o-----------SSSS------------------------SSSS------------------------SSSS---------o--o-----------SSSS------------------------SSSS------------o-----------SSSS------------oo------------QQ-------QQQQQ-Q-----------------------QQ------------------------------------------SSS---------------------SSSSSSS-----------------------SSSSS------------o-----------SSSS------------o-----------SSSS----------oooo----------SSSS---------o--o----E------SSSS
--------------------------------------------------------------------------------------------------------o---------------------------o-----------------------------------------------------------------------------------o---------------------------------------------------------------------------------------------------------------o---------------------------o-------------------------------------------------------------------------------------------------------------------------------------------o-------------------------------------------------------oo--------------------------------------------------------------------------------------------------------------o--------------------------------------------------------------------------------------------------------------------------------------------------------------------------------------------------------------------------------------------------------------------------------<>---------------------------------------------------------------------------------------------------------------------------------------------------------------------------------------------------------------------------------------------------------------------------------------------------------------------------------------------------------------------------------------------------------------------------------------------------------------------o-------
--------------------------------------------------------------------------------------------S-------------------------S-SS------------------o-----S-S---------------------------SS-SSS--------------o-------SS----------------------------------------------------------------------------------S-----------------------------------------------o-------S-------------------------------------------------------S----------------------------S------------------------------------------------------S---------------------------SS------------------------------------------------------SS--------------------------S-----------------------------------------------------------------------------------S----------------------E--S-SSS-------------------------SS--------------------------SS--------------------------SS----------------------------------------------------------------------------------SS--------------------SS--S-SS---------------------o----SS---[]-------------------------------------------------S--------------------------------------------------S--S-SS------------------------------------------------------SS------------------------------------------------------------------------------------------------------------------------------------------------------------------------------------------------------------------------------S---------------------------SS--------------------------S-------------------
--E--o------------E---------------------------E---------------------------E----------------oS---------E---------------SoS---------E---------------SoS---------E---------------SoS---------E---------------SoS---------E---------------------------E---------------------------E---------------SoS---------E---------------------------E---------------SoS---------E---------------------------E--o--------------S---------E-----------------S---------E---------------------------E---------------SoS---------E---------------SoS---------E---------------------------E---------------SoS---------E---------------SoS---------E---------------------------E---------------------------E-----------------S---------E-----------S---SoS---------E--o------------SoS---------E--o--------------S---------E---------------SoS---------E--o------------------------E---------------------------E---------------SoS---------E--o-------oSS--SoS---------E--o-------------oS----]----E---------------------------E-----------------S---------E--o------------------------E---------------SoS---------E--o------------------------E-----------------S---------E---------------------SS----E-------------------------------------------------------E--ooo----------------------E---------------------------E---------------------------E---------------------------E----------------oS---------E--o------------SoS---------E---------------SoS---------E---------
-<>--------------<>-----E-?S--E--------------<>-----ESSS-----------------<>-----ES?S-------SS----XX--<>------E?XXXS---SSS----XX--<>------E?SXXS---SSS----XX--<>------E?S-------SS--------<>---X--S?SXXS---SSS----XX--<>------E?S-----------------<>------E?S-----------------<>------E?XXXS---SSS--------<>------EXX--------------X--<>-X----E?XXXS---SSS----XX--<>-XX---EXX--S--------------<>-----E--S-------S---------<>------E?S--S--------------<>------E?S-----------------<>------E?S--S----SS--------<>------E?-XXS---SSS--------<>------E?S--------------X--<>------E?S--S---SSS--------<>------E?SXSS---SSS--------<>------E?S-----------------<>------E?S-----------------<>------E?S-----------------<>------E?S-SS---SSS--------<>------E?S------SSS--------<>------E?S-----------------<>------E?S-------SS--------<>------E?S-----------------<>------E?S-----------------<>------S?S-SS---SSS--------<>------E?SSSSS--SSS--------<>------E?S-SS----SS--------<>------S?S-----------------<>------E?S-SS----SS--------<>------E?S-----------------<>------S?SSSS---SSS--------<>------E?S-----------------<>------E?S-----------------<>------E?S-----------------<>------E?Sooo---QQQQQQQQ--Q-------------o----QQQQ---Q--<>--------------------------<>-----E--------------------<>-----ES?S-----------------<>------E?S-----------------<>------E?S-------SS--------<>------E?S-------SS--------<>------E?SXXS----SS--------<>------E?X
-[]--------------[]----<>----<>--------------[]--------------------------[]----<>------o-------------[]------------o-------------[]--------------------------[]--------------------------[]------------o-------------[]--------------------------[]------------o-------------[]------------o-------------[]------------o-------------[]------------o-------------[]--------------------------[]----<>--------------------[]--------------------------[]--------------------------[]------------o-------------[]------------o-------------[]------------o-------------[]------------o-------------[]------------o-------------[]-----E--------------------[]------------o-------------[]--------------------------[]------------o-------------[]--------------------------[]------------o-------------[]--------------------------[]--------------------------[]--------------------------[]------------o-------------[]--------------------------[]--------------------------[]--------------------------[]--------------------------[]--------------------------[]--------------------------[]--------------------------[]--------------------------[]--------------------------[]------------------------------------------------------[]----------<>--------------[]--------------------------[]----<>--------------------[]--------------------------[]--------------------------[]-----------oo-------------[]------------o-------------[]---------
-[]--------------[]----[]----[]--------------[]------------XXXX----------[]----[]-----XXXXX----------[]-----------XXXXX----------[]-----------XXXXX----------[]-----------XXXXXX---------[]-----------XXXXXX---------[]-----------XXXXX----------[]-----------XXXX-----------[]-----------XXXXX----------[]-----------XXXXX----------[]-----------XXXXX----------[]------------XXX-----------[]----[]-----XXXX-----------[]-----------XXXXX----------[]-------------X------------[]-----------XXXXX----------[]-----------XXXXX----------[]-----------XXXXX----------[]-----------XXXXX----------[]-----------XXXXX----------[]------------XXXX----------[]-----------XXXXX----------[]-----------XXXX-----------[]-----------XXXXX----------[]-----------XXXX-----------[]-----------XXXX-----------[]-----------XXXX-----------[]------------XXXX----------[]--------------------------[]-----------XXXX-----------[]-----------XXXX-----------[]------------XXXX----------[]------------XXXX----------[]-----------XXXX-----------[]------------XXX-----------[]-----------XXXX-----------[]--------------------------[]------------XX------------[]--------------------------[]------------------------------------------------------[]----------[]--------------[]---<>---------------------[]----[]--------------------[]------------XXXX----------[]-----------XXXXX----------[]-----------XXXXX----------[]-----------XXXXX----------[]---------
-[]--------E--E--[]-E--[]----[]--------E--E--[]-E---------------------E--[]----[]--------------------[]--------------------------[]--------------------------[]--------------------------[]--------------------------[]------------------E-------[]--------------------------[]--------------------------[]--------------------------[]--------------------------[]--------------------E-----[]----[]------------E-------[]--------------------------[]--------------------------[]--------------------------[]--------------------------[]-----------------------E--[]--------------------------[]------------------E-------[]--------------------E-----[]-----------------------E--[]--------------------------[]--------------------------[]--------------------------[]--------------------------[]--------------------E-----[]--------------------------[]--------------------E-----[]--------------------------[]------------------E-------[]--------------------------[]--------------------------[]------------------E----E--[]------------------E-------[]--------------------------[]--------------------E-----[]--------------------------[]--------------------------[]-----------------------E--E-----E--E------------E-EE--[]----------[]--E------E-EE-[]---[]------------------E--[]----[]-----------------E--[]--------------------E-----[]--------------------------[]-----------------------E--[]--------------------------[]---------
-XXXXXXXXXXXXXXXXXXXXXXXXXXX-XXXXXXXXXXXXXXXXXXXXXXXXXXX----------XXXXXXXXXXXXXXXXXX----------XXXXXXXXXXXXXXXXXX----------XXXXXXXXXXXXXXXXXX----------XXXXXXXXXXXXXXXXXX-----------XXXXXXXXXXXXXXXXX----------XXXXXXXXXXXXXXXXXXX--------XXXXXXXXXXXXXXXXXXX----------XXXXXXXXXXXXXXXXXX----------XXXXXXXXXXXXXXXXXX----------XXXXXXXXXXXXXXXXXX-----------XXX-XXXXXXXXXXXXXX------XXXXXXXXXXXXXXXXXXXXX---------XXXXXXXXXXXXXXXXXXX----------XXXXXXXXXXXXXXXXXXXX-------XXXXXXXXXXXXXXXXXXX----------XXXXXXXXXXXXXXXXXX----------XXXXXXXXXXXXXXXXXX----------XXXXXXXXXXXXXXXXXX----------XXXXXXXXXXXXXXXXXX----------XXXXXXXXXXXXXXXXXXX--------XXXXXXXXXXXXXXXXXXX----------XXXXXXXXXXXXXXXXXX----------XXXXXXXXXXXXXXXXXX----------XXXXXXXXXXXXXXXXXX---------XXXXXXXXXXXXXXXXXXX----------XXXXXXXXXXXXXXXXXXX--------XXXXXXXXXXXXXXXXXXX----------XXXXXXXXXXXXXXXXXXXX-------XXXXXXXXXXXXXXXXXXX----------XXXXXXXXXXXXXXXXXX---------XXXXXXXXXXXXXXXXXXXX---------XXXXXXXXXXXXXXXXXXX---------XXXXXXXXXXXXXXXXXX---------XXXXXXXXXXXXXXXXXXXXX-------XXXXXXXXXXXXXXXXXXX----------XXXXXXXXXXXXXXXXXXXXX-----XXXXXXXXXXXXXXXXXXXX---------XXXXXXXXXXXXXXXXXXXXX-------XXXXXXXXXXXXXXXXXXXXXXXXXXXXXXXXXXXXXXXXXXXXXXXXXXXXXXXXXXXXXXXXXXXXXXXXXXX-XXXXXXXXXXXXXXXXXXXXXXXXXXXXXX------XXXXXXXXXXXXXXXXXXXXX-------XXXXXXXXXXXXXXXXXXXXX-------XXXXXXXXXXXXXXXXXXX----------XXXXXXXXXXXXXXXXXX----------XXXXXXXXXXXXXXXXXX----------XXXXXXXXXXXXXXXXXX
