--------------------------------------------------------------------------------------------------------------------------------------------------------------------------------------------------------------------------------------------------------------------------------------------------------------------------------------------------------------------------------------------------------------------------------------------------------------------------------------------------------------------------------------------------------------------------------------------------------------------------------------------------------------------------------------------------------------------------------------------------------------------------------------------------------------------------------------------------------------------------------------------------------------------------------------------------------------------------------------------------------------------------------------------------------------------------------------------------------------------------------------------------------------------------------------------------------------------------------------------------------------------------------------------------------------------------------------------------------------------------------------------------------------------------------------------------------
--------------------------------------------------------------------------------------------------------------------------------------------------------------------------------------------------------------------------------------------------------------------------------------------------------------------------------------------------------------------------------------------------------------------------------------------------------------------------------------------------------------------------------------------------------------------------------------------------------------------------------------------------------------------------------------------------------------------------------------------------------------------------------------------------------------------------------------------------------------------------------------------------------------------------------------------------------------------------------------------------------------------------------------------------------------------------------------------------------------------------------------------------------------------------------------------------------------------------------------------------------------------------------------------------------------------------------------------------------------------------------------------------------------------------------------------------------
--------------------------------ooo-------------------------ooo-------------------------ooo-------------------------ooo---------------------SSSSSSSSSSSSSSSSSSSS------------ooo-------------------------oo--------------------------oo--------------------------oo----------------------S-S-oSSSSSSSSSS-----------------ooo---------------------SSS-SSSSSSSSSSSS--------------o-oSSS-SSSSSS-----------------ooSS--SSSS------------------ooo-------------------------oo--------------------------oo--------------------------oo--------------------------oo--------------------------ooo-------------------------oooS------------------------ooo-------------------------ooo-------------------------ooo-------------------------oo--------------------------oo--------------------------oo--------------------------oo--------------------------oo--------------------------ooo-------------------------oo--------------------------oo--------------------------ooo-------------------------oo--------------------------oo----------------------SSSSSSSSSSSSSSSS----------------oooS-----S------------------oo--------------------------oo--------------------------oo--------------------------oo--------------------------oo--------------------------oo----------------------SSSSSSSSSSSSSS------------------oooS------------------------ooSS--SSS---------------------------------------------------------------------------------------------------
--------------------------------XXXX------------------------XXXX-----------------------XXXXX-----------------------XXXXX----------------------------------------------------XXXX-----------------------XXXXX-----------------------XXXX------------------------XXXXX------------------------XXXX-----------------------XXXXX------------------------XXX-------------------------XXXX-----------------------XXXXX----------------------XXXXXX-----------------------XXXX------------------------XXXX------------------------XXXX------------------------XXXX------------------------XXXXX-----------------------XXXXX-----------------------XXXXX-----------------------XXXXX-----------------------XXXXX----------------------XXXXXX-----------------------XXXX------------------------XXXX------------------------XXXXX-----------------------XXXX------------------------XXXXX-----------------------XXXX------------------------XXXXX-----------------------XXXXX-----------------------XXXX------------------------XXXXX----------------------------------------------------XXXX-----------------------XXXXX-----------------------XXXXX-----------------------XXXXX-----------------------XXXX------------------------XXXXX-----------------------XXXXX----------------------------------------------------XXXX-----------------------XXXXX--------------------------------------------------------------------------------------------------------
--------------------------------------------------------------------------------------------------------------------------------------------------------------------------------------------------------------------------------------------------------------------------------------------------------------------------------------------------------------------------------------------------------------------------------------------------------------------------------------------------------------------------------------------------------------------------------------------------------------------------------------------------------------------------------------------------------------------------------------------------------------------------------------------------------------------------------------------------------------------------------------------------------------------------------------------------------------------------------------------------------------------------------------------------------------------------------------------------------------------------------------------------------------------------------------------------------------------------------------------------------------------------------------------------------------------------------------------------------------------------------------------------------------------------------------------------------
-----------------------SSSSS----------------------SSSSSS----------------------SSSSSS---------------------SSSSSSS------------o-----------SSSS------------o------------SQS------------------------SSSS-----------oo-----------SSSS---------oo-------------SSSS------------------------SSSS-------------------------SSS------------------------SSSS------------o------------SSS-------------------------SSS-----------ooo-----------SSS------------o-----------SSSS---------o--o-----------SSSS-----------------E------SSSS---------oooo----E------SSSS---------oooo----E------SSSS------------------------SSSS------------------------SSSS------------o-----------SSSS------------o-----------SSSS-----------ooo----------SSSS------------o-----------SSSS---o-----o--------------SSSS---------oooo----E------SSSS------------o-----------SSSS---o-----oo-------------SSSS------------o-E---------SSSS---------ooooo-----------SS-------------------------SSSS------------o-----------SSSS---------oooo----E------SSSS------------------------SSSS------------o------------SSS------------o-E----------SQQ-----------oo-----------SSSS------------o----E------SSSS------------------------SSQS---------oooo-----------SSSS------------------------SSQS------------o----------SSSSS------------o------------SSS------------o-----------SSSS-----------ooo----------SSSS-------------------------SSQ-QQQ-----QQQ------------------------QQQ-----------------
----------------------------------------------------------------------------------------------------------------------------------------------------------------------------------------------------------------------------------------------------o-----------------------------------------------------------------------------------------------------------------------------------------------------------------------------------------------------------------------------------------------------------o---------------------------o---------------------------o-----------------------------------------------------------------------------------------------------------------------------------------------------------------------------------------------------------------------------------------------------------------------------------------------------------------------------------------------------------------------------------------------------------------------------------o-------------------------------------------------------------------------------------------------------------------------------------------o-----------------------------------------------------------------------------------------------------------------------------------------------------------------------------------------------------------------------------------------------------------------------------------------------
------------------------------------------------------------------------------------------------------------------------SS---------------------E----SS------------------------------------------------------SS------------------------S-SS--------------------------SS------------------------------------------------------S----------------------E----SS---------------------E---------------------------E----SS------------------------------------------------------SS--------------------------S---------------------------SS--------------------------S----------------------o------------------------------------------------------------SS------------------------------------------------------SS------------------------------------------------SS--S-SS------------------------S-SSS-------------------------S---------------------SS--S-SS---------------------o------------------------------S-SSSS-S--------------------------------------------------SS--------------------------S----------------------o--------------------------------SS---------------------o--------------------------------SS--------------------------S--------------------------------------------------S--S-SSS-----------------------------------------------------S----------------------S--S-SS------------------------------------------------------SS------------------------------------------------------------------------------------------------------
------------------E---------------------------E-----------E---------------E---------------------------E----------------oS---------E---------------SoS---------E--o------------------------E---------------SoS---------E----------o-S--SoS---------E---------------SoS---------E---------------------------E--o--------------S---------E---------------SoS---------E--o------------------------E--o------------SoS---------E--o------------------------E---------------SoS---------E---------------SoS---------E---------------SoS---------E---------------SoS---------E---------------------------E---------------------------E---------------SoS---------E--o------------------------E---------------S-S---------E---------------------------E----------oSS--SoS---------E--o------------SoS---------E----------------oS---------E----------oSS--SoS---------E--o--------------S---------E---------------SoS---Q-----E---------------------------E---------------SoS---------E---------------SoS---------E---------------------------E---------------SoS---------E--o------------------------E--o------------SoS---------E---------------SoS---------E---------------------------E-----------S---SoS---------E--o------------------------E--o-------------oS---------E----------oSS--SoS---------E--o------------------------E--o--------------S---------E---------------------------E-----------------------------------------------------------------
-----------------<>-----E--------------------<>-----ES?S-<>--------------<>-----E--------------------<>------E?S--S----SS--------<>------E?S------SSS---S----<>------S?S-----------------<>------E?S-------SS--------<>------E?SXXS---SSS--------<>------E?X--S---SSS--------<>------E?S-----------------<>------E?S-------SS--------<>------E?S-SS---SSS--------<>------E?S--S--------------<>------E?S-SS---SSS--------<>------E?S-----------------<>------S?S--S---SSS--------<>------E?SXXS---SSS--------<>------E?X------SSS--------<>------E?SXXS---SSS----XX--<>------E?S-----------------<>------E?S-----------------<>------E?S------SSS--------<>------E?S-----------------<>------E?S-------SS--------<>------E?S-----------------<>------E?SSSS---SSS--------<>------E?SXSS---SSS--------<>------E?XX------SS--------<>------E?SXXSS--SSS--------<>------E?S-----------------<>------E?S-SS---SSS--------<>------S?S-----------------<>-----E--S------SSS--------<>------E?SXXS---SSS----XX--<>------E?X--S--------------<>------E?S--S---SSS--------<>------E?S-----------------<>------E?S-------SS--------<>------E?SXXS----SS----XX--<>------E?S-----------------<>------E?SSSS---SSS--------<>------E?S-----------------<>------E?XXXS----SS--------<>------E?SSSS---SSS--------<>------E?S-----------------<>------E?S-----------------<>------E?S-----------------<>-------?S-Qo--E-QQQQQ-QQ---------------Q---QQQQQ---------<>-----Q
-----------------[]----<>--------------------[]----<>----[]--------------[]----<>--------------------[]--------------------------[]--------------------------[]--------------------------[]------------o-------------[]------------o-------------[]--------------------------[]--------------------------[]--------------------------[]--------------------------[]--------------------------[]--------------------------[]--------------------------[]------------o-------------[]------------o-------------[]------------o-------------[]------------o-------------[]--------------------------[]--------------------------[]--------------------------[]--------------------------[]------------o-------------[]------------o-------------[]--------------------------[]------------o-------------[]------------o-------------[]--------------------------[]--------------------------[]-----------oo-------------[]--------------------------[]----<>--------------------[]------------o-------------[]--------------------------[]--------------------------[]--------------------------[]------------o-------------[]------------o-------------[]--------------------------[]------------o-------------[]--------------------------[]--------------------------[]-----E--------------------[]--------------------------[]--------------------------[]--------------------------[]---------------------------------------------------------[]------
----<>-----------[]----[]--------------------[]----[]----[]--------------[]----[]--------------------[]-----------XXXX-----------[]-----------XXXX-----------[]------------XXXX----------[]-----------XXXXXX---------[]-----------XXXXX----------[]----SS-----XXXXX----------[]--------------------------[]-----------XXXXX----------[]------------X-------------[]--------------------------[]-----------XXXX-----------[]------------XXXXX---------[]-----------XXXXX----------[]-----------XXXXX----------[]-----------XXXX-----------[]-----------XXXXX----------[]------------XXXX----------[]------------XX------------[]-----------XXXX-----------[]------------XXX-----------[]-----------XXXXX----------[]-----------XXXXX----------[]-----------XXXXX----------[]-----------XXXXX----------[]-----------XXXXX----------[]-----------XXXXX----------[]------------XXXX----------[]-----------XXXX-----------[]-------------X------------[]----[]-----XXXXX----------[]-----------XXXXX----------[]------------XXX-----------[]-----------XXXX-----------[]------------XX------------[]-----------XXXXX----------[]-----------XXXXX----------[]-----------XXXXX----------[]----<>-----XXXXX----------[]-----------XXXX-----------[]-----------XXXXX----------[]-----------XXXX-----------[]------------XXX-----------[]------------XX------------[]--------------------------[]---------------------------------------------------------[]------
----[]---EEE--E--[]----[]--------------E--E--[]----[]----[]-------EE-EE--[]----[]--------------E--E--[]--------------------------[]--------------------------[]--------------------E-----[]--------------------------[]------------------E-------[]------------------E-------[]--------------------------[]------------------E-------[]--------------------E-----[]------------------E-E-----[]--------------------------[]-----------------------E--[]--------------------------[]--------------------------[]--------------------------[]--------------------------[]-----------------------E--[]--------------------------[]--------------------------[]--------------------------[]--------------------------[]-----------------------E--[]--------------------------[]--------------------------[]--------------------------[]--------------------------[]--------------------E-----[]--------------------------[]-----------------------E--[]----[]--------------------[]--------------------------[]------------------E-E-----[]------------------E-------[]--------------------------[]--------------------------[]--------------------------[]-----------------------E--[]----[]------------E-------[]------------------E----E--[]-----------------------E--[]------------------E-------[]--------------------------[]--------------------------[]--------------------E-E---[]---------------------E-E--------E---------------E--EE----[]------
XXXXXXXXXXXXXXXXXXXXXXXXXXXXXXX-----XXXXXXXXXXXXXXXXXXXX-XXXXXXXXXXXXXXXXXXXXXXXXXXXXXX------XXXXXXXXXXXXXXXXXXX---------XXXXXXXXXXXXXXXXXXX---------XXXXXXXXXXXXXXXXXXXXX-------XXXXXXXXXXXXXXXXXXX----------XXXXXXXXXXXXXXXXXX----------XXXXXXXXXXXXXXXXXX----------XXXXXXXXXXXXXXXXXXXX-------XXXXXXXXXXXXXXXXXXX----------XXXXXXXXXXXXXXXXXX---------XXXXXXXXXXXXXXXXXXXXX-----XXXXXXXXXXXXXXXXXXXXX----------XXXXXXXXXXXXXXXXXX----------XXXXXXXXXXXXXXXXXX----------XXXXXXXXXXXXXXXXXX----------XXXXXXXXXXXXXXXXXX----------XXXXXXXXXXXXXXXXXX----------XXXXXXXXXXXXXXXXXXX---------XXXXXXXXXXXXXXXXXXX--------XXXXXXXXXXXXXXXXXXX----------XXXXXXXXXXXXXXXXXX---------XXXXXXXXXXXXXXXXXXX----------XXXXXXXXXXXXXXXXXX----------XXXXXXXXXXXXXXXXXX----------XXXXXXXXXXXXXXXXXX----------XXXXXXXXXXXXXXXXXX----------XXXXXXXXXXXXXXXXXX----------XXXXXXXXXXXXXXXXXXX--------XXXXXXXXXXXXXXXXXXX----------XXXXXXXXXXXXXXXXXX---------XXXXXXXXXXXXXXXXXXX----------XXXXXXXXXXXXXXXXXX----------XXXXXXXXXXXXXXXXXXXX-------XXXXXXXXXXXXXXXXXXX---------XXXXXXXXXXXXXXXXXXXX--------XXXXXXXXXXXXXXXXXXX----------XXXXXXXXXXXXXXXXXX----------XXXXXXXXXXXXXXXXXXX--------XXXXXXXXXXXXXXXXXXX----------XXXXXXXXXXXXXXXXXXX-------XXXXXXXXXXXXXXXXXXXX----------XXXXXXXXXXXXXXXXXX---------XXXXXXXXXXXXXXXXXXXX--------XXXXXXXXXXXXXXXXXXX---------XXXXXXXXXXXXXXXXXXXXXX------XXXXXXXXXXXXXXXXXXXXXXXXXXXXXXXXXXXXXXXXXXXXXXXXXXXXXXXXXXXXXXXXXXXXXXXXXXX
