--------------------------------------------------------------------------------------------------------------------------------------------------------------------------------------------------------------------------------------------------------------------------------------------------------------------------------------------------------------------------------------------------------------------------------------------------------------------------------------------------------------------------------------------------------------------------------------------------------------------------------------------------------------------------------------------------------------------------------------------------------------------------------------------------------------------------------------------------------------------------------------------------------------------------------------------------------------------------------------------------------------------------------------------------------------------------------------------------------------------------------------------------------------------------------------------------------------------------------------------------------------------------------------------------------------------------------------------------------------------------------------------------------------------------------------------------------
--------------------------------------------------------------------------------------------------------------------------------------------------------------------------------------------------------------------------------------------------------------------------------------------------------------------------------------------------------------------------------------------------------------------------------------------------------------------------------------------------------------------------------------------------------------------------------------------------------------------------------------------------------------------------------------------------------------------------------------------------------------------------------------------------------------------------------------------------------------------------------------------------------------------------------------------------------------------------------------------------------------------------------------------------------------------------------------------------------------------------------------------------------------------------------------------------------------------------------------------------------------------------------------------------------------------------------------------------------------------------------------------------------------------------------------------------------
---------------------------------oo-------------------------ooo-------------------------oo--------------------------oo--------------------------ooo-------------------------oSSSSSSSSS------------------oo--------------------------oo--------------------------oo--------------------------oo--------------------------oo--------------------------oo--------------------------oo--------------------------oo-S------------------------oo--------------------------oooS------------------------ooo-------------------------ooo-------------------------oo--------------------------oo--------------------------ooo-------------------------oo----------------------SSS-SSSSSSSSSSSSS-----------SSSSSSSSSSSSSSSSSSSSSSSSSSSS----oooS--SSSS------------------ooo-------------------------ooo-------------------------ooo----------------------SS-SSoS-SSSSSSS------------------------------------------------------------------------oo--------------------------ooo-------------------------ooo-------------------------ooo-------------------------oo--------------------------oo--------------------------oo----------------------SSSSSSSSSSSSSS------------------oo--------------------------oo--------------------------oo--------------------------oo--------------------------oo--------------------------oo--------------------------oo--------------------------oo--------------------------oo--------------------------ooo---------------------
--------------------------------XXXX-----------------------XXXXX-------------------E--XXXXXX-----------------------XXXX------------------------XXXXX-----------------------XXXX-----------------------XXXXXX-------------------E---XXXX------------------------XXXX------------------------XXXX------------------------XXXXX-----------------------XXXX------------------------XXXXX-----------------------XXXX------------------------XXXX------------------------XXXXX-----------------------XXXXX-----------------------XXXXX----------------------XXXXXX-----------------------XXXX------------------------XXXXX-----------------------XXXXX------------------------XXX-----------------------------------------------------XXXX------------------------XXXX----------------------XXXXXX-----------------------XXXXX------------------------XXXX-------------------------------------------------------------------------------XXXX------------------------XXXXX------------------------XXXX-----------------------XXXXX-----------------------XXXXX-------------------E--XXXXXX-----------------------XXXX----------------------------------------------------XXXX------------------------XXXX-----------------------XXXXXX-----------------------XXXXX-----------------------XXXX------------------------XXXXX-----------------------XXXX------------------------XXXX------------------------XXXXX-----------------------XXXXX--------------------
------------------------------------------------------------------------------------------------------------------------------------------------------------------------------------------------------------------------------------------------------------------------------------------------------------------------------------------------------------------------------------------------------------------------------------------------------------------------------------------------------------------------------------------------------------------------------------------------------------------------------------------------------------------------------------------------------------------------------------------------------------------------------------------------------------------------------------------------------------------------------------------------------------------------------------------------------------------------------------------------------------------------------------------------------------------------------------------------------------------------------------SS------------------------------------------------------------------------------------------------------------------------------------------------------------------------------------------------------------------------------------------------------------------------------------------------------------------
-----------------------SSSSS----------------------SSSSSS---------------------SSSSSSS------------------------SSSS------------------------SSSS-----------oo-----------SSSS------------o------------SSS-----------oo-----------SSSS------------------------SSSS---------o--o----E------SSSS---------o--o------------SQ-------------------------SSSS---------oooo----E------SSS?------------o-----------SSSS------------o-----------SSSS---------oooo-----------SSSS------------------------SSSS------------o-----------SSSS------------oo----------SSSS------------o-----------SSSS------------------------SSSS-----------oooo---------SSSS------------o-----------SSSS------------o------------SSS-------------------------SSS------------o-----------SSSS------------------------SSSS------------o-----------SSSS------------------------SSSS-------------------------SSS---Q---------------------------------QQ-----------------------------------------SSS------------------------SSSSS---------------------SSSSSSS------------oo----------SSSQ-----------------------SSSSS------------o-----------SSSS---------E--------------SSSS---o--S--oooo-E-----------S-----o----oooo----E------SSS----------oooo----E------SSSS----------ooo----E------SSSS-----------oo-----------SSSS---------oo-o-----------SSSS------------o-----------SSSS---------oooo----E-------SS----------oooo----E------SSSS------------o-----------SSSS------------------------SSSS
--------------------------------------------------------------------------------------------------------o---------------------------------------------------------------------------------------------------------------o---------------------------o---------------------------o-----------------------------------------------------------------------------------o---------------------------------------------------------------------------------------------------------------------------------------------------------------------------------------------------------------------------------------------------------------------------------------------------------------------------------------------------------------------------------------------------------------------------------------------------------------------------------------------------------------------------------------------------------------------------------------------------------------------------------------------------------------------------------------------------------------------------------------------------------------------S------<>-------------------------------------------------------------o---------------------------------------------------------------------------------------------------------------------------------------------------------------------------------------------------------------------------------------
--------------------------------------------------------------------------------------------S---------------------------S--------------------------------------------------E----SS------------------------------------------------------S---------------------------S-------------------------S-SS--------------------------S---------------------------SS--------------------------S----------------------E----SS------------------------S-SSS--------------------E----SS--------------------------------------------------------------------------------------------------------------S----------------------------S-SSS----------------------S----------------------E--S-SS---------------------o---------------------------o-----S-----------------------------------------------------------------------------o----S-----------------------------------------------------------------------------------------------------------------------------------------------------------------------------------------------------------------------------------------------------------S---------------------------S---------------------SS--S-SSS--[]-------------o-----S-SS------------------------S-SS--------------------------SS--------------------------SS--------------------------SS--------------------------S---------------------------SSS-------------------------SSS-------------------------SS--------------------------S-------------------
------------------E-----E--o--E---------------E---------------------------E---------------SoS---------E---------------SoS---------E--o------------------------E---------------SoS---------E--o------------------------E---------------SoS---------E---------------SoS---------E---------------SoS---------E--o------------SoS---------E---------------SoS---------E----------------oS---------E---------------SoS---------E--o------------SoS---------E----------------oS---------E--o------------------------E---------------------------E---------------------------E---------------SoS---------E-----------------S---Q-----E---------------SoS---------E-----------S---SoS---------E--o------------------------E--o--------------S---------E---------------------------E---------------------------E-----------------S---------E--o------------------------E-----------------------------------------------------------oo----------------------E---------------------------E---------------------------E---------------------------E---------------------------E-----------------S---------E---------------SoS---------E----------oSS--SoS----[]---E--o------------SoS---------E---------------SoS---------E---------------SoS---------E---------------SoS---------E---------------SoS---------E---------------SoS---------E---------------SoS---------E---------------SoS---------E---------------SoS---------E---------------SoS---------E---------
-----------------<>----<>----<>--------------<>-----E--------------------<>-XXX--E?---S---SSS--------<>-----E??SX-S----SS--------<>------E?S-----------------<>------E?S-SS---SSS--------<>------E?S-----------------<>------E?SSSS---SSS--------<>-----E--SXXS---SSS--------<>------E?XXX-----SS--------<>------E?X--S----SS--------<>-----EE?S-------SS--------<>------E?S-------SS--------<>------E?S-SS---SSS--------<>------E?SXXS---SSS--------<>------E?S-SS----SS--------<>------E?S-----------------<>------E?S-----------------<>------E?S-----------------<>------E?S--S----SS--------<>-----EE?S-----------------<>------E?S-------SS--------<>------E?S-SS---SSS--------<>------E?S-----------------<>------E?S-----------------<>------E?S-----------------<>-----E--S-----------------<>------E?S--S--------------<>------E?S-----------------<>------E?SQQQQQQ-----------E-----------QQ--QQQQQQ----------------------------------<>-XS-----------------------<>-----E??S-----------------<>--S----SS-----------------<>--S---S?S-----------------<>------E?S-----------------<>------E?XXSS---SSS--------<>------E?SSSS---SSS--------<>------S?SXXS---SSS----XX--<>------EXXXXS---SSS----XX--<>------E?X-------SS--------<>------E?S-------SS--------<>------E?SXXS---SSS--------<>------E?S-------SS--------<>------E?S-SS---SSS--------<>------E?SX-----SSS--------<>------E?XXXS---SSS--------<>------E?S--S----SS--------<>------E?S
-----------------[]----[]----[]--------------[]----<>--------------------[]------------o-------------[]----<>------o-------------[]--------------------------[]--------------------------[]--------------------------[]--------------------------[]----<>------o-------------[]------------o-------------[]--------------------------[]----<>-----oo-------------[]--------------------------[]-----E--------------------[]-----E------o-------------[]--------------------------[]--------------------------[]--------------------------[]------------o-------------[]------------o-------------[]----<>--------------------[]------------o-------------[]--------------------------[]--------------------------[]--------------------------[]--------------------------[]----<>--------------------[]--------------------------[]--------------------------[]-------------------------<>-------------------------------------------------------[]--------------------------[]----<>--------XXX-?-------[]-------X------------------[]--------------------------[]------------o-------------[]------------o-------------[]------------o-------------[]------------o-------------[]------------o-------------[]------------o-------------[]------------o-------------[]------------o-------------[]------------o-------------[]------------o-------------[]-----------oo-------------[]--------------------------[]--------------------------[]---------
-----------------[]----[]----[]--------------[]----[]-------XXXX---------[]-----------XXXXX----------[]----[]-----XXXXX----------[]-----------XXXXXX---------[]------------XX------------[]-----------XXXXX----------[]-----------XXXXX----------[]----[]-----XXXXX----------[]-----------XXXXXX---------[]-----------XXXXX----------[]----[]-----XXXXX----------[]-----------XXXXX----------[]-----------XXXX-----------[]-----------XXXXX----------[]------------XXX-----------[]------------XXX-----------[]------------XXX-----------[]-----------XXXXXX---------[]-----------XXXXX----------[]----[]-----XXXX-----------[]-----------XXXXX----------[]-----------XXXX-----------[]--------------------------[]------------XXX-----------[]--------------------------[]----[]-----XXXXXX---------[]------------XXX-----------[]--------------------------[]-------------------------[]-----------------------------------------XXXXX---------[]--------------------------[]----[]--------------------[]------------XXXXX---------[]------------XXXX----------[]-----------XXXXX----------[]-----------XXXXX----------[]-----------XXXXX----------[]-----------XXXXX----------[]-----------XXXXX----------[]-----------XXXXX----------[]-----------XXXXX----------[]-----------XXXXX----------[]-----------XXXXX----------[]-----------XXXXX----------[]-----------XXXXX----------[]-----------XXXXX----------[]----<>-----XXXXX----------[]---------
-----------E--E--[]-E--[]----[]--------E--E--[]-E--[]-E------------E-----[]------------------E----E--[]----[]------------E-------[]--------------------------[]--------------------------[]-----------------------E--[]------------------E----E--[]----[]--------------------[]--------------------------[]--------------------------[]----[]--------------------[]-----------------------E--[]--------------------------[]--------------------------[]--------------------------[]--------------------E-----[]--------------------------[]--------------------------[]------------------E-------[]----[]--------------------[]--------------------------[]--------------------------[]--------------------E-----[]--------------------E-----[]--------------------E-E---[]----[]--------------------[]------------------E-E-----[]-------------------EE-E---[]------------EE-E---E-E-E-[]----EE-E----------------EE-----------------------------[]--------------------E--E--[]----[]--------------E-EE--[]---E---XX-----------E--E--[]------------------E-E-----[]--------------------------[]--------------------------[]--------------------------[]--------------------------[]--------------------------[]--------------------------[]--------------------------[]--------------------------[]--------------------------[]--------------------------[]--------------------------[]--------------------------[]----[]--------------------[]---------
XXXXXXXXXXXXXXXXXXXXXXXXXXXX-XXXXXXXXXXXXXXXXXXXXXXXXXXXXXX-------XXXXXXXXXXXXXXXXXX----------XXXXXXXXXXXXXXXXXX---------XXXXXXXXXXXXXXXXXXX----------XXXXXXXXXXXXXXXXXX---------XXXXXXXXXXXXXXXXXXX----------XXXXXXXXXXXXXXXXXX---------XXXXXXXXXXXXXXXXXXX----------XXXXXXXXXXXXXXXXXX-----------XXXXXXXXXXXXXXXXX----------XXXXXXXXXXXXXXXXXX----------XXXXXXXXXXXXXXXXXX----------XXXXXXXXXXXXXXXXXX----------XXXXXXXXXXXXXXXXXX----------XXXXXXXXXXXXXXXXXX---------XXXXXXXXXXXXXXXXXXXX--------XXXXXXXXXXXXXXXXXXX----------XXXXXXXXXXXXXXXXXX----------XXXXXXXXXXXXXXXXXX---------XXXXXXXXXXXXXXXXXXX----------XXXXXXXXXXXXXXXXXX----------XXXXXXXXXXXXXXXXXX---------XXXXXXXXXXXXXXXXXXXXXX----XXXXXXXXXXXXXXXXXXXXXXX-------XXXXXXXXXXXXXXXXXXXXX-------XXXXXXXXXXXXXXXXXXX----------XXXXXXXXXXXXXXXXXXXX-------XXXXXXXXXXXXXXXXXXXXXX-----XXXXXXXXXXXXXXXXXXXXXXXXXXXXXXXXXXXXXXXXXXXXXXXXXXXXXXXXXXXXXXXXXXXXXXXXXXXXXX--------XXXXXXXXXXXXXXXXXXXXX-----XXXXXXXXXXXXXXXXXXXXXXX------XXXXXXXXXXXXXXXXXXXXX--------XXXXXXXXXXXXXXXXXXXX-----XXXXXXXXXXXXXXXXXXXXX----------XXXXXXXXXXXXXXXXXX----------XXXXXXXXXXXXXXXXXX----------XXXXXXXXXXXXXXXXXX-----------XXXXXXXXXXXXXXXXX----------XXXXXXXXXXXXXXXXXX----------XXXXXXXXXXXXXXXXXX----------XXXXXXXXXXXXXXXXXX----------XXXXXXXXXXXXXXXXXX----------XXXXXXXXXXXXXXXXXX----------XXXXXXXXXXXXXXXXXX-----------XXXXXXXXXXXXXXXXX----------XXXXXXXXXXXXXXXXXX----------XXXXXXXXXXXXXXXXXX
