--------------------------------------------------------------------------------------------------------------------------------------------------------------------------------------------------------------------------------------------------------------------------------------------------------------------------------------------------------------------------------------------------------------------------------------------------------------------------------------------------------------------------------------------------------------------------------------------------------------------------------------------------------------------------------------------------------------------------------------------------------------------------------------------------------------------------------------------------------------------------------------------------------------------------------------------------------------------------------------------------------------------------------------------------------------------------------------------------------------------------------------------------------------------------------------------------------------------------------------------------------------------------------------------------------------------------------------------------------------------------------------------------------------------------------------------------------
--------------------------------------------------------------------------------------------------------------------------------------------------------------------------------------------------------------------------------------------------------------------------------------------------------------------------------------------------------------------------------------------------------------------------------------------------------------------------------------------------------------------------------------------------------------------------------------------------------------------------------------------------------------------------------------------------------------------------------------------------------------------------------------------------------------------------------------------------------------------------------------------------------------------------------------------------------------------------------------------------------------------------------------------------------------------------------------------------------------------------------------------------------------------------------------------------------------------------------------------------------------------------------------------------------------------------------------------------------------------------------------------------------------------------------------------------------
--------------------------------ooo-------------------------ooo-------------------------ooo-------------------------oo--------------------------oo--------------------------ooo-------------------------ooo-------------------------ooo-------------------------oo--------------------------ooo-------------------------oooS------------------------ooo-------------------------ooo---------------------SSSSSSSSSSSSSSSS----------------oo--------------------------oo--------------------------oo--------------------------oo--------------------------ooo-------------------------oo--------------------------oo--------------------------ooo-------------------------oo--------------------------oo--------------------------ooo-------------------------oo--------------------------oo--------------------------ooo-------------------------oo--------------------------oo--------------------------oo--------------------------oSoS--SSSSSS----------------ooo-------------------------oo----------------------SSSSSSSSSSSSSSSSSSS-------------ooo-------------------------oo--------------------------oo--------------------------ooo-------------------------oo--------------------------oo----------------------SSSSSSSSSSSSSSSS----------------ooo-------------------------ooo---------------------SSSSSSSSSSSSSSSSSS--------------oSoS-SSSSSS-------------------------------------------------------------------------ooo---------------------
--------------------------------XXXX------------------------XXXX-----------------------XXXXX-----------------------XXXX------------------------XXXX-------------------------XXXX-----------------------XXXXX------------------------XXXX-----------------------XXXXX-----------------------XXXXX------------------------XXXX-----------------------XXXXX-----------------------XXXXX------------------------XXX------------------------XXXXX----------------------XXXXXX-----------------------XXXX------------------------XXXX------------------------XXXXX----------------------XXXXXX-----------------------XXXX------------------------XXXXX-----------------------XXXX-------------------------XXX------------------------XXXXX----------------------XXXXX------------------------XXXX------------------------XXXXX-----------------------XXXX------------------------XXXX------------------------XXXX-------------------------XXXX-----------------------XXXXX-----------------------XXXX-------------------------XX-------------------------XXXXX-----------------------XXXXX------------------------XXX------------------------XXXXX-----------------------XXXXX-----------------------XXXX-------------------------XXX------------------------XXXXX-----------------------XXXXX-----------------------------------------------------XX---------------------------------------------------------------------------------XXXX--------------------
--------------------------------------------------------------------------------------------------------------------------------------------------------------------------------------------------------------------------------------------------------------------------------------------------------------------------------------------------------------------------------------------------------------------------------------------------------------------------------------------------------------------------------------------------------------------------------------------------------------------------------------------------------------------------------------------------------------------------------------------------------------------------------------------------------------------------------------------------------------------------------------------------------------------------------------------------------------------------------------------------------------------------------------------------------------------------------------------------------------------------------------------------------------------------------------------------------------------------------------------------------------------------------------------------------------------------------------------------------------------------------------------------------------------------------------------------------
-----------------------SSSSS---------------------SSSSSSS------------------------SSSQ-----------oooo---------SSSQ------------------------SSSS------------------------SSSS------------oo----------SSSS------------------------SSSS------------------------SSSS----------oooo----------SSSS---------------------SSSSSSS------------------------SSSS-----------ooo----------SSS?---------------------S--SSSS----------ooooo----------SQS-----------ooo----------SSSS------------o----E------SSSS---------oooo----E-------SSS---------o--------------SSSS------------o-----------SSSS---------ooooo---E------SSS------------------E------SSSS------------------------SSSS---------oooo----E------SSSS------------------------SSSS------------o-----------SSSS---------o-oo----E------SSS----------o--------------SSSS------------------------SSSS---------oooo----E------SSSS------------------------SSSS------------------------SSSS-------------------------SSS---------------------SSSSSSS------------o-----------SSSS-------------------------SSS------------o-----------SSSS------------------------SSSS---------oo-o------------SSS------------------------SSS------------ooo----------SSSS---------oooo-----------SSSS------------o------------SSS---------------------SSSSSSS------------o-----------SSSS--------------E----------SQS---------------------S----QQ------------------------------------QQQ--------------------------------------SSSSSSS
----------------------------------------------------------------------------------------------------------------------------------------------------------------------------------------------------------------------------------------------------------------------------------------------------------------------------------------------------------------------------------------------------------------------------------------------------------------------------------------------------------------o---------------------------o-------------------------------------------------------o---------------------------o-------------------------------------------------------------------------------------------------------------------------------------------o--------------------------------------------------------------------------------------------------------------------------------------------------------------------------------------------------------------------------------------------------------------------------------------------------------------------------------------------------------------------------------------------------------------------------------------------------------------------------------------------------------------------------------------------<>-----------------------------------------------------------------------------------------------------------------------------
-----------------------------------------------------------------------------------------------SSS---------------------------------------------E--S-SS--------------------------------------------------------------------------------------------------------------SS----------------------------------------------------------------------------------SS-------------------------------------------------E----SSSSSS--------------------------------------------------S-------------------------S-SSS-----------------------S-SS---------------------o--------------------------------S---------------------------S-------------------------------------------------------SS--------------------------S-------------------------------------------------------S---------------------------S-----------------------------------------------------S-SSS--------------------S--S-SS---------------------S--S-SS----------------------------------------------------------------------------------SS---------------------E----------------------------------------------------------------------------------SS--S-SSS-----------------------------------------------------SS-SS------------------E--S-SSS--------------------S--S-SS------------------------------------------------------SS---------------------E--S-SS---[]-----------------------------------------------------------------------------------------------------------------------------
------------------------E---------------------E---------------------------E---------------------Q-----E---------------------------E----------oS---SoS---------E--o------------------------E---------------------------E---------------------------E---------------SoS---------E---------------------------E---------------------------E---------------SoS---------E---------------------------E---------------SoS---Q-----E--o------------S-S---------E---------------SoS---------E---------------SoS---------E---------------SoS---------E-----------------S---------E----------------oS---------E---------------SoS---------E---------------------------E--o------------SoS---------E---------------SoS---------E--o------------------------E---------------------------E---------------SoS---------E--o------------------------E---------------SoS---------E----------o----SoS---------E--o-------oS---SoS---------E--o------------------------E---------------------------E---------------SoS---------E---------------------------E--o------------------------E---------------------------E----------oSS--SoS---------E--o------------------------E---------------S-S---S-----E---------------SoS---------E--o-------oSS--SoS---------E--o------------------------E---------------SoS---------E----------oS---SoS----XX---E--o-------------------------------------------------------------------------------------oo---------------------E---------
------------------E----<>--------------------<>-----E--S-----------------<>------E?S-----------------<>------E?S-----------------<>------E?XSSS---SSS--------<>------E?S-----------------<>------E?S-----------------<>-----EE?S-----------------<>------E?S-------SS--------<>------E?S-----------------<>------E?S-----------------<>------E?S-------SS--------<>------S?S-----------------<>------E?S-SS---SSS--------<>------S?S-----------------<>-----EE?S--S----SS--------<>------E?SXSS---SSS----XX--<>------E--XSS---SSS--------<>------E?SXXS--------------<>------S?SXX-----SS----XX--<>-XXX--E?XXXS---SSS-----X--<>------E-S-----------------<>------E?SX-S---SSS--------<>------E?S--S----SS--------<>-----ES?S-----------------<>------E?S-------S-----XX--<>------E--SSS---SSS--------<>------E?X-----------------<>------E?SXXS---SSS--------<>------E?SSSS---SSS--------<>------E?SSSS---SSS--------<>------E?S-----------------<>------E?S-----------------<>-----ES?SSSS----SS--------<>------E?S-SS--------------<>------E?S-----------------<>------E?S-----------------<>------E?SSSS---SSS--------<>------E?S-----------------<>------E?S-o---------------<>------E?S-SS---SSS--------<>------E?SSSS---SSS--------<>------E?S-----------------<>------E?S--S----SS--------<>------E?SSSS---SSS--------<>------S?S-----------------<>--S---ESS-----------------------E------o----QQQQ------<>--------------------------<>-----E--S
-----------------<>----[]--------------------[]----<>--------------------[]--------------------------[]------------o-------------[]--------------------------[]--------------------------[]--------------------------[]--------------------------[]------------o-------------[]--------------------------[]--------------------------[]--------------------------[]--------------------------[]--------------------------[]------------o-------------[]----<>------o-------------[]------------o-------------[]------------o-------------[]--------------------------[]-----------Eo-------------[]------------o-------------[]--------------------------[]------------o-------------[]--------------------------[]----<>--------------------[]-----E-----Eo-------------[]------------o-------------[]--------------------------[]-----------oo-------------[]------------o-------------[]--------------------------[]--------------------------[]--------------------------[]----<>------o-------------[]--------------------------[]--------------------------[]------------o-------------[]-----E------o-------------[]--------------------------[]--------------------------[]------------o-------------[]--------------------------[]--------------------------[]------------o-------------[]--------------------------[]--------------------------[]-------------------------------<>---------------------[]--------------------------[]----<>---
-----------------[]----[]--------------------[]----[]--------------------[]------------XX------------[]-----------XXXXX----------[]-----------XXXX-----------[]--------------------------[]------------XXX-----------[]-------------XXX----------[]-----------XXXXX----------[]--------------------------[]--------------------------[]-----------XXXX-----------[]--------------------------[]-----------XXXX-----------[]-----------XXXXX----------[]----[]-----XXXXX----------[]-----------XXXXX----------[]-----------XXXXX----------[]-----------XXXXXX---------[]-----------XXXXXX---------[]-----------XXXXX----------[]----<>------XXXX----------[]-----------XXXXX----------[]-----------XXXX-----------[]----[]--------------------[]-----------XXXXX----------[]-----------XXXX-----------[]------------XXXX----------[]-----------XXXXX----------[]-----------XXXXX----------[]-----------XXXXX----------[]--------------------------[]-------------XXX----------[]----[]-----XXXXX----------[]--------------------------[]-----------XXXXX----------[]-----------XXXXX----------[]-----------XXXXX----------[]------------XXXX----------[]----------XXXX------------[]-----------XXXXX----------[]-----------XXXX-----------[]--------------------------[]-----------XXXXX----------[]-----------XXXX-----------[]--------------------------[]-------------------------------[]---------------------[]--------------------------[]----[]---
--------------E--[]-E--[]--------------E-EE--[]----[]-E------------E--E--[]-----------------------E--[]-----------------------E--[]------------------E-------[]--------------------E-E---[]--------------------E-----[]--------------------E-----[]--------------------------[]--------------------E-----[]--------------------E-----[]--------------------------[]--------------------E-EE--[]--------------------------[]--------------------------[]----[]--------------------[]--------------------------[]--------------------------[]-----------------------E--[]--------------------------[]------------------E-------[]----[]--------------E-----[]--------------------------[]------------------EEE-----[]----[]--------------------[]--------------------------[]------------------E-------[]--------------------------[]--------------------------[]------------------E-------[]------------------E-------[]--------------------E-----[]------------------E----E--[]----[]--------------------[]--------------------------[]--------------------E-----[]------------------E-E-----[]------------------E-------[]--------------------E-----[]-----------------------E--[]--------------------------[]--------------------------[]--------------------E--E--[]------------------E-E-----[]--------------------------[]--------------------E-E---[]---E-----------------E-E-E-----[]------------------E--[]-----------------------E--[]----[]---
XXXXX--XXXXXXXXXXXXXXXXXXXXXXXXX----XXXXXXXXXXXXXXXXXXXXXXX------XXXXXXXXXXXXXXXXXXXX---------XXXXXXXXXXXXXXXXXX----------XXXXXXXXXXXXXXXXXX---------XXXXXXXXXXXXXXXXXXXXX-------XXXXXXXXXXXXXXXXXXXXX-------XXXXXXXXXXXXXXXXXXXXXX-------XXXXXXXXXXXXXXXXXX----------XXXXXXXXXXXXXXXXXXXX-------XXXXXXXXXXXXXXXXXXXXXX------XXXXXXXXXXXXXXXXXXX----------XXXXXXXXXXXXXXXXXXXX-------XXXXXXXXXXXXXXXXXXX----------XXXXXXXXXXXXXXXXXX----------XXXXXXXXXXXXXXXXXX----------XXXXXXXXXXXXXXXXXX----------XXXXXXXXXXXXXXXXXX----------XXXXXXXXXXXXXXXXXX----------XXXXXXXXXXXXXXXXXX-----------XX--XXXXXXXXXXXXX----------XXXXXXXXXXXXXXXXXXX--------XXXXXXXXXXXXXXXXXXX----------XXXXXXXXXXXXXXXXXX------XXXXXXXXXXXXXXXXXXXXXX---------XXXXXXXXXXXXXXXXXXX----------XXXXXXXXXXXXXXXXXX---------XXXXXXXXXXXXXXXXXXXX---------XXXXXXXXXXXXXXXXXX----------XXXXXXXXXXXXXXXXXX----------XXXXXXXXXXXXXXXXXX---------XXXXXXXXXXXXXXXXXXXXX------XXXXXXXXXXXXXXXXXXXXXX-------XXXXXXXXXXXXXXXXXXX----------XXXXXXXXXXXXXXXXXXXX-------XXXXXXXXXXXXXXXXXXXX--------XXXXXXXXXXXXXXXXXXX---------XXXXXXXXXXXXXXXXXXX----------XXXXXXXXXXXXXXXXXXXX--------XXXXXXXXXXXXXXXXXX----------XXXXXXXXXXXXXXXXXX----------XXXXXXXXXXXXXXXXXX---------XXXXXXXXXXXXXXXXXXXXXX------XXXXXXXXXXXXXXXXXXXX---------XXXXXXXXXXXXXXXXXX---------XXXXXXXXXXXXXXXXXXXXX-------XXXXXXXXXXXXXXXXXXXXXXXXX---XXXXXXXXXXXXXXXXXXXXXXXXXXXXXXXXXXXXXXXXXXXXXXXXX-------XXXXXXXXXXXXXXXXXXX
