--------------------------------------------------------------------------------------------------------------------------------------------------------------------------------------------------------------------------------------------------------------------------------------------------------------------------------------------------------------------------------------------------------------------------------------------------------------------------------------------------------------------------------------------------------------------------------------------------------------------------------------------------------------------------------------------------------------------------------------------------------------------------------------------------------------------------------------------------------------------------------------------------------------------------------------------------------------------------------------------------------------------------------------------------------------------------------------------------------------------------------------------------------------------------------------------------------------------------------------------------------------------------------------------------------------------------------------------------------------------------------------------------------------------------------------------------------
--------------------------------------------------------------------------------------------------------------------------------------------------------------------------------------------------------------------------------------------------------------------------------------------------------------------------------------------------------------------------------------------------------------------------------------------------------------------------------------------------------------------------------------------------------------------------------------------------------------------------------------------------------------------------------------------------------------------------------------------------------------------------------------------------------------------------------------------------------------------------------------------------------------------------------------------------------------------------------------------------------------------------------------------------------------------------------------------------------------------------------------------------------------------------------------------------------------------------------------------------------------------------------------------------------------------------------------------------------------------------------------------------------------------------------------------------------
----oo---------------------------oo---------------------------o-------------------------ooo-------------------------ooo-------------------------oo--------------------------ooo-------------------------ooo-------------------------oooS------------------------ooo-------------------------ooo-------------------------oooS------------------------oooS-SSSSSS-----------------oooS--------------------SSS-SSSSSSSSSSSSS---------------ooo-------------------------oo--------------------------oo--------------------------ooo-------------------------oo--------------------------oo--------------------------ooo-------------------------ooo-------------------------oooS------------------------oo--------------------------oo--------------------------ooo---------------------SSS-SSSSSSSSSS------------------ooo-------------------------oo--------------------------ooo-------------------------oo--------------------------oo--------------------------ooSS------------------------oooS------------------------ooo-------------------------ooo-------------------------ooo-------------------------oooS--SSSSS-----------------ooo---------------------SSSSSSSSSSSSSSSSS-------------------------------------------------------------------------------------------------------------------------------ooo-------------------------ooo-------------------------ooo-------------------------oo--------------------------oo----------------------
----XXXX------------------------XXXX------------------------XXXX------------------------XXXX-----------------------XXXXX-----------------------XXXXX------------------------XXXX-----------------------XXXXX-----------------------XXXXX-----------------------XXXXX-----------------------XXXXX-----------------------XXXXX------------------------XXXX------------------------XXX-------------------------XXXX-----------------------XXXXX-----------------------XXXXX-----------------------XXXX-----------------------XXXXXX-----------------------XXXXX-----------------------XXXX------------------------XXXXX-----------------------XXXXX-----------------------XXXXX-----------------------XXXX------------------------XXXX------------------------XXXXX------------------------XXX-------------------------XXXX-----------------------XXXXX------------------------XXXX-----------------------XXXXX----------------------XXXXXX-----------------------XXXX------------------------XXXX------------------------XXXXX-----------------------XXXXX-----------------------XXXXX------------------------XXXX-----------------------XXXXX-------------------------XX-----------------------------------------------------------------------------------------------------------------------------------------XXXX-------------------E---XXXXX------------------------XXXX-----------------------XXXXX-----------------------XXXX---------------------
--------------------------------------------------------------------------------------------------------------------------------------------------------------------------------------------------------------------------------------------------------------------------------------------------------------------------------------------------------------------------------------------------------------------------------------------------------------------------------------------------------------------------------------------------------------------------------------------------------------------------------------------------------------------------------------------------------------------------------------------------------------------------------------------------------------------------------------------------------------------------------------------------------------------------------------------------------------------------------------------------------------------------------------------------------------------------------------------------------------------------------------------------------------------------------------------------------------------------------------------------------------------------------------------------------------------------------------------------------------------------------------------------------------------------------------------------------
-----------------------SSSSS------------------------SSSS------------------------SSSS-----------------------SSSSS------------------------SSSS------------o-----------SSSS------------------------SSSS------------o-----------SSSS-----------ooo----------SSSS------------------------SSSS------------------------SSSS------------oo----------SSSS------------------------SSSS------------o------------SSS------------o------------SSS------------------------SSSS---------o--o----E------SSSS------------o-E---------SSSS-----------oo-----------SSS-------------o-----------SSSS---------oooo----E------SSSS------------o-----------SSSS-----------------------SSSSS------------oo----------SSSS------------------------SSSS------------o-----------SSSS------------------------SSSS------------o------------SSS------------------------SSSS-----------oo-----------SSSS------------------------SSSS-----------ooo----------SSS-------------o----E------SSSS------------o------------SSS------------o-----------SSSS------------o-----------SSSS------------------------SSSS------------o-----------SSSS------------o------------SSS------------o-----------SSSS-------------------------SSS-------------------------------------QQ------------------------QQQQ------------------------------------------SSS------------------SS----SSS------------------------SSSSS------------------------SSSS-----------ooo----------SSSS------------------------SSSS
----------------------------------------------------------------------------------------------------------------------------------------------------------------------------------------------------------------------------------------------------------------------------------------------------------------------------------------------------------------------------------------------------------------------------------------------------------------------------------------------------------------------------------------------------------------------------------------------------o-----------------------------------------------------------------------------------------------------------------------------------------------------------------------------------------------------------------------------------------------------------------------------------------------------------------------------------------------o---------------------------------------------------------------------------------------------------------------------------------------------------------------------------------------------------------------------------------------------------------------------------------------------------------------------------------------------------------------------------------------------------------------------------------------------------------------------------------------------------
-----------------------------------------------------------------------------------------------------------------------------------------------E----SS-----------------------------------------------------------------------------E----SS---------------------E----S---------------------------S----------------------------S---------------------o---------------------------------S---------------------o-----S------------------------------------------------------SS--------------------SS--S-SS----------------------------------------------------------------------------------SS------------------------------------------------------------------------------------------------------------------------------------------SS---------------------o--------------------------------SS------------------------------------------------------------------------------------------------------------------------------------------S----------------------E----SS--------------------------SS----------------------------------------------------------------------------------S----------------------o----SS--------------------------SS---------------------------------------------------------------------------------------------------------------------------------------------------------------------------------------------------------------------------------------------------------------------------------E--S-SS------------------
-----o------------E---------------------------E---------------------------E---------------------------E---------------------------E---------------SoS---------E--o------------------------E---------------------------E---------------SoS---------E--o------------SoS---------E--o--------------S---------E-----------------S---------E---------------------------E--o--------------S---------E--o--------------S---------E--o------------------------E---------------SoS---------E----------oSS--SoS---------E--o------------------------E---------------------------E---------------SoS---------E---------------------------E---------------------------E---------------------------E---------------S-S---------E---------------SoS---------E---------------------------E---------------S-S---------E--o------------------------E-----------------S---------E---------------------------E-----------------S---------E----------------oS---------E---------------SoS---------E--o------------SoS---------E---------------------------E---------------------------E---------------SoS---------E--o-------------oS---------E--o--------------S---------E---------------------------E--------------------------E--o--E----------------------E----o----------------------E--ooo----------------------E---------------------------E---------------------------E---------------------------E-----------------S---------E---------------SoS---------E---------
-----------------<>-----E--------------------<>------E?S-----------------<>-----E--S-----------------<>-----E--S-----------------<>------E?S-SS---SSS--------<>------E?S-----------------<>------E?S-----------------<>------E?S-SS---SSS--------<>------S?S-SS----SS--------<>------E?S-------SS--------<>------E?S-S---------------<>------E?S-----------------<>------E?S-SS--------------<>------E?S-------S---------<>------S?S-----------------<>-----E??SX-S----SS--------<>------E?SSSS---SSS--------<>------E?S-----------------<>--XX--E?S-----------------<>------E?SXXS---SSS--------<>------E?X-----------------<>------E?S-----------------<>------E?S-----------------<>------E?S--S----S---------<>-----E--SXSS---SSS--------<>------E?S--S--------------<>------E?S-------SS--------<>------E?S-----------------<>------E?S-----------------<>------E?S-----------------<>------E?S-----------------<>------S?S-------SS--------<>------E---SS----SS--------<>------E?S------SSS--------<>------E?S-----------------<>------E?S-----------------<>------E?S-------SS--------<>------E?SSSS----SS--------<>------E?S-----------------<>------E?S-----------------<>------E?SQ---------------<>----<>------o----QQQQ------<>-----------o----QQQQ---Q--<>-----------------Q--------<>--------------------------<>--S--E--------------------<>------E?S-----------------<>------E?S-----------------<>------E?SSSS---SSS--------<>-----E??S
-----------------[]----<>--------------------[]--------------------------[]----<>--------------------[]----<>--------------------[]--------------------------[]--------------------------[]--------------------------[]--------------------------[]--------------------------[]--------------------------[]--------------------------[]--------------------------[]--------------------------[]--------------------------[]--------------------------[]----<>------o-------------[]--------------------------[]--------------------------[]--------------------------[]------------o-------------[]--------------------------[]--------------------------[]--------------------------[]------------o-------------[]----<>------o-------------[]--------------------------[]--------------------------[]--------------------------[]------------o-------------[]--------------------------[]------------o-------------[]-----------Eo-------------[]------------o-------------[]--------------------------[]--------------------------[]--------------------------[]--------------------------[]--------------------------[]--------------------------[]--------------------------[]-------------------------[]----[]---------------------[]--------------------------[]--------------------------[]----<>--------------------[]----<>--------------------[]--------------------------[]------------o-------------[]------------o-------------[]----<>---
-----------------[]----[]--------------------[]--------------------------[]----[]--------------------[]----[]-------X------------[]-----------XXXX-----------[]--------------------------[]------------XXX-----------[]-----------XXXX-----------[]-----------XXXX-----------[]------------XXX-----------[]--------------------------[]--------------------------[]------------XX------------[]------------XX------------[]--------------------------[]----[]-----XXXXXX---------[]-----------XXXXX----------[]------------XXXXX---------[]-----------XXXXX----------[]-----------XXXXX----------[]------------XXX-----------[]--------------------------[]-----------XXXX-----------[]-----------XXXXX----------[]----[]-----XXXXX----------[]------------XXX-----------[]-----------XXXX-----------[]--------------------------[]-----------XXXX-----------[]-------------XXX----------[]-----------XXXXXX---------[]-----------XXXXX----------[]-----------XXXX-----------[]-----------XXXX-----------[]------------XXXX----------[]------------XXX-----------[]-----------XXXXX----------[]------------XXX-----------[]------------XXXX----------[]--------------------------[]-------------------------[]----[]---------------------[]--------------------------[]--------------------------[]----[]--------------------[]----[]------XXXX----------[]------------X-------------[]-----------XXXXX----------[]-----------XXXXX----------[]----[]---
---------EEE--E--[]----[]--------------E-----[]-------------------EE-E---[]----[]-------------EE-E---[]----[]-----------------E--[]------------------E-------[]--------------------------[]-----------------------E--[]--------------------------[]------------------E-E--E--[]--------------------E-----[]--------------------------[]--------------------E-----[]--------------------------[]--------------------------[]-------------------EE-E---[]----[]--------------------[]--------------------------[]--------------------------[]--------------------------[]--------------------------[]--------------------------[]--------------------E--E--[]--------------------------[]------------------E----E--[]----[]------------E-------[]--------------------E-----[]--------------------------[]--------------------E-----[]--------------------------[]--------------------E-----[]--------------------------[]--------------------------[]--------------------------[]------------------E-------[]--------------------E-----[]--------------------E-----[]------------------E-------[]--------------------------[]--------------------------[]-------------------EE-E---[]------------EE-E---E-E---[]----[]------------------E--[]-----------------------E--[]-----------------------E--[]----[]--------------E-EE--[]----[]-----------------E--[]--------------------E-----[]--------------------------[]------------------E-------[]----[]---
XX-----XXXXXXXXXXXXXXXXXXXXXXXX-----XXXXXXXXXXXXXXXXXXXXXXX-----XXXXXXXXXXXXXXXXXXXXXXX-----XXXXXXXXXXXXXXXXXXXXX---------XXXXXXXXXXXXXXXXXX----------XXXXXXXXXXXXXXXXXXXX-------XXXXXXXXXXXXXXXXXXXX---------XXXXXXXXXXXXXXXXXX----------XXXXXXXXXXXXXXXXXXX--------XXXXXXXXXXXXXXXXXXXX--------XXXXXXXXXXXXXXXXXXX---------XXXXXXXXXXXXXXXXXXXXX-------XXXXXXXXXXXXXXXXXXX---------XXXXXXXXXXXXXXXXXXXX--------XXXXXXXXXXXXXXXXXXXXXX-----XXXXXXXXXXXXXXXXXXXX----------XXXXXXXXXXXXXXXXXX----------XXXXXXXXXXXXXXXXXX-----------XXXXXXXXXXXXXXXXX----------XXXXXXXXXXXXXXXXXX----------XXXXXXXXXXXXXXXXXXX---------XXXXXXXXXXXXXXXXXXXXX-----XXXXXXXXXXXXXXXXXXXX----------XXXXXXXXXXXXXXXXXX----------XXXXXXXXXXXXXXXXXX----------XXXXXXXXXXXXXXXXXXX--------XXXXXXXXXXXXXXXXXXX---------XXXXXXXXXXXXXXXXXXXXX-------XXXXXXXXXXXXXXXXXXX----------XXXXXXXXXXXXXXXXXXXX-------XXXXXXXXXXXXXXXXXXX----------XXXXXXXXXXXXXXXXXX----------XXXXXXXXXXXXXXXXXX---------XXXXXXXXXXXXXXXXXXX---------XXXXXXXXXXXXXXXXXXXXX-------XXXXXXXXXXXXXXXXXXXX--------XXXXXXXXXXXXXXXXXXX----------XXXXXXXXXXXXXXXXXX---------XXXXXXXXXXXXXXXXXXXX--------XXXXXXXXXXXXXXXXXXXXXX---XXXXXXXXXXXXXXXXXXXXXXXXXXXXXXXXXXXXXXXXXXXXXXXXXXXXXXXXXXXXXXXXXXXXXXXXXXXXXXXXXXXXXXXXXXXXXXXXXXXXXXXXXXXXXXXXXXXXXXXXXXXXXXXXXXXXXXXXX-------XXXXXXXXXXXXXXXXXXXX--------XXXXXXXXXXXXXXXXXXXX-------XXXXXXXXXXXXXXXXXXX----------XXXXXXXXXXXXXXXXXX---------XXXXXXXXXXXXXXXXXXX
