--------------------------------------------------------------------------------------------------------------------------------------------------------------------------------------------------------------------------------------------------------------------------------------------------------------------------------------------------------------------------------------------------------------------------------------------------------------------------------------------------------------------------------------------------------------------------------------------------------------------------------------------------------------------------------------------------------------------------------------------------------------------------------------------------------------------------------------------------------------------------------------------------------------------------------------------------------------------------------------------------------------------------------------------------------------------------------------------------------------------------------------------------------------------------------------------------------------------------------------------------------------------------------------------------------------------------------------------------------------------------------------------------------------------------------------------------------
--------------------------------------------------------------------------------------------------------------------------------------------------------------------------------------------------------------------------------------------------------------------------------------------------------------------------------------------------------------------------------------------------------------------------------------------------------------------------------------------------------------------------------------------------------------------------------------------------------------------------------------------------------------------------------------------------------------------------------------------------------------------------------------------------------------------------------------------------------------------------------------------------------------------------------------------------------------------------------------------------------------------------------------------------------------------------------------------------------------------------------------------------------------------------------------------------------------------------------------------------------------------------------------------------------------------------------------------------------------------------------------------------------------------------------------------------------
----oo--------------------------oSSSSSSSSSS-------------SSSSSSSSSSSSSSSSSSSSS-----------ooo-------------------------ooo---------------------SSS-SSSSSSSSSSSS----------------ooo-------------------------ooo-------------------------o---------------------------ooo-------------------------ooo-------------------------ooo---------------------SSS-oSSSSSSSSS------------------ooo-------------------------oo----------------------SSS-oSSSSSSSSS---------------SS-SSSSSSSSSS------------------ooo-------------------------oo--------------------------oo--------------------------oo--------------------------ooo-------------------------oo--------------------------oo--------------------------oooS------------------------oo--------------------------oo--------------------------oo--------------------------oo--------------------------oo--------------------------ooo--------------------------o--------------------------oo--------------------------oo--------------------------ooSS------------------------ooo-------------------------oo--------------------------oSSSS-SSSS------------------o-o-------------------------oooS------------------------ooo-------------------------oo--------------------------o---------------------------oooS--SSSS------------------ooo-------------------------ooo-------------------------ooo---------------------------------------------------------------------------------ooo---------------------
----XXX-------------------------XXXX----------------------------------------------------XXXX-----------------------XXXXX------------------------XXXX------------------------XXXX-----------------------XXXXX-----------------------XXXX-------------------------XXXX-----------------------XXXXX-----------------------XXXXX------------------------XXX------------------------XXXXX-----------------------XXXXX------------------------XXX-------------------------XXX------------------------XXXXX-----------------------XXXXX-----------------------XXXX------------------------XXXX------------------------XXXXX-----------------------XXXX------------------------XXXX-------------------------XXXX-----------------------XXXX------------------------XXXX------------------------XXXX------------------------XXXX------------------------XXX-------------------------XXXXX------------------------XXXX-----------------------XXXXX-----------------------XXXX------------------------XXXX------------------------XXXXX-----------------------XXXXX----------------------------------------------------XXXX------------------------XXXX-----------------------XXXXX-----------------------XXXX-------------------------XXX-------------------------XXXX-----------------------XXXXX------------------------XXXX------------------------XXXX------------------------XXX-----------------------------------------------------XXXX--------------------
--------------------------------------------------------------------------------------------------------------------------------------------------------------------------------------------------------------------------------------------------------------------------------------------------------------------------------------------------------------------------------------------------------------------------------------------------------------------------------------------------------------------------------------------------------------------------------------------------------------------------------------------------------------------------------------------------------------------------------------------------------------------------------------------------------------------------------------------------------------------------------------------------------------------------------------------------------------------------------------------------------------------------------------------------------------------------------------------------------------------------------------------------------------------------------------------------------------------------------------------------------------------------------------------------------------------------------------------------------------------------------------------------------------------------------------------------------
------------------------SSSS-------------------------SSS-------------------------SQQ------------------------SSSS------------oo----------SSSS------------------------SSSS------------------------SSSS------------o-----------SSSS------------------------SSSS---------------------SSSSSSS------------o-----------SSSS------------o-----------SSSS------------oo-----------SSS------------o-----------SSSS---------oooo----E------SSSS------S--oo-o------------SS-------------o------------SSS------------o-----------SSSS---------oooo-----------SSSS------------------------SSSS------------o-----------SSSS------------o-----------SSSS---------oooo----E------SSS-------------------------SSSS------------o------------SSS---------oooo----E------SS-----o-----oo-------------SSSS------------o-----------SSSS-----------------E------SSSS---o-----oo--------------SSS------------------------SSSS------------------------SSSS---------ooooo---E------SSS-------------------------SSSS---------ooooo-----------SSS-----------oo-----------SSSS-----------oo-----------SSSS---o--------o------------SSS---------------------S--SSSQ------------oo----------SSSS------------------------SSSS-----------ooo----------SSSS-------------------------SSS------------------------SSSS------------------------SSSS--------------E------S--SSSQ---------------------S--SSSS-------------------------SQS--------QQQQ-Q-Q------------------------------SSSSSSSSSS
------------------------------------------------------------------------------------------------------------------------------------------------------------------------------------------------------------------------------------------------------------------------------------------------------------------------------------------------------------------------------------------------------------------------------------------------------------------------------------------------------------------------------------------------------------------------------------------------------------------------------------------------------------o-----------------------------------------------------------------------------------o-------------------------------------------------------------------------------------------------------------------------------------------------------------------------------------------------------------------------------------------------------------------------------------------------------------------------------------------------------------------------------------------------------------------------------------------------------------------------------------------------------------------------------------------------------------------------------------------------------------------------------------------------------------------------------------------------------
-------------------------------E----------------------------------------------------------------------------------------------------------------------------------------------------------------------------SS----------------------------------------------------------------------------------SS--------------------------SS---------------------E----SS--------------------------SS------------------------S-SS---------------------E--S-SSS-------------------------SS--------------------------S-------------------------S-SS---S-----------------S--S-SS--------------------------S-------------------------------------------------------S----------------------E----S----------------------o--------------------------------S----------------------S--S-SS--------------------------SS--------------------------S---------------------SS--S-SS---------------------o------------------------------------------------------------SS--------------------------S----------------------E----SSS-----------------------------------------------------SS--------------------SS--S-SS-----------------------------------------------------------------------------E----SS--------------------------SS---------------------------------------------------------------------------------------------------------o-------------o-------------------------------------------------------------------------------Q------------------------------------------
------------------E---------------------------E--o------------------------E---------------------------E---------------------------E---------------------------E--o------------------------E---------------SoS---------E---------------------------E---------------------------E-----------------S---------E---------------SoS---------E---------------SoS---------E--o------------SoS---------E---------------SoS---------E----------oSS--SoS---------E--o-------------oS---------E--o--------------S---------E---------------SoS---------E----------oS---SoS---------E--o------------------------E---------------------------E---------------SoS---------E---------------SoS---------E--o------------------------E---------------SoS---------E----------oSS--SoS---------E---------------SoS---------E--o------------------------E----------oSS--SoS---------E--o------------------------E--o------------------------E---------------SoS---------E---------------------------E---------------SoS---------E--o--------------S---------E---------------SoS---------E----------oSS--SoS---------E--o------------------------E---------------------------E---------------SoS---------E--o------------SoS---------E---------------------------E---------------------------E---------------------------E---------------------------E---------------------------E---------------------------E----------S--------------------------------------------E---------
-----------------<>-----E--------------------<>-------?S-----------------<>------E?S-----------------<>------E?S-----------------<>------E?S-----------------<>------E?S-----------------<>------E?S-------SS--------<>------E?S--S--------------<>-----E-?S-----------------<>------E?S-----------------<>------E?S-------SS--------<>------E?S-SS---SSS--------<>------E?S-SS---SSS--------<>------E?SXXS----SS--------<>------E?S-SS---SSS--------<>------E?S-SS----SS--------<>------E?S-------S---------<>-----E??S------SSS--------<>------E?SSSS---SSS--------<>------E?S-----------------<>------E?S-----------------<>------E?S--S----SS----XX--<>------E?--SS---SSS--------<>------E?S-----------------<>------E?SXXS---SSS----XX--<>-XX---EXXSSSS--SSS--------<>------EXX-------SS--------<>------E?S-----------------<>------E?-XSS---SSS--------<>------E?S--S--------------<>------E?S-----------------<>----------------SS--------<>------S?S-SS--------------<>-----E--S-SS---SSS--------<>------E?S-----------------<>------E?S------SSS--------<>------E?SSSSS--SSS--------<>------E?S-----------------<>------ESS-----------------<>------S?S-------SS--------<>------E?S-SS----SS--------<>------E?S-SS--------------<>------E?S-----------------<>------E?S-----------------<>------E?S-----------------<>------E?S-----------------<>------E?S-----------------<>---------E------QQQQ-QQQ---------------E--------------<>--S--E---
-----------------[]----<>--------------------[]--------------------------[]--------------------------[]--------------------------[]--------------------------[]--------------------------[]--------------------------[]--------------------------[]----<>--------------------[]--------------------------[]--------------------------[]--------------------------[]--------------------------[]------------o-------------[]------------o-------------[]--------------------------[]--------------------------[]----<>------o-------------[]--------------------------[]--------------------------[]--------------------------[]-----------Eo-------------[]--------------------------[]-----E--------------------[]------------o-------------[]--------------------------[]------------o-------------[]-----------Eo-------------[]------------o-------------[]--------------------------[]--------------XX----------[]----<>------o-------------[]--------------------------[]----<>------o-------------[]--------------------------[]------------o-------------[]--------------------------[]--------------------------[]--------------------------[]--------------------------[]--------------------------[]--------------------------[]-----E--------------------[]--------------------------[]--------------------------[]--------------------------[]--------------------------[]-----E------------------------------------------------[]----<>---
--XXX------------[]----[]--------------------[]--------------------------[]--------------------------[]------------XXX-----------[]--------------------------[]--------------------------[]-----------XXXXX----------[]--------------------------[]----[]--------------------[]-----------XXXXX----------[]-----------XXXXX----------[]-----------XXXX-----------[]------------XXX-----------[]-----------XXXXXX---------[]-----------XXXXX----------[]------------XX------------[]-----------XXXX-----------[]----[]-----XXXXX----------[]-----------XXXXX----------[]-----------XXXX-----------[]-----------XXXXXX---------[]-----------XXXXX----------[]------------XXX-----------[]--------------------------[]-----------XXXXX----------[]-----------XXXX-----------[]-----------XXXXX----------[]-----------XXXXX----------[]-----------XXXXX----------[]------------XX------------[]--------------------------[]----[]-----XXXXXX---------[]--------------------------[]----[]-----XXXX-----------[]-----------XXXX-----------[]-----------XXXXX----------[]-----------XXXX-----------[]--------------------------[]-----------XXXXX----------[]------------XXX-----------[]-----------XXXX-----------[]--------------------------[]--------------------------[]--------------------------[]--------------------------[]------------XX------------[]--------------------------[]----<>------------------------------------------------[]----[]---
---------EEE-----[]----[]--------------E-----[]--------------------E-----[]--------------------E-----[]--------------------------[]--------------------E-----[]--------------------------[]--------------------------[]--------------------------[]----[]-------------EE-----[]--------------------------[]--------------------------[]------------------E-------[]--------------------------[]--------------------------[]------------------E-------[]--------------------------[]------------------E-------[]----[]--------------------[]------------------E-------[]--------------------------[]--------------------------[]--------------------------[]------------------E-E-----[]--------------------E-----[]--------------------------[]--------------------------[]--------------------------[]--------------------------[]------------------E-------[]--------------------E-----[]--------------------E-EE--[]----[]--------------------[]------------------EEE--E--[]----[]--------------------[]--------------------------[]--------------------------[]--------------------------[]--------------------E-E---[]---E--------------E-E-----[]--------------------------[]--------------------------[]--------------------------[]--------------------E-----[]--------------------E-----[]--------------------E-E---[]--------------------E-----[]-----------------------E--[]----[]-----------------E--------E--------------EE-E---[]-E--[]---
XXX--XXXXXXXXXXXXXXXXXXXXXXXXXXX----XXXXXXXXXXXXXXXXXXXXXXX-----XXXXXXXXXXXXXXXXXXXXXXX------XXXXXXXXXXXXXXXXXXX----------XXXXXXXXXXXXXXXXXXXX-------XXXXXXXXXXXXXXXXXXXXX-------XXXXXXXXXXXXXXXXXXX----------XXXXXXXXXXXXXXXXXX--------XXXXXXXXXXXXXXXXXXXXXXX----XXXXXXXXXXXXXXXXXXXXX----------XXXXXXXXXXXXXXXXXX----------XXXXXXXXXXXXXXXXXX---------XXXXXXXXXXXXXXXXXXX----------XXXXXXXXXXXXXXXXXX-----------XXXXXXXXXXXXXXXXX----------XXXXXXXXXXXXXXXXXX---------XXXXXXXXXXXXXXXXXXX---------XXXXXXXXXXXXXXXXXXX----------XXXXXXXXXXXXXXXXXX----------XXXXXXXXXXXXXXXXXX----------XXXXXXXXXXXXXXXXXX----------XXXXXXXXXXXXXXXXXX----------XXXXXXXXXXXXXXXXXX------XXXXXXXXXXXXXXXXXXXXXXXX-------XXXXXXXXXXXXXXXXXXX-----------XX--XXXXXXXXXXXXX----------XXXXXXXXXXXXXXXXXX----------XXXXXXXXXXXXXXXXXX----------XXXXXXXXXXXXXXXXXX----------XXXXXXXXXXXXXXXXXXXX------XXXXXXXXXXXXXXXXXXXXXXX------XXXXXXXXXXXXXXXXXXX----------XXXXXXXXXXXXXXXXXXXX-----XXXXXXXXXXXXXXXXXXXXX----------XXXXXXXXXXXXXXXXXX----------XXXXXXXXXXXXXXXXXX----------XXXXXXXXXXXXXXXXXX---------XXXXXXXXXXXXXXXXXXXXXX------XXXXXXXXXXXXXXXXXXXX--------XXXXXXXXXXXXXXXXXXX---------XXXXXXXXXXXXXXXXXXX----------XXXXXXXXXXXXXXXXXX--------XXXXXXXXXXXXXXXXXXXXXXX-----XXXXXXXXXXXXXXXXXXXXXXX------XXXXXXXXXXXXXXXXXXXXX-------XXXXXXXXXXXXXXXXXXXXX-------XXXXXXXXXXXXXXXXXXXXXXX----XXXXXXXXXXXXXXXXXXXXXXXXXXXXXXXXXXXXXXXXXXXXXXXXXXX---X-XXXXXXXXXXXXXXXXXXXX
