--------------------------------------------------------------------------------------------------------------------------------------------------------------------------------------------------------------------------------------------------------------------------------------------------------------------------------------------------------------------------------------------------------------------------------------------------------------------------------------------------------------------------------------------------------------------------------------------------------------------------------------------------------------------------------------------------------------------------------------------------------------------------------------------------------------------------------------------------------------------------------------------------------------------------------------------------------------------------------------------------------------------------------------------------------------------------------------------------------------------------------------------------------------------------------------------------------------------------------------------------------------------------------------------------------------------------------------------------------------------------------------------------------------------------------------------------------
-------------------------------------------------------------------------------------------------------------------------------------------------------------------------------------------------------------------------------Q---------------------------------------------------------------------------------------------------------------------------------------------------------------------------------------------------------------------------------------------------------------------------------------------------------------------------------------------------------------------------------------------------------------------------------------------------------------------------------------------------------------------------------------------------------------------------------------------------------------------------------------------------------------------------------------------------------------------------------------------------------------------------------------------------------------------------------------------------------------------------------------------------Q---------------------------------------------------------------------------------------------------------------------------------------------------------------------Q-------------------------------------------------------Q-Q------------------------------------------------------------------------------------
-----------------------------------------------------------------------------------------------------------------------------------------------------------------------------------------------------------------------------------------------------------------------------------------------------------------------------------------------------------------------------------------------------------------------------------------oo-------------------------------------------------------------------------------------------------------------------------------------------------------------------------------------------------------------------------------------------------------------------------------------------------------------------------------------------------------------------------------------------------------------------------------------------------------------------------------------------------------------------------------------------------------------------------------------------------------------------------------------------------------------------------------------------------------------------------------------------------------------------------------------------------------------------------------------------------------------------------------------------------------------------------------------------------------------------------------------------------------------
-------------------------------------------------------------------------------------------------------------------------------------------------------------------------------------------------------------------------------------------------------------------------------------------------------------------------------------------Q------------------------------------------------------------------------------------------X-XXXX-------------------------------------------------------------------------------------------------------E-----------------------------------------------------------------------------------E---------------------------------------------------------------------------------------------------------------------------------------------------------------------------------------------------------------------------Q---------------------------------------------------------------------------------------------------------------------------------------------------------------------------------------------------------------------------------------------------------------------------------------------------------------------------------------------------------------------------------------------------------------------------------------------------------------------------------------------------------------------------------XXX------------------------------------------------
-------------------------------------------------------E-----------------------------------------------------------------------------------------------------------------------------------------------------------------------------------------------------------------------------------------------------------------E------------------------------------------------------------------------------------------------------------------------------------------------------------------------------------------------------------------------------------------------------------------------------------------------------------------------------------------------------------------------------------------------------------------------------------------------------------------------------------------------------------------------------------------------------------------------------------------------------------------------------------------------------------------------------------------------------------------------------------------------------------------------------------------------------------------------------------------------------------------------------------------------------------------------------------------------------------------------------------------------------------------------------------------------------------------------------------------------------------------------------
---------------------------S-------------------------SSS-------------------------------------QQQ-Q-----------------------?--E------------SSS----------QQ-----------------------------------------------------?--E-----------QSQQ-----S-----?SSSS--QQ-----------------SS----------------S------------------------SSSS-----E--E----------------------------?-?-------------------------QQQQ--------------------------?ESSS------SSSSSS---------QQQQ-------------Q----------?-?QSSS-----SSSSSSS-------Q-Q-Q-----------------------?QQQ-E------------SS-----QQ-------------------------XXXX---------------------Q------------SS------SSSSS-Q---------------SS--------------------------------------Q---------?--E----------------------SSQQ---SSS--------------------QQ?-------------SQS------------------------SSSS---------?-QQ------------S----------E----------------------------QQQQ-----------SSS----------Q----------------Q----------Q-?QSSS--------SSQ----------?--E--------------S---------QQQ-Q------------Q-------------------------SSSS------------------------SSS---------------------------Q--------------------------SSS------------SSSS---------QQQ--------SSS?-SSS----------Q----------------------------S--------------------------SS---------QQ-------------SSSS------------QS---------SSSSS---------------------SSSSSSS---------?------------SSSSSS------------------------SSQQ---------Q-QQ---------QSSSQQ----------------------------
---------------------------------------------------------------------------------------------------------------------------XX-XX-------------------------------------------------------------------------------------------------------------------------------------------------------------------------------------------XX-XXX------o----------------------------------XX---------------------------X-------------XXX------------------------------------------------------X-------------------------------------------E---------XXXX----------------------------------------------------------------------------------------------------------------------------------------------------------------------XX-----------------------------------------------------------------------------------------------------------QXXXX-----------------------X---o---o------------------------------------------------------------------------------XX--------------------------X---------------------------------------------------------------------------------------------------------------------------------------------------------------------------------------------------X-------------------------------------------------------------------------------------------------------------------------------------------------------------------------------------------------------------------------------------------------------------------------
------------------------------------------------------------------------------------------------------------------------------------------------------------------------------------------------------E-------------------------------------------------------------------------------------------------------------------------------XXX-------------------------------------------------------------------------------------------------------------------------------------Q------------------------------------------<>-----------Q---------------------------------------------------------------------------------------------------------------------------------------------------------------------------------------------------------------------------------------------------------------------------------------Q----------------------------X--XXX-----------------------------------------------------------------------------Q-----------------------------------------------------------------------E--------------------------------------------------------------------------------------------------------------<>-----------------------------------------------------------------------------------------------------------------------------------------------------------------------------------------------------------------------------------------------------------------------------------------------------------------
------------------E---------------------------------------------------------------------------------------------------------------------E------------------------E------------------------E--S-------<>---------------E----------------------------------------------E--------E--E------------------------------E-------------------------------------------------------------E------------------E----------E-------------------E---------------------E---------------E------------------------------------------E-------[]---------------E--E--------------------------------------------------------------------E---------------------------E--------------E--?-----------------------------------E-------------E------------------------------E--------E------------------E------------------------E--S--------E---------------------------E----------------------------------------------E--------E---------------E--E--------E---E--------------E--------E-E-------------------E-----E------------------E-------<>---------------E---------------E--------------E----------------------------------------o-----------E----------[]---------------------------E-----------------------------E-------------E-----E-------E-------------E-----------E---------------E---------------------------E-----------E---------------E--E--------E---------------E---------------------------E--E---------------------------E----------E-----------------------
-----------------<>-----E-----------Q---------------E-----E---------------<>-E----E<---<>--Q--QQQQ---Q--Q------Q---------S--------E----<>-----------------------<>-----------------------<>-----E----[]----E?-QQQ----<>------Q??-----------------Q--Q------Q--------<>-------<>-<>---------<>-------------E----<>----------E--Q--------------QQ?--E---E---QQQ----Q--Q------Q-<>----E-QQQQ-------<>--------E<>------QQ----------<>-----E----E?QQ-Q----<>------QQ?-----<>---Q---Q--------------------Q-QQQ--------<>---QQQ-[]---EE?SQQQ----<>-<>------XX--SSS-----------------XX--------------------------------E--<>----QQ------Q-------------<>---QQQ-------<>-------------Q--QQQQ---------------<><>--E?SQQQ----<>----------------Q?SQ-Q-------<>---QQQ-<>----E?SQ---------<>---------------Q-------<>-----E--S-<>----E?SQQQ-----E-----E----<>----E--Q---------<>---Q-Q--E---E--SQQQ-------<>----QQ-<>----E--Q------<>-<>---QQQ-<>--<>---QQQQ------<>-------<><>---?S--------E----<>----<>----Q-QQ---------<>---QQQ-[]--------------<>--------S--E--<>----Q--------<>---QQQ---------------------------S-----------------<>-----E----[]------------------S---QQQ-<>---E-----------------------E<>---QQQ------<>----<>-----E<>----QQ------<>-----E----<>---E---Q---Q--<>------EES--E-E----QQQQ----<>-----E----<>--<>---Q------<>-<>---E?S-<>------S-------<>--------S---------QQ------<>-<>---QQQ--E---E---Q-Q-------<>---QQQ--E<>-----------------------
-----------------[]----<>--------------------------<>----<>---------------[]<>---<>[---[]-------------------------E-E------------<>----[]-----------------------[]-----------XX----------[]----<>----[]--------------[]---------------------------------------------[]-------[]-[]--------E[]------------<>----[]-----E--------------------------<>--<>----------------------[]-----------------[]---<>--<>[]------------------[]----<>--------------[]----------<>--[]-----------------------------------------[]-------[]--------------[]-[]---------E-----------------------------------------------------<>--[]-----------------------E--[]-------------[]-----------------------------------[][]------------[]-----E-----------------------[]-------[]-----------------[]--------E--------------[]----<>----[]--------------<>----<>----[]-----------------[]-------<>--<>-------------[]-------[]--<>----------[]-[]-------[]--[]-------------[]-------[][]------------<>----[]----[]-----------------[]-------[]--------------[]----------<>--[]-------------[]-------<>------------------------------------E-----[]----<>----[]------E-------------------[]--<>--------------E-------<>[]------------[]----[]----<>[]------------[]----<>----[]--<>----------[]--E-------<><>------------[]----<>----[]--[]----------[]-[]-------[]--------------[]--E--E----<><>------------[]-[]-------<>--<>-------------[]-------<>[]-----E-----------------
-----------------[]----[]--------------------------[]----[]---------------[][]---[]S---[]------------------------<><>------------[]----[]-----------------------[]-----------------------[]----[]----[]--------------[]------------------<>-------------------------[]-------[]-[]-------<>[]------------[]----[]----<>--------------------------[]--[]----------------------[]-----------------[]---[]--[][]------------------[]----[]--------------[]-<>-------[]--[]-----------------------------------------[]-------[]--------------[]-[]------------------------------------------------X--------------[]--[]----------------------<>--[]-------------[]-----------------------------------[][]------------[]-<>-<>-----------------------[]-------[]-----------------[]-------<>--------------[]----[]----[]--------------[]----[]----[]-----------------[]-------[]--[]-------------[]-------[]--[]----------[]-[]-------[]--[]-------------[]-------[][]------------[]----[]----[]-----------------[]-------[]--------------[]----------[]--[]-------------[]-------[]-----------------------------------<>-----[]----[]----[]-----<>-------------------[]--[]-------------<>-------[][]------------[]----[]----[][]------------[]----[]----[]--[]----------[]-<>-------[][]------------[]----[]----[]--[]----------[]-[]-------[]--------------[]-<>-------[][]------------[]-[]-------[]--[]-------------[]-------[][]----<>-----------------
------E-E---E-E--[]----[]--------EE-----E-E----E---[]----[]---------------[][]-E-[]S---[]---------E-EE-----EE-E--[][]--------EE--[]-E--[]---------E-----E-EE----[]-E-EE---------------E--[]----[]----[]-----------E--[]------------------[]-----EE-----E--E------E--[]-------[]-[]-------[][]--------EE--[]-E--[]----[]----------EE-E----EE------[]-E[]-------E-EE-----EE-E--[]-----------EE----[]-E-[]--[][]-E------EE--E-E---[]----[]-----------E--[]-[]-------[]--[]------EE-----E-E---X---------------EE----[]----E--[]----------EE--[]-[]----------------------------------------------E-X--------------[]--[]-------E--E--------XX-[]--[]-------EE-E--[]-E-E----------------E-EE-----E-----[][]--------EE-E[]-[]-[]-----------------E--E--[]-E--E--[]-----------E-----[]-------[]--------E--E--[]----[]----[]----------EE-E[]E---[]----[]-----------E-EE--[]----E--[]--[]-------E--E--[]-E--E--[]--[]-------E--[]-[]-------[]--[]-------E--E--[]-------[][]---E-----E--[]----[]----[]-----------E-----[]-------[]--E------E-E--[]----E-----[]-E[]-------E-----[]----E--[]--EE-----E-E--------E----------E---[]--E--[]----[]----[]-----[]-E--E--E-----------[]--[]----E--E-EE-E[]-------[][]--------EE--[]----[]----[][]--------EE--[]-E--[]----[]--[]---EE-E---[]-[]-------[][]-E------EE--[]----[]----[]--[]---EE-E---[]-[]-------[]-----------E--[]-[]-------[][]---------E--[]-[]-------[]--[]-------E--E--[]-------[][]--E-[]---E-EE----EE----
XXXXXXXXXXXXXXXXXXXXXXXXXXXXXXXXXXXXXXXXXXXXXXXXXXXXXXXXXXXXXXXXXXXXXXXXXXXXXXXXXXXXXXXXXXXXXXXXXXXXXXXXXXXXXXXX-XXXXXXXXXXXXXXXXXXXXXXXXXXXXXXXXXXXXXXXXXXXXXXXXXXXXXXXXXX------XXXXXXXXXXXXXXXXXXX-XXXXXXXXXXXXXXXXXXXXXXXXXXXXXXXXXX--XXXXXXXXXXXXXXXXXXX-XXXXXXXXXXXXXXXXXXXXXXXXXXX-XXXXXXXXXXXXXXXXXXXXXXXXXSX-XXXXXXXXXXXXXXXXXXXXXXX-XXXXXXXXXXXXXXXXXXXXXXXXXXXXXXXXXXXXXXXXXXXXXXXXXXXXXXXXXXX-XXXXXXXXXXXXXXXXXXXXXXXXXXX-XXXXXXXXXXXXXXXXXXXXXXXXXXX-XXXXXXXXXXXXXXXXXXXXXXXXXXXXXXXXXXXXXXXXXXXXXXXXXXXXXXXXXXXXXXXXXXXXXXXXXXXXXXXXXXXXXXXXX----------------------XXXXXXXXXXXXXXXXXXXXXXXXXXXX-XXXXXXXXXXXXXXXXXXXXXXXXXXX-XXXXXXXXXXXXXXXXXXXXXXXXXXXXXXX---X-XXXXXXXXXXXXXXXXXXXXXXXXXXXXXXXXXXXXXXXXXXXXXXXXXX--XXXXXXXXXXXXXXXXXXXXXXX-XXXXXXXXXXXXXXXXXXXXXXXXXXX-XXXXXXXXXXXXXXXXXXXXXXXXXXXXXXXXXXXXXXXXXXXXXXXXXXXXXXX-XXXXXXXXXXXXXXXXXXXXXXXXXXX-XXXXXXXXXXXXXXXXXXXXXXXXXXXXXXXXXXXXXXXXXXXXXXXXXXXXXXXXXXXXXXXXXXXXXXXXXXXXXXXXXXX-XXXXXXXXXXXXXXXXXXXXXXXXXXX-XXXXXXXXXXXXXXXXXXXXXXXXXXX-XXXXXXXXXXXXXXXXXXXXXXXXXXX-XXXXXXXXXXXXXXXXXXXXXXXXXXXXXXXXXXXXXXXXXXXXXXXXXXXXXXXXXXXXXoXXXXXXXXXXXXXXXXXXXXX-XXXXXXXXXXXXXXXXXXXXXXXXXXXXXXXXXXXXXXXXXXXXXXXXXXXXXXX-XXXXXXXXXXXXXXXXXXXXXXXXXXX-XXXXXXXXXXXXXXXXXXXXXXXXXXX-XXXXXXXXXXXXXXXXXXXXXXXXXXXXXXXXXXXXXXXXXXXXXXXXXXXXXXX-XXXXXXXXXXXXXXXXXXXXXXXXXXX-XXXXXXXXXXXXXXXXXXXXXXXXXXXXXXXXXXXXXXXXXXXXXXXXXXXXXXX-XXXXXXXXXXXXXXXXXXXXXXXXXXX-XXXXXXXXXXXXXXXXXXXXXXXXXXX
