--------------------------------------------------------------------------------------------------------------------------------------------------------------------------------------------------------------------------------------------------------------------------------------------------------------------------------------------------------------------------------------------------------------------------------------------------------------------------------------------------------------------------------------------------------------------------------------------------------------------------------------------------------------------------------------------------------------------------------------------------------------------------------------------------------------------------------------------------------------------------------------------------------------------------------------------------------------------------------------------------------------------------------------------------------------------------------------------------------------------------------------------------------------------------------------------------------------------------------------------------------------------------------------------------------------------------------------------------------------------------------------------------------------------------------------------------------
-------------------------------------------------------------------------------------------------------------------------------------------------------------------------------------------------------------------------------------------------------------------------------------------------------------------------------------------------------------------------------------------------------------------------------------------------------------------------------------------------------------------------------------------------------------------------------------------------------------------------------------------------------------------Q-----------------------------------------------------------------------------------Q-------------------------------------------------------Q-----------------------------------------------------------------------------------------------------------------------------------------------------------------------Q-------------------------------------------------------------------------------------------------------------------------------------------------------------------------------------------------------------------------------------------------------------------------------------------------------------------------------------------------------------------------------------------------------Q---------------------------Q----------------------------
--------------------------------------------------------------------------------------------------------------------------------------------------------------------------------------------------------------------------------------------------------------------------------------------------------------------------------------------------------------------------------------------------------------------------------------------------------------------------------------------------------------------------------------------------------------------------------------------------------------------------------------------------------------------------------------------------------------------------------------------------------------------------------------------------------------------------------------------------------------------------------------------------------------------------------------------------------------------------------------------------------------------------------------------------------------------------------------------------------------------------------------------------------------------------------------------------------------------------------------------------------------------------------------------------------------------------------------------------------------------------------------------------------------------------------------------------------
-----------------------------------------------------------------------------------------------------------------------------------------------------------------------E---------------------------------------------------------------------------------------------------------------------------------------------------------------------------------------------------------------------------------------------------------------------------------------------------------------------------------------------------------------------------E----------------------------------------------------------------------------------------------------------------------------------------------------------------------------------------------------------------------------------------------------------------------------------------------------------------------------------------------------------------------------------------------------------------------------------------------------------------------------------------------------------------------------------------------------------------------------------------------------------------------------------------------------------------------------------------------------------------------------------------------------------------------------------------------------------------------------------------------------------------------------------------------------
--------------------------------------------------------------------------------------------------------------------------------------------------------------------------------------------------------------------------------------------------------------------------------------------------------------------------------------------------------------------------------------------------------------------------------------------------------------------------------------------------------------------------------------------------------------------------------------------------------------------------------------------------------------------------------------------------------------------------------------------------------------------------------------------------------------------------------------------------------------------------------------------------------------------------------------------------------------------------------------------------------------------------------------------------------------------------------------------------------------------------------------------------------------------------------------------------------------------------------------------------------------------------------------------------------------------------------------------------------------------------------------------------------------------------------------------------------
-----------Q-----------SSSS----------QQQ-----------------------------------------SSS---------?--E-------------S----------?-?-SSS-----SSSSSSS-----------Q-----------SSSS----------QQQ------------SSSS---------?--E------------SSS---------QQQQ------------SQ----------?-?E-------------QQ---------QQ-QQQ----------------------Q---------------------------Q--------------SSS-o--------QQQQ--S------------------------E------------------------QS-E------------SS------------------------SSSSS---------Q---------------SQQo------?-QQQQ----------SSSS----------QQQQSSS---------SQ----------Q-Q----------------o--------QQ-E----------SSSSS---------QQ-E------------SSS---------Q-QQ------------------------?---------------SS----------???E-----------SSSS---------------------------------------?-S---------SSSSS---------------------------------------------------------------------------------------------Q-Q--QSS-------SSS----------?--E-------------SS-------------------------SSQ---------?-Q-----------S-------------?--E--------SSSSS------------------S-------SSS----------------SS-----SSSSSS---------?Q?Q-----------SSSS---------QQ--------------SQ----------QQQ---S---------------------?-?-------------------------Q-Q-------------SQS-------------------------------------QQ?QSSS--------SSQS-------------------------SSS-------------------------QQQ---------?--E-----------SSSS---------Q--------------SSSS---------QQQ----------------
------------------------------------------------------------------------------------------------------------------E---------------------------------------------------------------------------------------------------------------------------XX--------------------------XX--------------------------X-----------------------------------------------------------------------------------------------------------------------------------------XXXX---------------------------------------------------------------------------------XXX--------------------------------------------------------------------------------XXXX----------------------------------------------------------------------------------XX--------------------------XX------------------------------------------------------------------------------------------------------------------------------------------------------------------------------------------------XXXX----------------------------------------------------------------------------------X----------------------------------------------------------------------------------XXX----------------------------------------------------------------------------------------------------------------------------------------------------------------------XX-------------------------------------------------------------------------------XXXXXX-------------------------------------------------------------------
-----------------------------------------------------------------------------------------------------------------<>---------------------------------------------------------------------------------------------------------------------------Q-------------------------------------------------------Q-------------------------------------------------------------------------------------------------------------------------------------------Q-----------------------------------------------------------------------------------Q-----X-----------------------------------------------------------------------------Q-----------------------------------------------------------------------------------------------------------------------------------------------------------------------------------------------------------------------------------------------------------------------------------------------------------------------------------E-------------------------------------------------------------------Q-----------------------------------------------------------------------------------Q---------------------------------------------X-------------------------------------------------------------------------------------------------------------------------Q-----------------------------------------------------------------------------------Q---------------------------------------------------------------------
------E--------------E---------------------------E--?---------------------E-----E-----E---------------E----------[]---------------E------------------------------E--------E------------------E--?-------E-------------E--S--E-----E---------------E-----------E---------------E-----------------------------------------E-------------E-----------E---------------E--E------------E--------------E----------E-------------E-----------E---E-----------E--?--------E---------------E--S--------E---------------E--E------------E--------------E--------E------------------E---------------------------E----------E-------------------------E---------------E---------------E--------------E----------E-------------E-----------E-E---------------------------E----------------E--------E---------------E-------------E-------------E--------------------------------E-------------------------E------------E--------------E--------E---E-----------------E----<>---------------E-----------E------------------E------------------------E------------------------------E------------------------E--E-------------------------------------------------------E---------XS----------------E------------E-----------------------E------------------E----------E-------------E-----------E-------------------------------------------E-----E-----E------------------E----------E-------------------E--o--E---------------E--E---------------------------E------
--E--<>---QQQ-------<>------------E--QQQQ-------<>--------------Q--------<>----<>----<>----E?QQ------<>-----E----[]---EE---------<>------S?S------E--QQQQ-------<>---QQQ-<>----E-SQ---------<>--------E<>---?SQQQ----<>----<>----<>---E--SQQQ----<>----------<>----E?S-------<>-----E-----E---E--QQQQQ----------------E<>---QQQ------<>-----E----<>----E---------<>-<>---QQ------<>---QQQQ------<>----QQ--E<>---QQQQ-----<>-----E----<>--<>--SQQQ----<>----------<>--------------<>-----E----<>----E?QQQQ----<>-<>--------E--<>---QQQQ------<>---QQQ-<>----E?SQQQ-------<>---QQQ--E--<>---QQQ-------<>---QQQ--E<>---?SQQQ----------------<>----E?S-------<>-----------E--<>---QQQQ------<>---QQQ--E<>--E--QQQ----<>------QQ?-<><>---?SQ------<>-----E--S---<>------------E--<>-------<>----E---------<>--------S--E<>----Q-------<>-------------------------------<>------E----E--QQQ-------<>--------E--<>---QQQQ------<>---QQQ-<>--<>--S--------E----<>----[]----E---------<>-----E----<>----E?SQQQ----Q--<>---QQ?--E--<>----------<>-------XX--E--<>---QQ--------<>---QQQ-<>----Q--Q------<>-<>----E---E---E---QQQ---------------------Q-QQ-------<>-<>----?S--EXX--E--QQQ----E--<>--------E--<>----QQ-------<>----QQ-<>----E?SQ---------<>--------E<>-----Q------<>----------<>--<>---Q------<>-S------S-----------------<>----<>----<>-----------------<>---QQQ--E<>---?SQQQ-----E----<>----<>-----QQ-------<>-<>-----S----------QQ--------<>-----Q
-<>--[]-------------[]--------E--<>-------------[]-----------------------[]----[]----[]--------------[]----<>----[]--------------[]-----------E--<>-------------[]-------[]-----------------[]-------<>[]------------[]----[]----[]--<>----------[]-----E----[]--------------[]----<>----<>--<>-----------------E----<>[]------------[]----<>----[]--------------[]-[]--------E--[]-------------[]-------<>[]------------[]----<>----[]--[]----------[]-----E----[]--------------[]----<>----[]--------------[]-[]-<>----<>--[]-------------[]-------[]-----------------[]-------<>--[]-------------[]-------<>[]------------------------[]--------------[]--E-------<>--[]-------------[]-------<>[]------------[]----------[][]------------[]----<>------[]-----------<>--[]-------[]--------------[]----------<>[]------------[]-------------------------------[]--E--<>-----------------[]-------<>--[]-------------[]-------[]--[]----------<>----[]----[]--------------[]----<>----[]-----------------[]-------<>--[]----------[]----------<>--[]-------------[]-------[]--------------[]-[]-------<>--<>--------------------------------------[]-[]-------XXXX-----------<>--[]-------<>--[]-------------[]-------[]-----------------[]-------<>[]------------[]-----E----[]--[]----------[]-----E--------------E-----[]----[]----[]-----------------[]-------<>[]------------<>----[]----[]--------------[]-[]--E----XX-----------------[]------
-[]-E[]-------------[]-------<>--[]-------------[]-----------------------[]----[]----[]--------------[]----[]----[]--------------[]----------<>--[]-------------[]-------[]-----------------[]-------[][]------------[]----[]----[]--[]----------[]-<>-<>----[]--------------[]----[]----[]--[]----------------<>----[][]------------[]----[]----[]--------------[]-[]-------<>--[]-------------[]-------[][]------------[]----[]----[]--[]----------[]-<>-<>----[]--------------[]----[]----[]--------------[]-[]-[]----[]--[]-------------[]-------[]-----------------[]-------[]--[]-------------[]-------[][]---------------<>-------[]--------------[]-<>-------[]--[]-------------[]-------[][]------------[]----------[][]------------[]----[]----<>[]-----------[]--[]-------[]--------------[]----------[][]------------[]-----E-----------------------SS[]-<>--[]-----------------[]-------[]--[]-------------[]-------[]--[]----------[]----[]----[]--------------[]----[]----[]-----------------[]-------[]--[]----------[]----------[]--[]-------------[]-------[]--------------[]-[]-------[]--[]--------------------------------------[]-[]------XXXXX---SS------[]--[]-------[]--[]-------------[]-------[]-----------------[]-------[][]------------[]----<>----[]--[]----------[]-<>-<>----<>--------------[]----[]----[]-----------<>----[]-------[][]------------[]----[]----[]--------------[]-[]-<>----[]-----------------[]------
-[][][]-------EE-E--[]-E-----[]--[]-------EE----[]--------------------E--[]----[]----[]-----------E--[]----[]----[]--------E--E--[]-X--------[]--[]-------E--E--[]----E--[]-----------EE----[]-E-----[][]---------E--[]----[]----[]--[]-------E--[]-[]-[]----[]-----------E--[]----[]----[]--[]------EE-EE-E---[]----[][]--------EE--[]----[]----[]--------E--EE-[]-[]-------[]--[]-------EE----[]-E-E---[][]--------EE-E[]----[]----[]--[]------EE--[]-[]-[]----[]-------E---E--[]----[]----[]-----------E--[]-[]-[]----[]--[]------EE-EE--[]-------[]-----------E--E--[]----E--[]-E[]-------EE----[]-------[][]---------E--E--[]-E-----[]-----E-----E--[]-[]-E-----[]--[]-------EE-E--[]----E--[][]--------EE-E[]---E------[][]---------E--XX----[]----[][]-E-----E-E-[]--[]-E-----[]-----------E--[]----------[][]---------E-E[]--------------E--EE-E--E--E----[]-[]--[]----------EE-EE--[]-------[]-E[]-------EE-E--[]-E--E--[]--[]------EE--[]E---[]----[]--EE-E--EE-E--[]----[]----[]----------EE-----[]-------[]--[]----E-EE--[]---E---X--[]--[]-------EE----[]-------[]--------E---E-[]-[]-------[]--[]-------E--E---------------EE-----E-E--[]-[]------XXXXX-----------[]--[]-E-E---[]--[]-------E-EE--[]-E--E--[]-----------E--E--[]-E-----[][]--------EE--[]----[]----[]--[]----E--E--[]-[]-[]----[]--EE-E-----E--[]----[]----[]---E--E--E-[]----[]-------[][]---------E--[]----[]----[]--EE-E---E-E--[]-[]-[]----[]---E-----E-EE----[]-E-EE-
-XXXXXXXXXXXXXXXXXXXXXXXXXXX-XXXXXXXXXXXXXXXXXXXXXXXXXXXXXXXXX-XXXXXXXXXXXXXXXXXXXXX-XXXXXXXXXXXXXXXXXXXXXXXXXXX-XXXXXXXXXXXXXXXXXXXXXXXXXXX-XXXXXXXXXXXXXXXXXXXXXXXXXXX-XXXXXXXXXXXXXXXXXXXXXXXXXXX-XXXXXXXXXXXXXXXXXXXXXXXXXXX-XXXXXXXXXXXXXXXXXXXXXXXXXXX-XXXXXXXXXXXXXXXXXXXXXXXXXXX-XXXXXXXXXXXXXXXXXXXXXXXXXXXXXXXXXXXXXXXXXXXXXXXXXXXXXXX-XXXXXXXXXXXXXXXXXXXXXXXXXXX-XXXXXXXXXXXXXXXXXXXXXXXXXXX-XXXXXXXXXXXXXXXXXXXXXXXXXX-XXXXXXXXXXXXXXXXXXXXXXXXXXXX-XXXXXXXXXXXXXXXXXXXXXXXXXXX-XXXXXXXXXXXXXXXXXXXXXXXXXXXXXXXXXXXXXXXXXXXXXXXXXXXXXXX-XXXXXXXXXXXXXXXXXXXXXXXXXXX-XXXXXXXXXXXXXXXXXXXXXXXXXXXXXXXXXXXXXXXXXXXXXXXXXXXXXXX-XXXXXXXXXXXXXXXXXXXXXXXXXXXXXXXXXXXXXXXXXXXXXXXXXXXXXXX-XXXXXXXXXXXXXXXXXXXXXXXXXXX-XXXXXXXXXXXXXXXXXXXXXXXXXXX-XXXXXXXXXXXXXXXXXXXXXXXXXXX-XXXXXXXXXXXXXXXXXXXXXXXXXXX-XXXXXXXXXXXXXXXXXXXXXXXXXXXXXXXXXXXXXXXXXXXXXXXXXXXXXXX-XXXXXX-XXXXXXXXXXXXXXXXXXXX-XXXXXXXXXXXXXXXXXXXXXXXXXXX-XXXXXXXXXXXXXXXXXXXXXXXXXX--XXXXXXXXXXXXXXXXXXXXXXXXXXX-XXXXXXXXXXXXXXXXXXXXXXXXXXX-XXXXXXXXXXXXXXXXXXXXXXXXXXXXXXXXXXXXXXXXXXXXXXXXXXXXXXX-XXXXXXXXXXXXXXXXXXXXXXXXXXXXXXXXXXXXXXXXXXXXXXXXXXXXXXXXXXXXXXXXXXXXXXXXXXXXXXXXXXXXXXX-XXXXXXXXXXXXXXXXXXXXXXX-XXXXXXXXXXXXXXXXXXXXXXXXXXX-XXXXXXXXXXXXXXXXXXXXXXXXXXXXXXXXXXXXXXXXXXXXXXXXXXXXXXX-XXXXXXXXXXXXXXXXXXXXXXXXXXX-XXXXXXXXXXXXXXXXXXXXXXXXXXX-XXXXXXXXXXXXXXXXXXXXXXXXXXX-XXXXXXXXXXXXXXXXXXXXXXXXXXX-XXXXXXXXXXXXXXXXXXXXXXXXXXXXXXXXXXXXXXXXXXXXXXXXXXXXXXX
