--------------------------------------------------------------------------------------------------------------------------------------------------------------------------------------------------------------------------------------------------------------------------------------------------------------------------------------------------------------------------------------------------------------------------------------------------------------------------------------------------------------------------------------------------------------------------------------------------------------------------------------------------------------------------------------------------------------------------------------------------------------------------------------------------------------------------------------------------------------------------------------------------------------------------------------------------------------------------------------------------------------------------------------------------------------------------------------------------------------------------------------------------------------------------------------------------------------------------------------------------------------------------------------------------------------------------------------------------------------------------------------------------------------------------------------------------------
---------------------------------------------------------------------------------------------------------------------------------------------------------------------------------------------------Q---------------------------------------------------------------------------------------------------------------------------------------------------------------------------------------------------------------------------------------------------------------------------------------------------------------------------------------------------------------------------------------------------------------------------------------------------------------------------------------------------------------------------------------------------------------------------------------------------------------------------------------------------------------------------------------------------------------------------------------------------------------------------------------------------------------------------------------------------------------------------------------------------------------------------------------------------------------------------------------------------------------------------------------------------------------------------Q-----------------------------------------------------------------------------------------------------------------------------------------------------------------------Q
------------------------------------------------------------------------------------------------------------------------------------------------------------------------------------------------------------------------------------------------------------------------------------------------------------------------------------------------------------------------------------------------------------------------------------------------------------------------------------------------------------------------------------------------------------------------------------------------------------------------------------------------------------------------------------------------------------------------------------------------------------------------------------------------------------------------------------------------------------------------------------------------------------------------------------------------------------------o----------------------------------------------------------------------------------------------------------------------------------------------------------------------------------------------------------------------------------------------------------------------------------------------------------------------------------------------oo---------------------------o---------------------------------------------------------------------------------------------------------
-----------------------------------------------------------------------------------------------------------------------------------------------------------------------------------------------------------------------------------------------------------E-----------------------------------------------------------------------------------------------------------------------------------------------------------------------E-----------------------------------------------------------------------------------------------------------------------------------------------------------------------------------------------------------------------------------------------------------------------------------------------------------------------------------------------------------------------------------------------------------------------------------------------------------------------------------------------------------------------------XXX--------------------------------------------------------------------------------------------------------------------------------------------------------------------------------------------------------------------------------------------------------------------------------------------------------------------------------------------XXXX-------------------------XXX--------------------------------------------------------------------------------------------------------
---------------------------------------------------------------------------------------------------------------------------------------------------------------------------------------------------------------------------------------------------------------------------------------------------------------------------------------------------------------------------------------------------------------------------------E----------------------------------------------------------------------------------------------------------------------------------------------------------------------------------------------------------------------------------------------------------------------------------------------------------------------------------------------------------------------------------------------------------------------------------------------------------------------------------------------------------------------------------------------------------------------------------------------------------------------------------------------------------------------------------------------------------------------------------------------------------------------------------------------------------------------------------------------------------------------------------------------------------------------------------------------------------------------------------------------------------------------
-------------------------QQQ------------E------------------------Q-Q-SSS---------------------------S-----SSS-------------------------SSSSSSS---------------------------Q---------?-?-SSS-----SSSSSSS------------E------------------------Q-QQ---------SSSSS--------?S?S?Q----------------------?-QQQQ-----------------------------------------QQ---------Q-QQQQ-----------QQ---------Q-QQ-----------SSSS-------?-Q-Q-----------SSSS-o--------QQQQ-----------SSSS---------?-?Q------------SQ----------QQ?E------------------------?--E----------------------QQQQQQQ------------Q----------QQQ------------SSQ----------Q-Q----------------o--------Q-Q-----------SSSS-------------------------SSSS--------QQ---------------------------Q-QQ-------------Q----------?--E------------------------?--E-----------SSSS-----------------------------------------------------SQQ---------------------------S-----------------------SSSSS---------Q---------------SQS---------?--E---------SSSSSS---------?--E---------------------------------------SQS-------------------------SSSS-------?-QQQ-------------SQ----------QQ?QSSS--------SSQ--------------------------S?S-------?-QQ-----------SSSSS----------?-?Q------------------------Q-Q-------------------------?S-E---------SSSSSS---------Q-Q-----------SSS-----------------------SSSSSSS---------Q------------SSSSSS---------Q-Q-------------------------?-QQ----------------------?QQQQE-----------SSSS
------------------------------------------X-------------------------------------------------------------------------------------------------------------------------------------------X-----------------------------------------------------------------------S-----------XX--------------------------------------------------------------------------------------------------------------XX----------------------------------------------------------------------------------XX--------------------------XX-----------------------QXXXX----------------------------------------------------------------------------------------------------------------------------------------------------------------------------------XX-----------------------------------------XXX---------------------------------------------------------------------------------------------------------------------------------------------------------------------------------------------------------------------------XX-X---------------------------------------------------------------------------------------------------------------XX----------------------------------------------------------------------------------XX--------------------------------------XX-----------<XXXXX-----------------------------------------------------------------------------------------------------------------------------------------XX--------------------------X-------------
--------------------------------------------------------------------------------------------------------------------------------------------------------------------------------------Q-------------------------------------------------------------------------------------------------------------------------------E---------------------------------------Q---------------------------Q---------------------------------------------------------------------------------------------------E-----------------------------------------------------------------------------------------------------------------------------------------------------------------------------------------------------------------------------------------------------------------------------------------------------------------------------------------------E-------------------------------------------------------------------------------------------------------------------------------------------------------------------------------------------------------------------------------------------------------------------------------------------------------------------------------------------------------------------------------------------XXX---------E-------------------------------------------------------------------------------------------------------------------------------------------------------------------------------------------------
------------------------------E---------------E--S------------------------------------------E---------------------E---------------E---------------------------E-----E---------E-------------------------------------------------------E--------------E--------E------------------E--------E------------------E-------<>------------------E------------E-----------E---------------------------E--E--------E---------------E--E---------------------------E--------E---E--------------E-------<>------------------E----------E-------------------E------------------------E--------E------------------E--------E------------------E------------E--------------E----------E-------------------E-----E------------------E----------------------------------------E---------------------------------------E--S---------------------------E-------<>---------------E---------------------------------E-----E---------------E--E---------------------------E--------E---------------E-----------E-------------------------------E--------------E----------E-------------E--S--E-----E---------------E--E---------------------------E----------E-------------E--E--------E---------------E-----------E----------------------------------------------E-------<>---------------E------------------------------E--?-----E---------------E-------------------------------------------E--------------E--------E---E--------------E--------E------------------E------
-<>---------------E----------<>----E?S-------<>-----E------Q--QQ-QQQQQ---------------------<>-----------------XX-<>---E----------<>-------X------------------<>----<>-----E--<>-------Q--Q---------?--E-E----Q--------E-----E-----E--<>---QQQ-------<>---QQ?-<>-X--E?SSQQ-------<>-------<>----E?SQQQ-------<>-------[]----E------------<>--------E--<>---QQQQQ--<>--------X--E-E--E-SQQQ----<>-<>-------<>--<>--SQQQ----<>-<>---QQ?--E<>---?SQQQ-------<>-------<>--<>--SQQQ-------<>---QQQ-[]----E?SQQ-----QQ-<>---QQQ--E<>---QSQQQ----<>----<>----------Q?-QQQ----Q--<>---QQQ-<>----E-QQQQ-------<>---QQQ-<>--<>---QQQ-------<>---QQQ--E--<>---QQQ-------<>---QQQ--E<>---QQQ------<>----<>----<>----E?-QQQ-------<>-----Q--E-E--E-SQQQ------------QQQ--E--<>---QQQQ------<>--------E------QQ------<>-----E--S-----------E-----E--<>-------[]--------------<>-----------E----E?SQQQ-----E----<>----<>-----QQ-------<>-<>---EES---<>--E?QQ---------<>-------<>----E-QQ------<>-----E--S-<>------S-------<>-----E-----E--<>---QQQ-------<>---QQQ--E<>------------<>----<>----<>----E?SQQQ----<>-<>--------E-E-E---QQQQ------<>----QQ--E<>---QQ-------<>-<>-------<>----E--Q---Q--<>--------S-<>----E-SQQQ----Q---E---QQQ--E--<>--QQQQ-------<>---QQQ-[]---E??S-------<>-----E--S---------QQQ--------<>-------<>----Q---------<>-------?S-<>----Q-Q---------------S?S--E--<>---QQQQ------<>---QQQ-<>--<>---QQQ-------<>---QQQ-<>----S?S----------<>------
-[]--------------<>----------[]--------------[]----<>---------------------------------E----[]-----------------X--[]--------------[]-------X------------E-----[]----[]----<>--[]----------------------<><>------------<>----<>----<>--[]-------------[]-------[]-----------------[]--E----[]-----------------[]-------[]-----------------[]-------<>--[]----------[]-----E----<>[]------------[]-[]--E----[]--[]----------[]-[]-------<>[]---------------[]-E-----[]--[]-------------[]-------[]-----------------[]-------<>[]------------[]----[]-----------------------[]-------[]-----------------[]-------[]--[]-------------[]-------<>--[]-------------[]-------<>[]------------[]----[]----[]-----------------[]-------<>[]------------------------<>--[]-------------[]-------<>--------------[]----<>----X---S----<>----<>--[]-------[]--------------[]-----E----<>--------------<>----[]----[]--------------[]-[]---------[]---------------[]-------[]--------------[]----<>----[]--------------[]----<>----<>--[]-------------[]-------<>[]------------[]----[]----[]--------------[]-[]-------<><>[]-------------[]-------<>[]------------[]-[]-<>----[]--------------[]-----E----[]-----------------<>-------<>--[]-------------[]-------[]--<>----------[]----<>-----E-E---------------[]-------[]--------------[]----------[]--------------------------<>--[]-------------[]-------[]--[]-------------[]-------[]-----------------[]------
-[]--------------[]----------[]--------------[]----[]--------------------------------<>----[]-----------------XX-[]--------------[]-------------------<>-----[]----[]----[]--[]----------------------[][]------------[]----[]----[]--[]-------------[]-------[]-----------------[]-<>----[]-----------------[]-------[]-----------------[]-------[]--[]----------[]----<>----[][][]----------[]-[]-<>----[]--[]----------[]-[]-------[][]---------------[]<>-----[]--[]-------------[]-------[]-----------------[]-------[][]------------[]----[]----<>-----------------[]-------[]-----------------[]-------[]--[]-------------[]-------[]-E[]-------------[]-------[][]------------[]----[]----[]-----------------[]-------[][]------------------------[]-E[]-------------<>-------[]--------------[]----[]-------------[]----[]--[]-------[]--------------[]----<>----[]--------------[]----[]----[]--------------[]-<>-------<>[]---------------[]-------[]--------------[]----[]----[]--------------[]----[]----[]--[]-------------[]-------[][]------------[]----[]----[]--------------[]-[]-------[][][]-------------[]-------[][]------------[]-[]-[]----[]--------------[]-<>-------[]-----------------[]-------[]--[]-------------[]-------[]--[]----------[]----[]----<><>---------------[]-------[]--------------[]----------[]-----------------<>-------[]--[]-------------[]-------[]--[]-------------[]-------[]-----------------[]------
-[]--------E--E--[]----------[]----------EE--[]----[]--------------------------------[]----[]----E--E-----E---XX-[]--X----EE-EE--[]-E-E---X-----------[]--E--[]----[]----[]-E[]----E-E---E-E---------[][]--------EE-EXX----[]----[]--[]-------E-----[]-------[]----------EE-----[]-[]----[]-----------E-----[]-------[]---------E-EE----[]-E-----[]-E[]------EE--[]----[]----[][][]-------E--[]-[]-[]----[]--[]----E--E--XX-[]-------[][]---------E-----[][]-----[]--[]------EE-EE--[]-------[]-----------E-E---[]-------[][]--------EE-E[]----[]----[]----------EE-----[]-------[]-----------EE----[]-------[]--[]-------EE-E--[]-E--E--[][][]-------E-----[]-E--E--[][]------E-EE--[]-E--[]----[]-----------E-EE--[]-------[][]---------E-EE--------E--[][][]------EE-E---[]-------[]-X------E--E--[]----[]----X----E---[]----[]--[]-------[]------E-E--E--[]----[]----[]----------EE-EXXE---[]----[]--------E--E--[]-[]-------[][]---------E-EE--[]-------[]--------E--E--[]----[]----[]----------EE-E[]----[]----[]-E[]-------EE-E--[]-E--E--[][]------E--E--[]----[]----[]-----------E--[]-[]-------[][][]-------E-EE--[]-E-E---[][]---------E--[]-[]-[]----[]--------E-EE--[]-[]--X----[]-----------E-EE--[]-------[]--[]-------EE----[]----E--[]--[]----E--E--[]----[]----[][]-------E-EE----[]-------[]------E-E--E--[]----------[]---------E-E-----[]-------[]--[]-------E-EE--[]-EE-E--[]--[]-------E-EE--[]-------[]-----------E-EE--[]------
-XXXXXXXXXXXXXXXXXXXXXXXXXXX-XXXXXXXXXXXXXXXXXXXXXXXXXXXXXXXX-XXXXXXXXXXXX-X---XXXXX-XXXXXXXXXXXXXXXXXXXXXXXXXXX-XXXXXXXXXXXXXXXXXXXXXXXXXXXXXXXXX--XXXXXXXXXXXXXXXXXXXX-XXXXXXXXXXXXXXXXXXXXXXXXXXX-XXXXXXXXXXXXXXXXXXXXXXXXXXX-XXXXXXXXXXXXXXXXXXXXXXXXXXXXXXXXXXXXXXXXXXXXXXXXXXXXXXX-XXXXXXXXXXXXXXXXXXXXXXXXXXX-XXXXXXXXXXXXXXXXXXXXXXXXXXX-XXXXXXXXXXXXXXXXXXXXXXXXXXXXXXXXXXXXXXXXXXXXXXXXXXXXXXXXXXXXXXXXXXXXXXXXXXXXXXXXXXXXXXXXXXXXXXXXXXXXXXXXXXXXXXX-XXXXXXXXXXXXXXXXXXXXXXXXXXX-XXXXXXXXXXXXXXXXXXXXXXXXXXXXXXXXXXXXXXXXXXXXXXXXXXXXXXX-XXXXXXXXXXXXXXXXXXXXXXXXXXX-XXXXXXXXXXXXXXXXXXXXXXXXXXX-XXXXXXXXXXXXXXXXXXXXXXXXXXX-XXXXXXXXXXXXXXXXXXXXXXXXXXX-XXXXXXXXXXXXXXXXXXXXXXXXXXX-XXXXXXXXXXXXXXXXXXXXXXXXXXXXXXXXXXXXXXXXXXXXXXXXXXXXXXXXXXXXXXXXXXXXXXXXXXXXXXXXXXX-XXXXXXXXXXXXXXXXXXXXXXXXXXXXXXXXXX-XXXXXXXXXXXXXXXXXXXX-XXXXXXXXXXXXXXXXXXXXXXXXXXX-XXXXXXXXXXXXXXXXXXXXXXXXXXX-XXXXXXXXXXXXXXXXXXXXXXXXXXXXXXXXXXXXXXXXXXXXXXXXXXXXXXX-XXXXXXXXXXXXXXXXXXXXXXXXXXX-XXXXXXXXXXXXXXXXXXXXXXXXXXX-XXXXXXXXXXXXXXXXXXXXXXXXXXX-XXXXXXXXXXXXXXXXXXXXXXXXXXX-XXXXXXXXXXXXXXXXXXXXXXXXXXXXXXXXXXXXXXXXXXXXXXXXXXXXXXX-XXXXXXXXXXXXXXXXXXXXXXXXXXXXXXXXXXXXXXXXXXXXXXXXXXXXXXX-XXXXXXXXXXXXXXXXXXXXXXXXXXX-XXXXXXXXXXXXXXXXXXXXXXXXXXX-XXXXXXXXXXXXXXXXXXXXXXXXXXX-XXXXXXXXXXXXXXXXXXXXXX-XXXX-XXXXXXXXXXXXXXXXXXXXXXXXXXXXXXXXXXXXXXXXXXXXXXXXXXXXXXXXXXXXXXXXXXXXXXXXXXXXXXXXXXX-XXXXXXXXXXXXXXXXXXXXXXXXXXXXXXXXXXXXXXXXXXXXXXXXXXXXXXX
