--------------------------------------------------------------------------------------------------------------------------------------------------------------------------------------------------------------------------------------------------------------------------------------------------------------------------------------------------------------------------------------------------------------------------------------------------------------------------------------------------------------------------------------------------------------------------------------------------------------------------------------------------------------------------------------------------------------------------------------------------------------------------------------------------------------------------------------------------------------------------------------------------------------------------------------------------------------------------------------------------------------------------------------------------------------------------------------------------------------------------------------------------------------------------------------------------------------------------------------------------------------------------------------------------------------------------------------------------------------------------------------------------------------------------------------------------------
--------------------------------------------------------------------------------------------------------------------------------------------------------------------------------------------------------------------------------------------------------------------------------------------------------------------------------------------------------------------------------------------------------------------------------------------------------------------------------------------------------------------------------------------------------------------------------------------------------------------------------------------------------------------------------------------------------------------------------------------------------------------------------------------------------------------------------------------------------------------------------------------------------------------------------------------------------------------------------------------------------------------------------------------------------------------------------------------------------------------------------------------------------------------------------------------------------------------------------------------------------------------------------------------------------------------------------------------------------------------------------------------------------------------------------------------------------
----oo--------------------------oo--------------------------oo--------------------------o---------------------------oo--------------------------oo--------------------------oo--------------------------o---------------------------oo--------------------------o---------------------------oo--------------------------oo--------------------------oo--------------------------oo--------------------------oo--------------------------oo--------------------------oo--------------------------oo--------------------------o---------------------------oo------------------------------------------------------o---------------------------oo--------------------------oo--------------------------oo--------------------------oo--------------------------oo--------------------------oo--------------------------oo--------------------------oo--------------------------o---------------------------oo--------------------------oo--------------------------oo------------------------------------------------------o---------------------------oo--------------------------oo--------------------------o---------------------------oo--------------------------o---------------------------o---------------------------oo--------------------------oo--------------------------oo------------------------------------------------------ooo-------------------------oo--------------------------oo--------------------------oo----------------------
----XXX------------------------XXXX------------------------XXXX----------------------------------------------------XXXX-------------------------XXX-------------------------XX-----------------------------------------------------XXXX-------------------------X-------------------------XXXXX--------------------E---XXXX-----------------------XXXXX-----------------------XXXXX-----------------------XXXXXX-------------------E----XXX-------------------------XXX-------------------------XXX--------------------E----X-------------------------XXXXXX------------------------XXX-------------------------X--------------------------XXXX------------------------XXXX-------------------------XXX-------------------------XXX-------------------------XXX------------------------XXXX-------------------------XXX------------------------XXXX-----------------------------------------------------XXX-------------------------XXX-------------------------XXX-----------------------------------------------------XX--------------------------X--------------------------XXXX----------------------------------------------------XXXX-----------------------------------------------------X---------------------------XXX------------------------XXXX-----------------------XXXXX--------------------E-----XX-------------------------XXXX-----------------------XXXXX-----------------------XXXX-------------------------XXX---------------------
-----------------E-----------------------------------------------------------------------------------?---------------------------?---------------------------?---------------------------?---------------------------E-------------------------------------------------------?-----------------------------------------------------------------------------------------------------------------------------------------------------------------------?---------------------------E---------------------------E---------------------------?-------------------------------------------------------?---------------------------?---------------------------E---------------------------?---------------------------?---------------------------?---------------------------?--------------------------E?---------------------------?---------------------------?------X--------------------?---------------------------?---------------------------?---------------------------?---------------------------?---------------------------?---------------------------?---------------------------?---------------------------?---------------------------?---------------------------E---------------------------?-------------------------------------------------------?-----------------------------------------------------------------------------------------------------------------------------------------------------------------------?----------
---------oooo----XX-----SS-------------ooo---EXS----SSS-------------oo---ESS----SSS------------ooo---XXS----S--------------oo---XXXS----SSS-----------Xoo---XXXS----SSS-----------Xoo----XXS----SSS------------oo----XXS----SSS------------ooo---XSS----SSS------------oo---XXXS----SS-------------ooo---SSS----SSS----------oooo----E------SSS?---------oooo----XX-----SSSS------------oo---ESS----SSS------------ooo---XXS----SSS-----------Xooo--XXXS----?--------------oo---XXXS----SSS------------oo----XXS----SSS-----------Xooo---XXS----S------------ooooo---E------SSS-----------Xooo--XXXS----?-------------Xooo---XXS----S------------ooooo---XXS----SS------------Xooo---XXS----S-S-----------Xooo---XXS----S-------------Xooo---XXS----S-------------Xooo---XXS----SS-------------oo---XXXX----SS------------Xoo---XXXS----S-------------Xooo--XXXS----S-------------Xooo---XXS----S-------------Xooo---XXS----SS------------Xooo---XXS----SS------------oooo---XXS----S-------------Xooo---XXS----?-------------Xoo----XXS----S-------------ooo---XXX-----SS------------Xooo---XXS----S-------------Xooo---XXS----S-------------oooo---XXS----S------------oooo----XX-----?-------------oooo---XXS----S------------oooo---XXX-----SS------------Xooo---XXS----S------------oooo----XX-----SSS--------------------------SSS----------------------SSSSSS------------o-----------SSSS---------oooo----E------SSSS-----------ooo---XXS----?---
--------------------o---------------------------o------------------------------------------------------oo-----------------------------------------------------------------------------------o---------------------------o-------------------------------------------------------o-------------------------------------------------------o---------------------------o-----------------------------------------------------------------------------------o------------------------------------------------------oo-----------------------------------------------------------------------------------o-------------------------------------------------------------------------------------------------------------------------------------------o-----------------------------------------------------------------------------------------------------------------------------------------------------------------------------------------------------------------------------------------------------------o-------------------------------------------------------o--------------------------------------------------------------------------------------------------------------oo------------------------------------------------------oo-------------------------------------------------------o---------------------------------------------------------------------------------------------------------------o---------------------------o-------
--------S-------------------------------------------------------------------------------------------------------------------------------------------------------------------------------------------------------------------------------------------------------------------------------------------------------------------SS--------------------------S---------------------------------------------------------------------------------------------------------------------------------------------------------------------------------------------------S---------------------------------------------------------------------------------------------------------------------------------------------------------------------------------------------------------------------------------------------------------------------------------------------------------------------------------------------------------------------------------------------------------------------------------------------------------------------------------------------------------------------------------------------------------------------------------------------------------------------------------------------------------------------------------------------------------------------------S---------------o-------------------------------------------------------------------S---------------------------S-----------------------------------------------
------SoS---------------------------------------------------------------------------------------------------------------------------------------------------------------------------------------------------------------------------------------------------------------Q-------------------------------------------------SoS---------E-----------------S---------E---------------------------------------------------------------------------------------------------------------------------------X-------------------------------------------------------S---------E-----------------------------------------------------------------------------------------------------------------------------------------------------------------------------------------------------------------------------------------------------------------------------------------------------------------------------------------------------------------------------------------------------------------------------------------------------------------------------------------------------------------------------------------------------------------------------------------------------------------------------------------------------------------------------------------------------------------S---------E---------------------------E---------------------------E---------------S-S---------E---------------SoS---------E-------------------------------------
-------SS----XXX----XXX--XX--------------XXX----XXX------------------XXX----XXX------------------XXX----XXX------------------XXX---XXXX--XXX-------------XXX---XXXX--XXX-------------XXX----XXX--X---------------XXX---XXXX--XX--------------XXX----XXX--XX--------------XXX---XXXX------------------XXX----XXX--XXX------SSS--------<>------E?XXX-----SS----XX--<>-XXX--E---------------XX--<>-XXX------------------XXX----XXX--XXX-------------XXX----XXX------------------XXX---XXXX-----XXX----------XXX---XXXX------------------XXX---XXXX--XX--------SS--------<>-XXX--E?X-------------XXX---XXXX------------------XXX---XXXX--XX-XX-----------XXX---XXXX--XXX-------------XXX---XXXX--XX--------------XXX---XXXX--XXX-------------XXX----XXX--XX-XX-----------XXX---XXXX-----------------XXXX---XXXX--XXX-------------XXX---XXXX--XX--------------XXX---XXXX--XXXX------------XXX---XXXX--XXX-------------XXX---XXXX--XXXX------------XXX---XXXX--XXX-------------XXX---XXXX--XXXX------------XXX----XXX------------------XXX---XXXX--XXXXX-----------XXX---XXXX--XXXXX-----------XXX---XXXX--XX--------------XXX---XXXX------------------XXX---XXXX--XXXXX-----------XXX---XXXX------------------XXX---XXXX--XX-XX-----------XXX---XXXX------------------XXX----XXX------------SS----XX--<>-XXX--E?X-----------------<>-----E--------------------<>-----E--S-------SS--------<>------E?SXXS---SSS----XX--<>------E?X-------------XXX----XXX-----
--Eo--------------E------------o--------------E------------o--------------E-----------Eo---------------------------o---------------------------o--------------------------Eo---------------------------o---------------------------o---------------------------o---------------------------o--------------E-----------oo-------------[]------------o-------------[]------------o-------------[]------------o-------------<>-----------Eo---------------------------o---------------------------o--------------------------Eo---------------------------o-------------[]-----------Eo--------------------------Eo---------------------------o---------------------------o--------------------------Eo--------------------------Eo---------------------------o------------------------------------------------------Eo--------------------------Eo--------------------------Eo---------------------------o--------------------------Eo--------------------------Eo--------------------------Eo--------------------------Eo---------------------------o---------------------------o--------------------------Eo---------------------------o--------------------------Eo--------------------------Eo---------------------------o--------------------------Eo--------------------------Eo-------------[]--------------------------[]----<>--------------------[]----<>------o-------------[]------------o-------------[]-----------Eo------------------------
--XXXXX----------<>-----------XXXXXX---------<>-----------XXXXXX---------<>-----------XXXXXX---------<>-----------XXXXX-----------------------XXXXXX----------------------XXXXXX----------------------XXXXXX----------------------XXXXXX----------------------XXXXXX---------<>-----------XXXXXX---------<>-----------XXXXX----------[]-----------XXXXX----------[]-----------XXXXXX---------[]-----------XXXXXX---------[]-----------XXXXXX----------------------XXXXXX----------------------XXXXXX----------------------XXXXXX----------------------XXXXX----------[]-----------XXXXX-----------------------XXXXXX----------------------XXXXX-----------------------XXXXXX----------------------XXXXXX----------------------XXXXXX----------------------XXXXXX-----------------------XXXX-----------------------XXXXX-----------------------XXXXX-----------------------XXXXXX----------------------XXXXXX----------------------XXXXXX----------------------XXXXXX----------------------XXXXXX----------------------XXXXX-----------------------XXXXXX----------------------XXXXXX----------------------XXXXXX----------------------XXXXXX----------------------XXXXX-----------------------XXXXX-----------------------XXXXX----------<>-----------XXXXXX----------------------XXXXX----------[]--------------------------[]----[]--------------------[]----[]-----XXXXX----------[]-----------XXXXX----------[]-----------XXXXXX---------<>---------
-----------------[]--------------------------[]--------------------------[]--------------------------[]----------------------------------------------------------------------------------------------------------------------------------------------------------------------[]--------------------------[]--------------------------[]--------------------------[]--------------------------[]--------------------------[]------------------------------------------------------------------------------------------------------------------------------------------[]------------------------------------------------------------------------------------------------------------------------------------------------------------------------------------------------------------------------------------------------------------------------------------------------------------------------------------------------------------------------------------------------------------------------------------------------------------------------------------------------------------------------------------------------------------------------------------------------------------------------------------------------------------------[]------------------------------------------------------[]--------------------E-EE--[]----[]--------------E-EE--[]----[]--------------------[]--------------------------[]--------------------------[]---------
-----------X---XXXXXXXXXXXXX---------------XXXXXXXXXXXXXX--------------XXXXXXXXXXXXX---------------XXXXXXX--XXXXXX-------------XXXX------XXX---------------XXXX------XXX---------------XXXX-----XXXX---------------XXXX------XXX---------------XXXX-X----XXX---------------XXXX--X--XXXX---------------XXXXXXXX-XXXX-----------XXXXXXXXXXXXXXXXX-----------XX--XXXXXXXXXXXXXX----------XX--XXXXXXXXXXXXX---------------XXXXXXXX-XXXX---------------XXXX------XXXX--------------XXXX------XXX---------------XXXX-XX---XXX---------------XXXX------XXX-----------XXXXXXXXXXXXXXXXX---------------XXXX------XXX---------------XXXX------XXX---------------XXXX------XXX---------------XXXX------XXX---------------XXXX------XXX---------------XXXX------XXX----------------XXX------XXXX--------------XXXX------XXX---------------XXXX------XXX---------------XXXX------XXX---------------XXXX------XXX---------------XXXX------XXX---------------XXXX------XXX---------------XXXX------XXX----------------XXX------XXX---------------XXXX------XXX---------------XXXX------XXX----------------XXX------XXX---------------XXXX------XXX---------------XXXX-X----XXX---------------XXXX------XXX---------------XXXX------XXX---------------XXXXXXX---XXXX--------------XXXX-----XXXX-----------XXX-XXXXXXXXXXXXXXXXX-----XXXXXXXXXXXXXXXXXXXXXX------XXXXXXXXXXXXXXXXXXX----------XXXXXXXXXXXXXXXXXX----------XXXXXXXXXXXXXXXXXX-----------X---XXXXXXXXXXXXX
