--------------------------------------------------------------------------------------------------------------------------------------------------------------------------------------------------------------------------------------------------------------------------------------------------------------------------------------------------------------------------------------------------------------------------------------------------------------------------------------------------------------------------------------------------------------------------------------------------------------------------------------------------------------------------------------------------------------------------------------------------------------------------------------------------------------------------------------------------------------------------------------------------------------------------------------------------------------------------------------------------------------------------------------------------------------------------------------------------------------------------------------------------------------------------------------------------------------------------------------------------------------------------------------------------------------------------------------------------------------------------------------------------------------------------------------------------------
--------------------------------------------------------------------------------------------------------------------------------------------------------------------------------------------------------------------------------------------------------------------------------------------------------------------------------------------------------------------------------------------------------------------------------------------------------------------------------------------------------------------------------------------------------------------------------------------------------------------------------------------------------------------------------------------------------------------------------------------------------------------------------------------------------------------------------------------------------------------------------------------------------------------------------------------------------------------------------------------------------------------------------------------------------------------------------------------------------------------------------------------------------------------------------------------------------------------------------------------------------------------------------------------------------------------------------------------------------------------------------------------------------------------------------------------------------
----oo--------------------------oo--------------------------oo------------------------------------------------------oo------------------------------------------------------oo------------------------------------------------------oo--------------------------oo--------------------------oo--------------------------oo----------------------------------------------o-------oo--------------------------oo--------------------------oo--------------------------oo--------------------------oo------------------------------------------------------oo--------------------------oo--------------------------oo--------------------------oo--------------------------oo--------------------------oo------------------------------------------------------oo--------------------------oo--------------------------oo------------------------------------------------------oo--------------------------oo----------------------------------------------------------------------------------o---------------------------oo--------------------------oo------------------------------------------------------oo--------------------------oo--------------------------o---------------------------oo------------------------------------------------------ooo-------------------------ooo-------------------------ooo-------------------------oooS--------------------SSSSSSSSSSSSSSSS----------------oo--------------------------oo----------------------
----XXX------------------------XXXX-----------------------XXXXX--------------------E--------------------------------XX-----------------------------------------------------XXXX----------------------------------------------------XXXX-----------------------XXXXX--------------------E---XXXX-----------------------XXXXX--------------------E-----------------------XX------XXXX------------------------XXXX------------------------XXXX------------------------XXXX-----------------------XXXXXX-------------------------------------------XX------XXXX------------------------XXXX-------------------------XXX------------------------XXXX------------------------XXXX-------------------------XXX----------------------------------------------------XXXX-------------------------XXX------------------------XXXX-----------------------------------------------------XXX------------------------XXXX-------------------------------------------------------------------------------------------------------------XXX-------------------------XXX-----------------------------------------------------XX--------------------------XXX--------------------E-------------------------------XXXX-------------------------XXX-------------------------XXXX------------------------XXXX------------------------XXXX-----------------------XXXX-------------------------XXX------------------------XXXX------------------------XXXX---------------------
-----------------E----------------------------------------------------------------------------------E?o--------------------------?---------------------------?---------------------------?---------------------------E---------------------------?--------------------------------------------------------------------------------------------------------------E?---------------------------?---------------------------E---------------------------E-----------------------------------------------------------------------------------?---------------------------?---------------------------E---------------------------?---------------------------?---------------------------?---------------------------?---------------------------?---------------------------?---------------------------?---------------------------E---------------------------?---------------------------?---------------------------?---------------------------?---------------------------?-------------------------------------------------------?------X--------------------?------X--------------------?---------------------------?---------------------------?-------------------------------------------------------?------------------------------------------------------------------------------------------------------------------------------------------------------------------------------------------------------------------------------------------
-----------ooo---XSS----?--------------oo----ESS----SSS------------ooo---XXS----SSS-----------X-oo--XXXX----S--------------oo----XXS----SSS------------ooo---XXS----S-------------ooo---XXXS----SSS------------ooo---XSS----SS-------------ooo---XXS----SSS----------oooo----XX-----SSS----------oooo----E------SSSS---------oooo----XX-----SSS------------ooo--XXXX-------------------ooo---XXS----S--------------ooo---XXS----SSS------------ooo---XSS----SSS-----------Xooo---XXS----SSS----------ooooo---E------SSS?----------oooo--XXXS----?-------------Xooo---XXS----SSS------------ooo---XXS----SSS-----------Xooo---XXS----SSS-----------Xooo---XXS----SSS-----------Xooo---XXS----SSS----------oooo---XXX-----S-------------Xooo---XXS----S------------ooooo--XXXS----SS------------Xooo---XXS----S--------------oo----XXS----SSS-----------oooo---XXS----S-------------oooo---XXS----?-------------Xoo---XXXS----SS------------ooo---XXX-----?-------------Xoo----XXS----S-------------Xooo--XXX-----SSS----------oooo----XXS----?-------------Xooo---XXS----?-------------Xooo---XXS----?-------------oooo---XXS----S--------------oo---XXXS----SSS----------oooo----EXS----SSS-----------Xooo---XXS----SSS--------------------------SSS---------------------SSSSSSS------------------------SSSS--------------S---------SSSS------------------------SSSS------------oo-----------SQS---------oooo----E------SSSS---------oooo----XX-----SSS-
--------------------o---------------------------o-------------------------------------------------------o---------------------------o--------------------------oo---------------------------o--------------------------oo---------------------------o---------------------------o---------------------------o---------------------------o--------------------------ooo--------------------------o--------------------------oo---------------------------------------------------------------------------------------------------------------o-------------------------------------------------------o---------------------------------------------------------------------------------------------------------------o---------------------------o---------------------------------------------------------------------------------------------------------------o--------------------------oo------------------------------------------------------oo---------------------------o---------------------------o---------------------------o-------------------------------------------------------o---------------------------o-------------------------------------------------------o---------------------------o-------------------------------------------------------------------------------------------------------------------------------------------------------------------------------------------------------------------------------oo------
--------------------------------------------------------------------------------------------------------------------------------------------------------------------------------------------------------------------------------------------------------------------S---------------------------S---------------------------S-----------------------------------------------------------------------------------------------------------------------------------------------------------------------S--S------------------------------------------------------------------------------------------------------------------------------------------------------------------------------------------------------------------------------------------------------------------------------------------------------------------------------------------------------------------------------------------------------------------------------------------------------------------------------------------------------------------------------------------------------------------------------------------------------------------------------------------------------------------------------------------------------------------------------------------------------------------------------------------------------------S----------------------E----SS---------------------E----SS--------------------------SSS---------------------------------------------
-----------------------------------------------------------------?------------------------------------------------------------------------------------------------------------------------------------------XX------------------------------------------------------S---------E---------------SoS---------E-----------------S---------E-----------------------------------------------------------------------------------------------------------------------------------------------------------S-S---------E---------------------------------------------------------------------------------------------------------------------------------------------------------------------------------------------------------------------------------------------------------------------------------------------------------------------------------------------------------------------------------------------------------------------------------------------------------------------------------------------------------------------------------------------------------------------------------------------------------------------------------------------------------------------------------------------------------------------------E---------------------------E---------------------------E-----------------S---------E---------------SoS---------E--o------------SoS---------E--o------------SoS---------E-------------------------------------
-------------XXX----XXX------------------XXX----XXX------------------XXX----XXX--X---------------XXX----XXX------------------XXX----XXX-----XX-----------XXX---XXXX------------------XXX---XXXX--XX-XX-----------XXX----XXX--X---------------XXX----XXX-----X------SS----XX--<>-XXX--XXX-X-----SS--------<>-XX------X------SS----XX--<>-XXX--XXX-------------XXXX---XXX------------------XXX---XXXX-----XX-----------XXX----XXX------------------XXX----XXX--XXX-------------XXX----XXX--XX--------SS--------<>-X----E?X-------------XXX---XXXX------------------XXX---XXXX--XX--------------XXX---XXXX--XX--------------XXX----XXX--XX--------------XXX---XXXX--XXX-------------XXX---XXXX--X---X-----------XXX---XXXX--XXX-------------XXX---XXXX--XX-X------------XXX---XXXX--XXX-------------XXX---XXXX--XXX-------------XXX---XXXX--XXX-------------XXX----XXX--XX-X------------XXX---XXXX------------------XXX---XXXX--XXXX------------XXX---XXXX-----X------------XXX---XXXX--X---------------XXX----XXX-----XX-----------XXX---XXXX--XXXXX-----------XXX---XXXX--XX--------------XXX---XXXX--X---------------XXX---XXXX--XXX-------------XXX---XXXX--XXXXX-----------XXX---XXXX--XXXX------------XXX----XXX--XX------------------<>-----E--------------------<>-----E--------------------<>------E?S-----------------<>------E?S--S---SSS--------<>------E?S-SS---SSS--------<>------E?S------SSS--------<>------E?SXX-----------XXX----XXX-----
--Eo--------------E-----------Eo--------------E------------o--------------E------------o---------------------------o---------------------------o--------------------------Eo---------------------------o--------------------------Eo--------------------------oo-------------[]--------------------------[]-----------Eo-------------[]-----------Eo---------------------------o---------------------------o---------------------------o--------------------------Eo---------------------------o-------------[]-----------Eo---------------------------o---------------------------o---------------------------o--------------------------Eo---------------------------o---------------------------o--------------------------Eo---------------------------o--------------------------Eo---------------------------o--------------------------Eo--------------------------Eo--------------------------Eo--------------------------Eo--------------------------Eo---------------------------o--------------------------Eo--------------------------Eo--------------------------Eo--------------------------Eo-------------------------------------------------------o---------------------------o-----------------------------------------[]----<>--------------------[]----<>--------------------[]--------------------------[]------------o-------------[]-----E--------------------[]-----------oo-------------[]-----------Eo-------------oo---------
--XXXXXX---------<>-----------XXXXX----------<>-----------XXXXXX---------<>-----------XXXXXX---------<>-----------XXXXXX---------<>-----------XXXXXX----------------------XXXXX----------<>-----------XXXXXX----------------------XXXXXX---------<>-----------XXXXX----------[]-----------XXXXX----------[]-----------XXXXX----------[]-----------XXXXX-----------------E-----XXXXX-----------------------XXXXXX----------------------XXXXXX----------------------XXXXXX----------------------XXXXX----------[]-----------XXXXX-----------------------XXXXXX----------------------XXXXXX----------------------XXXXXX----------------------XXXXXX----------------------XXXXXX----------------------XXXXX-----------------------XXXXX-----------------------XXXXX-----------------------XXXXXX----------------------XXXXXX----------------------XXXXXX----------------------XXXXXX----------------------XXXXXX----------------------XXXXXX----------------------XXXXXX----------------------XXXXXX----------------------XXXXX-----------------------XXXXXX----------------------XXXXXX----------------------XXXXX-----------------------XXXXXX----------------------XXXXX-----------------------XXXXXX-------------------------------------[]----[]--------------------[]----[]--------------------[]------------XXXX----------[]-----------XXXXX----------[]-----------XXXX-----------[]-----------XXXXX----------[]-----------XXXXX----------[]---------
-----------------[]--------------------------[]--------------------------[]--------------------------[]--------------------------[]------------------------------------------------------[]------------------------------------------------------[]--------------------------[]--------------------------[]--------------------------[]----------------------------------------------------------------------------------------------------------------------------------------------------------------------[]--------------------------------------------------------------------------------------------------------------------------------------------------------------------------------------------------------------------------------------------------------------------------------------------------------------------------------------------------------------------------------------------------------------------------------------------------------------------------------------------------------------------------------------------------------------------------------------------------------------------------------------------------------------------------------------------------------------------E--E--[]----[]--------------E-EE--[]----[]--------------E-E---[]-------------------EE-----[]------------------E-E-----[]------------------E-------[]--------------------------[]--------------------------[]---------
----------XXX--XXXXXXX-XXXXX---------------XXXXXXXXXXXXX---------------XXXXXXXX-XXXXX----------X---XXXX--XXXXXXX---------------XXXXXXX-XXXXX---------------XXXX------XXX---------------XXXX-----XXXX---------------XXXX------XXX---------------XXXXXXX--XXXX-----------XX--XXXXXXXXXXXXX-----------XXXXXXXXXXXXXXXXX-----------XX--XXXXXXXXXXXXX-----------XX--XXXX--XXXXXXX---------------XXXX-----XXXX---------------XXXXXXX---XXX---------------XXXXXXX---XXX---------------XXXXXXX--XXXX----------XXXXXXXXXXXXXXXXXX---------------XXXX------XXX---------------XXXX-----XXXX---------------XXXXXXX---XXXX--------------XXXX------XXX---------------XXXX------XXX---------------XXXX------XXX---------------XXXX------XXX---------------XXXX-----XXXX---------------XXXX------XXX---------------XXXX------XXX---------------XXXX------XXX---------------XXXX-----XXXX---------------XXXX------XXX---------------XXXX-----XXXX---------------XXXX--X--XXXX---------------XXXX------XXX---------------XXXXXXX---XXX---------------XXXX------XXX----------------XXX-------XX----------------XXX------XXX---------------XXXX------XXXX--------------XXXX------XXX---------------XXXX-X----XXX---------------XXXX------XXXXXXX----XXXXXXXXXXXXXXXXXXXXXXX------XXXXXXXXXXXXXXXXXXXXXX-----XXXXXXXXXXXXXXXXXXXXXX-------XXXXXXXXXXXXXXXXXXX---------XXXXXXXXXXXXXXXXXXX---------XXXXXXXXXXXXXXXXXXX----------XXXXXXXXXXXXXXXXXX-----------XX--XXXXXXXXXXXXX
