--------------------------------------------------------------------------------------------------------------------------------------------------------------------------------------------------------------------------------------------------------------------------------------------------------------------------------------------------------------------------------------------------------------------------------------------------------------------------------------------------------------------------------------------------------------------------------------------------------------------------------------------------------------------------------------------------------------------------------------------------------------------------------------------------------------------------------------------------------------------------------------------------------------------------------------------------------------------------------------------------------------------------------------------------------------------------------------------------------------------------------------------------------------------------------------------------------------------------------------------------------------------------------------------------------------------------------------------------------------------------------------------------------------------------------------------------------
--------------------------------------------------------------------------------------------------------------------------------------------------------------------------------------------------------------------------------------------------------------------------------------------------------------------------------------------------------------------------------------------------------------------------------------------------------------------------------------------------------------------------------------------------------------------------------------------------------------------------------------------------------------------------------------------------------------------------------------------------------------------------------------------------------------------------------------------------------------------------------------------------------------------------------------------------------------------------------------------------------------------------------------------------------------------------------------------------------------------------------------------------------------------------------------------------------------------------------------------------------------------------------------------------------------------------------------------------------------------------------------------------------------------------------------------------------
----oo------------------------------------------------------oo--------------------------oo--------------------------oo--------------------------oo--------------------------oo--------------------------oo------------------------------------------------------oo--------------------------oo------------------------------------------------------oo--------------------------oo--------------------------oo--------------------------oo--------------------------oo--------------------------oo--------------------------oo--------------------------oo--------------------------oo--------------------------oo--------------------------oo--------------------------oo--------------------------oo--------------------------oo--------------------------ooo-----------------------------------------------------oo--------------------------oo--------------------------o---------------------------oo--------------------------oo--------------------------oo--------------------------oo--------------------------oo--------------------------oo--------------------------o---------------------------oo--------------------------oo--------------------------oo--------------------------oo--------------------------oo------------------------------------------------------oo------------------------------------------------------oo--------------------------oo--------------------------oo--------------------------oo----------------------
--XXXXX---------------------------------------------------XXXXXX-------------------E---XXXX-------------------------XXX------------------------XXXX------------------------XXXX--------------------E---XXXX----------------------------------------------------XXXX------------------------XXXX----------------------------------------------------XXXX------------------------XXXX-----------------------XXXXX--------------------E--XXXXX--------------------E--XXXXX--------------------E---XXXX------------------------XXXX-----------------------XXXXX------------------------XXXX------------------------XXXX------------------------XXXX-------------------------XX-------------------------XXXX-----------------------XXXXX--------------------E--XXXXXX-------------------------------------------X-------XXXX-------------------------XXX-----------------------------------------------------XXX-------------------------XXX-------------------------XXX------------------------XXXX-------------------------XXX------------------------XXXX-----------------------------------------------------XXX-------------------------XXX-------------------------XX--------------------------XXX------------------------XXXX-----------------------------------------------------XXX----------------------------------------------------XXXX-------------------------XXX------------------------XXXX------------------------XXXX---------------------
-----------------?---------------------------?---------------------------------------------------------------------------------------------------------------E---------------------------E---------------------------?---------------------------?---------------------------E---------------------------E---------------------------?---------------------------------------------------------------------------------------------------------------------------------------------------------------------------------------------------?-----------------------------------------------------------------------------------E---------------------------E---------------------------E---------------------------E-----------------------------------------------------------------------------------?---------------------------?---------------------------E---------------------------?---------------------------?---------------------------?---------------------------?---------------------------?---------------------------?---------------------------?---------------------------?---------------------------?---------------------------?-------------------------------------------------------E---------------------------?---------------------------?---------------------------?---------------------------?---------------------------?---------------------------?---------------------------?---------------------------?----------
----------ooo---XXXS----S--------------ooo---XXS----?-------------oooo---XSS----SSS------------ooo---EXS----SSS------------ooo---ESS----SSS------------ooo---XXS----SSS------------oo----XXS----SSS------------ooo---XXS----S-------------Xooo---XXS----S--------------ooo---XXS----SS-------------oo---XXXS----SSS-----------oooo--XXX-----?--------------ooo---XXS----SSS------------oo----ESS----SSS------------ooo---ESS----SSS----------oooo----XX-----SSS----------oooo---XXX-----SSS----------ooooo---E------SSSS----------oooo---XXS----?------------oooo----EX-----SSS------------ooo---ESS----SSS------------oo----XSS----SSS------------ooo---XXS----SSS------------oo----XXS----SSS-----------oooo---XXS----SSS----------ooooo--XXX-----SSS-------------o----------SSSSS----------oooo--XXXS----?-------------Xooo---XSS----S-S-------------oo---XXS----SSS-----------Xoo---XXXS----S-------------Xoo---XXXS----S-------------Xooo--XXXS----S-------------Xooo---XXS----S-------------oooo---XXS----SS------------oooo---XXS----?-------------Xooo---XXS----SSS-----------XXoo---XXSS---SSS----------oooo---XXX-----S-------------Xoo---XXXS----S--------------ooo---ESS----SSS------------ooo---XXS----SSS-----------Xoo---XXXS----SS------------Xoo---XXXS----S-------------Xoo---XXXS----S------------ooooo---XXS----S-------------Xooo---XXS----SSS-----------Xooo--XXXS----S-------------Xoo---XXXS----S-------------Xoo---XXXS----SS--
--------------------o---------------------------o-------------------------------------------------------o-------------------------------------------------------o---------------------------o------------------------------------------------------oo--------------------------oo---------------------------o--------------------------oo---------------------------o---------------------------o---------------------------o---------------------------o---------------------------o---------------------------o--------------------------oo---------------------------o---------------------------o--------------------------oo-----------------------------------------------------------------------------------o---------------------------o-------------------------------------------------------o------------------------------------------------------o--------------------------------------------------------o---------------------------o-------------------------------------------------------o---------------------------o-------------------------------------------------------------------------------------------------------------------------------------------o--------------------------oo---------------------------------------------------------------------------------------------------------------o-------------------------------------------------------o-------------------------------------------------------o-------
--------------------------------------------------------------------------------------------------------------------------------------------------------------------------------------------------------------------------------------------------------------------------------------------------------------------------------------------------------------------------------------------------------------------------------------------S-------------------------------------------------------S---------------------------------------------------------------------------------------------------------------------------------------------------------------------------------------------------------------------------------------------------------------------------------------------------------------------------------------------------------------------------------------------------------------------------------------------------------------------------------------------------------------------------------------------------------------------------------------------------------------------------------------------------------------------------------------------------------------------------------------------------------------------------------------------------------------------------------------------------------------------------------------------------------------------------------------------------
-------------------------------------------------------------------------------------------------------------------------------------------------------------------------------------------------------------------------------------------------------------------------------------------------------------------------------------------------------------------------------------------------------------------------------------------oS---------E---------------------------------------------S---------E-----------------------------------------------------------------------------------------------------------------------------------------------------------------------------------------------------------------------------------------------------------E-----------------------------------------------------------------------------------------------------------------------------------------------------------------------------------------------------------------------------------------------------------------------------------------------------------------------------------------------------------------------------------------------------------------------------------------------------------------------------------------------------------------------------------------------------------------------------------------------------------------------------------------------------------------------------
-------------XXX----XXX------------------XXX----XXX------------------XX-----XXX--XX-X------------XXX----XXX------------------XXX----XXX--X---------------XXX----XXX--X---X-----------XXX---XXXX--XXX-------------XXX----XXX-----X------------XXX----XXX------------------XXX---XXXX------------------XXX---XXXX--X---------------XXX---XXXX------------------XXX----XXX-----XX-----------XXX----XXX--XX--X-----------XX-----XXX--XXXX------SS----XX--<>-XXX--XXXXX-----------XX--<>-XXX--XX-XX-----SS----XX--<>-XX-------------------XXX----XXX------------------XX--<>-XXX--XXX-------------XXX----XXX------------------XXX----XXX------------------XXX---XXXX------------------XXX---XXXX--XXXXX-----------XXX----XXX--XX-X------------XX-----XXX--XX------------------<>------E?S-------------XXX----XXX------------------XXX---XXXX--X---------------XXX---XXXX------------------XXX---XXXX--XXX-------------XXX---XXXX--XX--------------XXX---XXXX-----X------------XXX---XXXX--XXXX------------XXX---XXXX--XXXXX-----------XXX---XXXX--XX--------------XXX----XXX--XX--------------XXX---XXXXX-XX--------------XXX---XXXX--XXX-------------XXX---XXXX--XXX-------------XXX---XXXX--XXX-------------XXX----XXX------------------XXX---XXXX--XXX-------------XXX---XXXX--XXX-------------XXX---XXXX--XX--------------XXX---XXXX--XXXXX-----------XXX---XXXX--XXX-------------XXX---XXXX--X---------------XXX---XXXX--XXX-------------XXX---XXXX--XX-
--Eo--------------E-----------Eo---------------------------o--------------E------------o--------------E------------o---------------------------o---------------------------o--------------------------Eo--------------------------Eo---------------------------o---------------------------o--------------E-----------Eo---------------------------o--------------E------------o--------------E------------o-------------<>-----------Eo-------------[]------------o-------------[]------------o-------------[]-----------Eo--------------E------------o-------------[]-----------Eo--------------E------------o--------------E------------o---------------------------o--------------------------Eo---------------------------o-------------XX------------o-------------[]-----------Eo---------------------------o---------------------------o--------------------------Eo---------------------------o---------------------------o--------------------------Eo---------------------------o--------------------------Eo--------------------------Eo--------------E---------------------------------------Eo--------------------------Eo---------------------------o--------------------------Eo--------------E-----------Eo--------------------------Eo--------------------------Eo--------------------------Eo---------------------------o--------------------------Eo---------------------------o---------------------------o------------------------
--XXXXXX---------<>-----------XXXXX-----------------------XXXXXX---------<>-----------XXXXXX---------<>-----------XXXXXX----------------------XXXXXX----------------------XXXXXX---------<>-----------XXXXXX----------------------XXXXXX----------------------XXXXXX----------------------XXXXXX---------<>-----------XXXXX-----------------------XXXXXX---------<>-----------XXXXXX---------<>-----------XXXXXX---------[]-----------XXXXXX---------[]-----------XXXXX----------[]-----------XXXXX----------[]-----------XXXXX----------<>-----------XXXXXX---------[]-----------XXXXXX---------<>-----------XXXXXX---------<>-----------XXXXXX----------------------XXXXXX----------------------XXXXXX----------------------XXXXXX---------[]-----------XXXXXX---------[]-----------XXXXX-----------------------XXXXXX----------------------XXXXX-----------------------XXXXXX----------------------XXXXXX----------------------XXXXX-----------------------XXXXXX----------------------XXXXXX----------------------XXXXX-----------------------XXXXXX---------<>-----------XXXXXX----------------------XXXXX-----------------------XXXXX-----------------------XXXXX-----------------------XXXXXX---------<>-----------XXXXXX----------------------XXXXX-----------------------XXXXX-----------------------XXXXX-----------------------XXXXXX----------------------XXXXX-----------------------XXXXXX----------------------XXXXXX--------------------
-----------------[]------------------------------------------------------[]--------------------------[]----------------------------------------------------------------------------------[]--------------------------------------------------------------------------------------------------------------[]------------------------------------------------------[]--------------------------[]--------------------------[]--------------------------[]--------------------------[]--------------------------[]--------------------------[]--------------------------[]--------------------------[]--------------------------[]--------------------------------------------------------------------------------------------------------------[]-----------------------E--[]--------------------------------------------------------------------------------------------------------------------------------------------------------------------------------------------------------------------------------------------------------------------------------------[]------------------------------------------------------------------------------------------------------------------------------------------[]-----------------------------------------------------------------------------------------------------------------------------------------------------------------------------------------------------------------------------------------
-----------XX--XXXXXXXXXXXXX-----------X---XXXX----XXXXX---------------XXXXXXXX-XXXX---------------XXXXXXXXXXXXXX--------------XXXXXXX--XXXX---------------XXXX-XX---XXX---------------XXXXXXX---XXX---------------XXXX------XXX---------------XXXX--X--XXXX---------------XXXX------XXX---------------XXXXXXX--XXXX---------------XXXX----XXXXX---------------XXXXXXX--XXXX---------------XXXXXXXXXXXXX---------------XXXXXXXX-XXXX-----------XX--XXXXXXXXXXXXX-----------X---XXXXXXXXXXXXX-----------XXX-XXXXXXXXXXXXX---------------XXXX--X--XXXX---------------XXXXXXXXXXXXX---------------XXXXXXX--XXXX---------------XXXXXXXXXXXXXX--------------XXXX-----XXXX---------------XXXX------XXX---------------XXXXXXX---XXX---------------XXXXXXXXXXXXX----------XXXXXXXXXXXXXXXXXX-----------X---XXXX----XXXXXX--------------XXXX------XXXX--------------XXXX------XXX---------------XXXX------XXX---------------XXXX------XXX---------------XXXX------XXX----------------XXX------XXX---------------XXXX------XXX-----------------XX------XXX---------------XXXXXXX--XXXXX----------------XX------XXX---------------XXXX------XXX---------------XXXX------XXX---------------XXXX-X----XXX---------------XXXXXXXXXXXXX---------------XXXX-----XXXX---------------XXXX------XXX---------------XXXX------XXX---------------XXXX------XXX----------------XXX------XXX---------------XXXX-----XXXX---------------XXXX------XXX---------------XXXX------XXX
