--------------------------------------------------------------------------------------------------------------------------------------------------------------------------------------------------------------------------------------------------------------------------------------------------------------------------------------------------------------------------------------------------------------------------------------------------------------------------------------------------------------------------------------------------------------------------------------------------------------------------------------------------------------------------------------------------------------------------------------------------------------------------------------------------------------------------------------------------------------------------------------------------------------------------------------------------------------------------------------------------------------------------------------------------------------------------------------------------------------------------------------------------------------------------------------------------------------------------------------------------------------------------------------------------------------------------------------------------------------------------------------------------------------------------------------------------------
--------------------------------------------------------------------------------------------------------------------------------------------------------------------------------------------------------------------------------------------------------------------------------------------------------------------------------------------------------------------------------------------------------------------------------------------------------------------------------------------------------------------------------------------------------------------------------------------------------------------------------------------------------------------------------------------------------------------------------------------------------------------------------------------------------------------------------------------------------------------------------------------------------------------------------------------------------------------------------------------------------------------------------------------------------------------------------------------------------------------------------------------------------------------------------------------------------------------------------------------------------------------------------------------------------------------------------------------------------------------------------------------------------------------------------------------------------
------------------------------------------------------------oo--------------------------oo--------------------------oo--------------------------oo--------------------------oo------------------------------------------------------o---------------------------oo--------------------------oo--------------------------oo--------------------------o---------------------------oo--------------------------oo--------------------------oo--------------------------oo--------------------------oo--------------------------oo--------------------------oo--------------------------o---------------------------oo--------------------------oo--------------------------oo--------------------------oo--------------------------oo--------------------------oo--------------------------oo------------------------------------------------------oo--------------------------oo--------------------------o---------------------------oo--------------------------oo--------------------------oo--------------------------oo------------------------------------------------------oo--------------------------oo--------------------------oo--------------------------oo--------------------------oo------------------------------------------------------oo--------------------------oo------------------------------------------------------oo------------------------------------------------------oo--------------------------oo----------------------
----------------------------------------------------------XXXXX--------------------E----XXX-------------------------XXX------------------------XXXX------------------------XXXX------------------------------------------------E----X---------------------------XXX-------------------------XXX------------------------XXXX-------------------------X--------------------------XXXX-----------------------XXXXXX-------------------E--XXXXXX----------------------XXXXXX----------------------XXXXX------------------------XXXX-----------------------XXXXX--------------------E----XXX------------------------XXXX------------------------XXXX-------------------------XXX------------------------XXXX-----------------------XXXXX------------------------XXXX-------------------------XXX----------------X---------------------------XX------XXXX-------------------------XXX----------------------------------------------------XXXX------------------------XXXX-------------------------XXX-------------------------XXX----------------------------------------------------XXXX-------------------------XXX------------------------XXXX-------------------------XXX-------------------------XXX----------------------------------------------------XXXX-------------------------XXX-----------------------------------------------------XXX----------------------------------------------------XXXX------------------------XXXX---------------------
----------------E??----------------------------------------------------------------------------------?---------------------------E-------------------------------------------------------?-------------------------------------------------------?---------------------------E---------------------------?-------------------------------------------------------E-------------------------------------------------------------------------------------------------------------------------------------------------------------------------------------------------------------------------------?-------------------------------------------------------E-------------------------------------------------------?-----------------------------------------------------------------------------------?--------------------------E?---------------------------E---------------------------?---------------------------?---------------------------E---------------------------?---------------------------?---------------------------?---------------------------?---------------------------?---------------------------?---------------------------?---------------------------?---------------------------?---------------------------?---------------------------?---------------------------?---------------------------?---------------------------?---------------------------?---------------------------?---------------------------?----------
-----------oo---XXXX----?-------------Xooo---ESS----?------------ooooo---XX----SSSS-----------Xooo--XXXS----S---------------oo---XXS----SSS------------ooo---ESS----SSS------------oo----XXS----SSS------------oo---XXX-----SS------------Xooo---XXS----?--------------ooo---XXS----SSS-----------Xooo---XXS----S-------------oooo---ESS----SSS------------ooo---XSS----SSS----------oooo----EX-----SSS------------oo----E-----SSSS-------------o----------SSSSS---------ooooo---XX-----SSS?-----------ooo---E------SSSS-----------oo----EXS----SSS-----------Xooo---ESS----SSS------------ooo---XXS----S---------------oo---XXS----SSS------------ooo---XSS----SSS-----------oooo---XXS----SS-------------ooo---XXS----SS-----------ooooo---XX-----SSS----------oooo----E------SSSS-----------oo---XXX-----?------------ooooo--XXX-----S------------ooooo---XXS----SS-----------oooo----XXS----S-------------Xoo---XXXS----S------------oooo----XXS----SSS------------oo---XXXS----S--------------ooo--XXXS----S-------------Xooo--XXXS----S-------------Xoo---XXXS----SS-----------oooo---XXX-----S-------------Xooo---XXS----S-------------oooo---XXS----S-------------oooo---XXS----S-------------Xooo---XXS----?------------ooooo---XXS----?-------------Xoo---XXX-----SSS----------oooo---XXX-----SS------------Xooo---XXS----S------------oooo----XXS----S-------------Xooo--XXXS----?-------------oooo---XXS----S------------oXoo---XXXS----S---
--------------------o--------------------------oo-------------------------------------------------------------------------------------------------------------------------------------------o--------------------------oo-------------------------------------------------------o-------------------------------------------------------o-------------------------------------------------------o-----------------------------------------------------------------------------------o---------------------------o--------------------------oo-----------XX------------------------------------------o---------------------------o------------------------------------------------------oo-------------------------------------------------------o---------------------------oo--------------------------o---------------------------o---------------------------o---------------------------o-----------------------------------------------------------------------------------o-----------------------------------------------------------------------------------o---------------------------o---------------------------o-------------------------------------------------------o--------------------------oo---------------------------o---------------------------o-----------------------------------------------------------------------------------o--------------------------oo---------------------------o-----------------------------------
------------------------------------------------------------------------------------------------------------------------------------------------------------------------------------------------------------------------------------------------------------------------------------------------------------------------------------------------------------------------------------------------------------------------------------------------------------------------------------------------------------------------------------------------------------------------------------------------------------------------------------------------------------------------------------------------------------------------------------S--S------------------------SS--------------------------------------------------------------------------------------------------------------------------------------------------------------------------------------------------------------------------------------------------------------------------------------------------------------------------------------------------------------------------------------------------------------------------------------------------------------------------------------------------------------------------------------------------------------------------------------------------------------------------------------------------------------------------------------
------------------------------------------------------------------------------------------------------------------------------------------------------------------------------------------------------------X-----------------------------------------------------------------------------------------------------------------------------------------------------------------------------------------------------------------------------------------E-----------------S---------E---------------------------E------------------------------------------------------------------------------------------------------X--------------------------------------------------------------------------------------------------------------S-------------------------SoS---------E-----------------------------------------------------------------------------------------------------------------------------------------------------------------------------------------------------------------------------------------------------------------------------------------------------------------------------------------------------------------------------------------------------------------------------------------------------------------------------------------------------------------------------------------------------------------------------------------------------------------------------------------------------------------------------
-------------XXX---XXXX-----X------------XXX----XXX------------------XX-----XXX--XXX-------------XXX---XXXXXXXX--------------XXX----XXX------------------XXX----XXX--X---------------XXX---XXXX--X--XX-----------XX----XXXX------------------XXX----XXX------------------XXX---XXXX--XXX-------------XXX---XXXX--X--XX-----------XXX----XXX--XXX-------------XXX---XXXX--X--XX-----------XX-----XXX--XXX-------------XX--<>-XXX--XXX-----------------<>-XX---E?S-------------XX--<>-XXX--E?--------------XX--<>-XXX-----XX-----------XXX----XXX--X---------------XXX----XXXX-XX--------------XXX----XXX------------------XXX----XXX------------------XXX----XXX-----XX-----------XXX----XXX------------------XXX---XXXX--XX-XX-----SS----XX-----XXX--XXXXXS---SSS----XX--<>----------------------XXX---XXXX------------------XXX---XXXX-----XX-----------XXX---XXXX--XXXXX-----------XXX---XXXX--XXX-------------XXX---XXXX-----X------------XXX---XXXX--XXX-------------XXX---XXXX------------------XXX---XXXX--XX--------------XXX---XXXX--XXXX------------XXX----XXX--X--X------------XXX---XXXX--XXX-------------XXX---XXXX--XX-XX-----------XXX---XXXX--XX--------------XXX---XXXX--X--XX-----------XXX---XXXX-----X------------XXX---XXXX--XXX-------------XXX---XXXX--XX--X-----------XXX---XXXX--XX--------------XXX---XXXX--XX-XX-----------XXX---XXXX--XX--------------XXX---XXXX-----X------------XXX---XXXX--XXX-------------XXX---XXXX--XXX
--Eo---------------------------o---------------------------o-------------XX-----------Eo---------------------------o---------------------------o---------------------------o---------------------------o--------------------------Eo---------------------------o---------------------------o---------------------------o---------------------------o---------------------------o--------------E--------------------------[]------------o-------------[]-----------Eo-------------[]------------o-------------[]------------o--------------E------------o--------------------------Eo---------------------------o--------------E------------o---------------------------o--------------------------Eo---------------------------o--------------E------------o-------------[]-----E-----Eo--------------------------Eo---------------------------o--------------------------Eo--------------------------Eo--------------------------Eo--------------------------Eo--------------------------Eo--------------------------Eo--------------------------Eo--------------------------Eo--------------------------Eo---------------------------o--------------------------Eo---------------------------o--------------------------Eo--------------------------Eo---------------------------o--------------------------Eo--------------------------Eo--------------------------Eo--------------------------Eo--------------------------Eo------------------------
--XXXXX-----------------------XXXXXX----------------------XXXXXX---------[]-----------XXXXXX----------------------XXXXXX---------<>-----------XXXXXX----------------------XXXXXX----------------------XXXXX----------<>-----------XXXXXX----------------------XXXXX-----------------------XXXXXX----------------------XXXXX----------<>-----------XXXXXX----------------------XXXXX----------<>-----------XXXXXX---------[]-----------XXXXX----------[]-----------XXXXXX---------[]-----------XXXXX----------[]-----------XXXXXX---------<>-----------XXXXXX---------<>-----------XXXXX-----------------------XXXXXX---------<>-----------XXXXXX----------------------XXXXX----------<>-----------XXXXXX----------------------XXXXX----------<>-----------XXXXX----------[]----<>-----XXXXX-----------------------XXXXX-----------------------XXXXXX----------------------XXXXXX----------------------XXXXXX----------------------XXXXX-----------------------XXXXX-----------------------XXXXX-----------------------XXXXX-----------------------XXXXXX----------------------XXXXX-----------------------XXXXXX----------------------XXXXXX----------------------XXXXX-----------------------XXXXXX----------------------XXXXX-----------------------XXXXX-----------------------XXXXX-----------------------XXXXXX----------------------XXXXXX----------------------XXXXX-----------------------XXXXX-----------------------XXXXX---------------------
-------------------------------------------------------------------------[]------------------------------------------------------[]----------------------------------------------------------------------------------[]--------------------------------------------------------------------------------------------------------------[]------------------------------------------------------[]--------------------------[]-----------------------E--[]--------------------------[]--------------------------[]--------------------------[]--------------------------[]------------------------------------------------------[]------------------------------------------------------[]------------------------------------------------------[]--------------------------[]----[]-----------------------------------------------------------------------------------------------------------------------------------------------------------------------------------------------------------------------------------------------------------------------------------------------------------------------------------------------------------------------------------------------------------------------------------------------------------------------------------------------------------------------------------------------------------------------------------------------------------------------------------------------------------------------
-----------X---XXXX-----XXXX-----------------X-------XXX---------------XXXXXXXXXXXXX-----------------XX------XXXX--------------XXXX------XXX---------------XXXXXXX---XXX---------------XXXX-----XXXX---------------XXXXXXX---XXX---------------XXXX------XXX---------------XXXX------XXX----------------XXX------XXX---------------XXXXXXX---XXX---------------XXXX------XXX---------------XXXXXXXX-XXXX---------------XXXXXXXXXXXXX----------XXXXXXXXXXXXXXXXXX-----------XX--XXXXXXXXXXXXX-----------XX--XXXXXXXXXXXXX---------------XXXXXXXX-XXXX---------------XXXXXXX---XXX-----------X---XXXX----XXXXX---------------XXXXXXXX-XXXXX--------------XXXX-XX--XXXX---------------XXXXXXXX-XXXX---------------XXXX------XXX---------------XXXXXXXXXXXXX----------XXXXXXXXXXXXXXXXXX-----------XX--XXXX----XXXXX-----------------XX------XXX---------------XXXX------XXX---------------XXXX------XXX----------------XXX------XXX---------------XXXX------XXX---------------XXXX-----XXXX---------------XXXX------XXX---------------XXXX------XXX---------------XXXX------XXX---------------XXXX------XXX---------------XXXX------XXX---------------XXXX------XXX---------------XXXX-----XXXX----------------XXX------XXX----------------XXX------XXX---------------XXXX-XX--XXXX---------------XXXX------XXX----------------XXX------XXX---------------XXXX------XXX---------------XXXX-----XXXX---------------XXXX------XXX---------------XXXX------XXX
