--------------------------------------------------------------------------------------------------------------------------------------------------------------------------------------------------------------------------------------------------------------------------------------------------------------------------------------------------------------------------------------------------------------------------------------------------------------------------------------------------------------------------------------------------------------------------------------------------------------------------------------------------------------------------------------------------------------------------------------------------------------------------------------------------------------------------------------------------------------------------------------------------------------------------------------------------------------------------------------------------------------------------------------------------------------------------------------------------------------------------------------------------------------------------------------------------------------------------------------------------------------------------------------------------------------------------------------------------------------------------------------------------------------------------------------------------------
--------------------------------------------------------------------------------------------------------------------------------------------------------------------------------------------------------------------------------------------------------------------------------------------------------------------------------------------------------------------------------------------------------------------------------------------------------------------------------------------------------------------------------------------------------------------------------------------------------------------------------------------------------------------------------------------------------------------------------------------------------------------------------------------------------------------------------------------------------------------------------------------------------------------------------------------------------------------------------------------------------------------------------------------------------------------------------------------------------------------------------------------------------------------------------------------------------------------------------------------------------------------------------------------------------------------------------------------------------------------------------------------------------------------------------------------------------
----oo--------------------------oo--------------------------oo--------------------------oo--------------------------oo--------------------------oo--------------------------oo--------------------------oo--------------------------oo--------------------------oo--------------------------oo--------------------------oo--------------------------oo--------------------------oo--------------------------oo--------------------------oo--------------------------oo--------------------------oo--------------------------oo--------------------------oo--------------------------oo------------------------------------------------------oo--------------------------o---------------------------oo--------------------------oo--------------------------oo----------------------------------------------o-------o---------------------------o---------------------------oo--------------------------oo--------------------------oo--------------------------oo--------------------------oo--------------------------o-------------------------------------------------------oo--------------------------oo--------------------------o---------------------------oo--------------------------oo--------------------------oo--------------------------oo--------------------------oo------------------------------------------------------oo--------------------------oo--------------------------oo--------------------------oo----------------------
----XXX------------------------XXXX-----------------------XXXXX--------------------E---XXXX------------------------XXXX------------------------XXXX--------------------E----XXX-------------------------XXX-------------------------XXX-------------------------XXX-------------------------XXX------------------------XXXX--------------------E----XX-------------------------XXXX-----------------------XXXXX--------------------E--XXXXXX-------------------E--XXXXXX----------------------XXXXXX----------------------XXXXX-----------------------XXXXX--------------------E--XXXXX--------------------E----XX--------------------------X------------------------------------------------------XXXX------------------------XXXX------------------------XXXXX-------------------------------------------XX-------XXX----------------------------------------------------XXXX------------------------XXXX------------------------XXXX-------------------------XXX-------------------------XXX---------------------------------------------------------------------------------XXX------------------------XXXX-----------------------------------------------------XXX------------------------XXXX-------------------------XXX------------------------XXXX-------------------------XXX----------------------------------------------------XXXX-------------------------XXX-------------------------XXX------------------------XXXX---------------------
-----------------?-----------------------------------------------------------------------------------?---------------------------E-------------------------------------------------------?---------------------------?---------------------------E---------------------------E---------------------------E---------------------------E---------------------------?---------------------------E-------------------------------------------------------------------------------------------------------------------------------------------------------------------------------------------------------------------------------?---------------------------?---------------------------?---------------------------?-----------------------------------------------------------------------------------?---------------------------?---------------------------E---------------------------E---------------------------?---------------------------?---------------------------?---------------------------?---------------------------?---------------------------?---------------------------?---------------------------?---------------------------?---------------------------?---------------------------E---------------------------?-------------------------------------------------------?------X--------------------?---------------------------?---------------------------?---------------------------?---------------------------?----------
-----------ooo--XXXS----?---------------oo---XXS----SSS----------ooooo---XX-----SSS------------ooo---XXS----S--------------ooo---XSS----SS-------------oo----ES-----SSS------------ooo---XXS----?-------------Xooo---XXS----S--------------oo----XXS----SS-------------ooo---XXS----SS------------Xooo---XXS----SSS------------ooo---XXS----SSS-----------Xooo---XSS----S-S-------------oo---XXS----SSS-----------Xooo---XXS----SSS----------ooooo---EX-----SSSS------------o----E-----SSSSS---------ooooo---XX-----SSS------------oo----XX-----SSS-------------oo---SSSS---SSS-----------ooo----XX----SSSS------------ooo--XXXS----?-------------Xooo---XXS----SSS-----------Xooo---XSS----SSS-----------Xoo----XXS----SSS------------oo----XXS----SSS------------oo-----------SSS------------ooo--XXX-------------------Xooo--XXXS----?-------------Xooo---XXS----SS------------ooo----XXS----SSS----------ooooo---XXS----S-------------Xooo---XXS----SSS----------ooooo---XXS----S-------------ooo---XXXS----S-------------Xooo---XXS----?-------------Xooo--XXXS----?-------------Xoo----XXS----S-------------Xooo--XXXS----SSS-----------Xoo----XXS----S-------------ooo----XXS----S-------------oooo---XXS----SS------------Xooo---XXS----S------------oooo----XX-----SS------------ooo----XXS----S-------------Xooo--XXXS----?-------------Xooo---XXS----SSS-----------Xooo---XXS----S-------------Xooo---XXS----S--------------ooo--XXXS----SSS-
--------------------o---------------------------o-----------------------------------------------------------------------------------o---------------------------o--------------------------oo---------------------------o--------------------------oo--------------------------oo---------------------------o-------------------------------------------------------o-------------------------------------------------------------------------------------------------------------------------------------------o---------------------------o-----------------------------------------------------------------------------------o-----------------------------------------------------------------------------------o---------------------------o------------------------------------------------------ooo--------------------------o--------------------------oo---------------------------o---------------------------o-------------------------------------------------------o---------------------------o---------------------------o---------------------------o-------------------------------------------------------o---------------------------o---------------------------o-------------------------------------------------------o-----------------------------------------------------------------------------------o---------------------------o-------------------------------------------------------------------------------------------
----------------------------------------------------------------------------------------------------------------------------------------------------------------------------------------------------------------------------------------------------------------------------------------------------------------------------------------------------------------------------------------------------------------------------------------------------------------------------------------------------S-----------------------------------------------------------------------------------------------------------------------------------------------------------------------------------------------------------------------------------------------------------SS--------------------------------------------------------------------------------------------------------------------------------------------------------------------------------------------------------------------------------------------------------------------------------------------------------------------------------------------------------------------------------------------------------------------------------------------------------------------------------------------------------------------------------------------------------------------------------------------------------------------------------------------------------------------------------------
-----------------------------------------------------------------------------------------------------------------------------------------------------------------------------------------------------------------------------------------------------------------------------------------------------------------------------X------------------------------------------------------------------------------------------------------------------------E---------------------------E-----------------S---------E---------------------------E------------------X------------------------------------------------------------------------------------------------------------------------------------------------------------------------------------------------S-S---------E--o--------------------------------------------------------------------------------------------------------------------------------------------------------------------------------------------------------------------------------------------------------------------------------------------------------------------------------------------------------------------------------------------------------------------------------------------------------------------------------------------------------------------------------------------------------------------------------------------------------------------------------------------------------------------------
-------------XXX----XXX------------------XXX----XXX------------------XX--<>-XXX--XXX-------------XXX----XXX------------------XXX----XXX-----XX-----------XX-----XXX--X---------------XXX----XXX------------------XXX----XXX-----XX-----------XXX----XXX------------------XXX----XXX------------------XXX----XXX--XX--X-----------XXX----XXX--XX--------------XXX----XXX------------------XXX---XXXX-----XX-----------XXX----XXX--XXX-------------XX--<>-XXX--X?X-----------------<>-X----E?XXX-----SS----XX--<>-XXX--E?X-------------XX--<>-XXX------------------XXX----XXX------------------XX--<>-XXX--XXX-------------XXX---XXXX------------------XXX---XXXX--X---------------XXX---XXXX--X---------------XXX---XXXX--XXX-------------XXX---XXXX--XX--------SS--------<>------E?S-------------XXX----XXX------------------XXX---XXXX------------------XXX----XXX-----XX-----------XXX---XXXX--XXXX------------XXX---XXXX--XX--------------XXX---XXXX--XX-X------------XXX---XXXX--XXXX------------XXX---XXXX--XX-X------------XXX---XXXX--XX--------------XXX---XXXX------------------XXX---XXXX--XXX-------------XXX---XXXX------------------XXX----XXX--XX--------------XXX---XXXX--XXXXX-----------XXX---XXXX--XXX-------------XXX---XXXX--XX-XX-----------XXX---XXXX--XXX-------------XXX---XXXX--XXX-------------XXX----XXX------------------XXX---XXXX--X---------------XXX---XXXX--XX--------------XXX---XXXX--XXX-------------XXX---XXXX--XX-
--Eo---------------------------o---------------------------o-------------[]-----------Eo---------------------------o---------------------------o--------------E-----------Eo--------------------------Eo---------------------------o--------------E-----------Eo--------------E-----------Eo---------------------------o--------------------------Eo---------------------------o---------------------------o--------------E------------o-------------[]------------o-------------[]------------o-------------[]------------o-------------[]---------------------------E------------o-------------[]-----------Eo---------------------------o---------------------------o---------------------------o---------------------------o---------------------------o-------------[]-----------Eo--------------E-----------Eo---------------------------o---------------------------o--------------------------Eo---------------------------o--------------------------Eo---------------------------o--------------------------Eo--------------------------Eo--------------------------Eo---------------------------o--------------------------Eo--------------------------Eo---------------------------o--------------------------Eo---------------------------o--------------------------Eo--------------------------Eo--------------------------Eo---------------------------o--------------------------Eo---------------------------o------------------------
--XXXXX-----------------------XXXXX-----------------------XXXXX----------[]-----------XXXXXX----------------------XXXXXX----------------------XXXXX----------<>-----------XXXXXX----------------------XXXXXX----------------------XXXXXX---------<>-----------XXXXXX---------<>-----------XXXXX-----------------------XXXXXX----------------------XXXXXX----------------------XXXXXX----------------------XXXXXX---------<>-----------XXXXXX---------[]-----------XXXXX----------[]-----------XXXXXX---------[]-----------XXXXX----------[]------------XXXXX---------<>-----------XXXXX----------[]-----------XXXXX-----------------------XXXXXX----------------------XXXXXX----------------------XXXXXX----------------------XXXXX----------<>-----------XXXXX----------[]-----------XXXXX----------<>-----E-----XXXXXX----------------------XXXXXX----------------------XXXXXX----------------------XXXXXX----------------------XXXXXX----------------------XXXXX-----------------------XXXXXX----------------------XXXXXX----------------------XXXXXX----------------------XXXXX-----------------------XXXXX-----------------------XXXXX-----------------------XXXXXX----------------------XXXXXX----------------------XXXXXX----------------------XXXXX-----------------------XXXXX-----------------------XXXXXX----------------------XXXXXX----------------------XXXXXX----------------------XXXXXX----------------------XXXXXX--------------------
-------------------------------------------------------------------------[]----------------------------------------------------------------------------------[]----------------------------------------------------------------------------------[]--------------------------[]------------------------------------------------------------------------------------------------------------------------------------------[]--------------------------[]--------------------------[]--------------------------[]--------------------------[]--------------------------[]--------------------------[]------------------------------------------------------------------------------------------------------------------------------------------[]------------------E-------[]--------------------------[]-------------------------------------------------------------------------------------------------------------------------------------------------------------------------------------------------------------------------------------------------------------------------------------------------------------------------------------------------------------------------------------------------------------------------------------------------------------------------------------------------------------------------------------------------------------------------------------------------------------------------------------------------
-----------X---XXXX----XXXXXX----------X---XXXX-XX-XXXXX---------------XXXXXXXXXXXXX-----------X---XXXX-----XXXX---------------XXXX------XXX---------------XXXXXXXX-XXXX---------------XXXX-----XXXX---------------XXXX-----XXXX---------------XXXXXXX--XXXX---------------XXXXXXX--XXXX---------------XXXX-----XXXX---------------XXXXXXX---XXX---------------XXXX-----XXXXX--------------XXXXXXX--XXXX---------------XXXXXXX---XXX---------------XXXXXXXXXXXXX----------XXXXXXXXXXXXXXXXXX-----------XX--XXXXXXXXXXXXX-----------XX--XXXXXXXXXXXXXX--------------XXXXXXXX-XXXX---------------XXXXXXXXXXXXX---------------XXXX-----XXXX----------------XXX------XXXX--------------XXXX------XXX---------------XXXX------XXX---------------XXXXXXX---XXX----------XXXXXXXXXXXXXXXXXX-----------XX--XXXX--XXXXXXX----------------XXX------XXX---------------XXXX------XXX---------------XXXX------XXX---------------XXXX------XXX---------------XXXX------XXX---------------XXXX------XXX---------------XXXX------XXX-----------------XX------XXX----------------XXX------XXX---------------XXXX------XXX---------------XXXX------XXX---------------XXXX-----XXXX---------------XXXX------XXX---------------XXXX------XXX---------------XXXX------XXX---------------XXXX------XXX---------------XXXX------XXX---------------XXXX-----XXXX---------------XXXX-----XXXX---------------XXXX------XXX---------------XXXX------XXXX--------------XXXX------XXX
