--------------------------------------------------------------------------------------------------------------------------------------------------------------------------------------------------------------------------------------------------------------------------------------------------------------------------------------------------------------------------------------------------------------------------------------------------------------------------------------------------------------------------------------------------------------------------------------------------------------------------------------------------------------------------------------------------------------------------------------------------------------------------------------------------------------------------------------------------------------------------------------------------------------------------------------------------------------------------------------------------------------------------------------------------------------------------------------------------------------------------------------------------------------------------------------------------------------------------------------------------------------------------------------------------------------------------------------------------------------------------------------------------------------------------------------------------------
--------------------------------------------------------------------------------------------------------------------------------------------------------------------------------------------------------------------------------------------------------------------------------------------------------------------------------------------------------------------------------------------------------------------------------------------------------------------------------------------------------------------------------------------------------------------------------------------------------------------------------------------------------------------------------------------------------------------------------------------------------------------------------------------------------------------------------------------------------------------------------------------------------------------------------------------------------------------------------------------------------------------------------------------------------------------------------------------------------------------------------------------------------------------------------------------------------------------------------------------------------------------------------------------------------------------------------------------------------------------------------------------------------------------------------------------------------
----oo--------------------------oo--------------------------oo--------------------------oo--------------------------oo--------------------------oo--------------------------oo--------------------------oo------------------------------------------------------oo--------------------------oo--------------------------o---------------------------oo--------------------------oo--------------------------oo--------------------------oo--------------------------oo--------------------------oo--------------------------o---------------------------oo--------------------------oo--------------------------oo--------------------------oo------------------------------------------------------oo--------------------------oo--------------------------oo--------------------------oo------------------------------------------------------o---------------------------oo--------------------------oo--------------------------oo--------------------------oo------------------------------------------------------oo------------------------------------------------------oo--------------------------o-------------------------------------------------------o---------------------------o---------------------------oo--------------------------oo--------------------------oo--------------------------oo--------------------------oo--------------------------oo------------------------------------------------------oo----------------------
---XXXX------------------------XXXX-----------------------XXXXX--------------------E---XXXX------------------------XXXX------------------------XXXX------------------------XXXX-------------------------XXX----------------------------------------------------XXXX-------------------------XXX---------------------------------------------------XXXXX--------------------E---XXXX------------------------XXXX--------------------E---XXXX-----------------------XXXXXX----------------------XXXXX------------------------XXXX-----------------------XXXXX------------------------XXXX--------------------E---XXXX------------------------XXXX----------------------------------------------------XXXX------------------------XXXX------------------------XXXXX------------------------XXX-----------------------------------------------------X--------------------------XXXX------------------------XXXX------------------------XXXX------------------------XXXX-----------------------------------------------------XX------------------------------------------------------XXX---------------------------------------------------------------------------------XX--------------------------X---------------------------XXX-------------------------XXX-------------------------XX-------------------------XXXX------------------------XXXX-------------------------XXX-----------------------------------------------------XXX---------------------
-----------------E---------------------------??----------------------------------------------------------------------------------E-------------------------------------------------------?---------------------------E---------------------------E---------------------------?---------------------------?---------------------------?-------------------------------------------------------?-------------------------------------------------------------------------------------------------------------------------------------------------------------------------------------------------------------------------------E---------------------------E---------------------------?---------------------------E---------------------------?-------------------------------------------------------?---------------------------?---------------------------E---------------------------?---------------------------E---------------------------?---------------------------?---------------------------E---------------------------?---------------------------?---------------------------?---------------------------?---------------------------?---------------------------?---------------------------?---------------------------?---------------------------?---------------------------?---------------------------?---------------------------?---------------------------?---------------------------?---------------------------?----------
----------ooo---XXX-----SSS-----------Xooo--XXXS----S-------------oooo---ESS----SSS------------ooo---SSS----SSS------------ooo---XXS----SS-------------ooo---EXS----SSS------------ooo---XXS----S--------------ooo---XSS----SSS-------------o---XXXS----SS------------Xoo----XXS----SSS-----------Xooo--XXXS----SS------------Xoo---XXXS----SS--------------o---XXX-----SSS------------ooo---XXS----S---------------oo---XSS----SSS----------ooooo---E------SSS----------oooo----XX-----SSSS---------oooo----XX-----oS-------------ooo---XXS----?--------------ooo---SSS----SSS-----------Xooo---ESS----SSS------------ooo---XSS----S--------------oo----XXS----SSS------------ooo---XXS----SS-------------oo----XXS----SSS-----------Xooo---XSS----SSS----------oooo-----------SSSS----------ooo---XXX-----?-------------Xooo--XXXS----?-------------oooo---XXS----S--------------oo---XXXS----SS------------Xooo---XXS----SSS-----------oooo--XXXS----SS-----------ooooo--XXXS----SS------------Xoo----XXS----SS------------ooo----XXS----S--------------oo----XXS----SS------------Xoo----XXS----SSS-----------Xooo---XXS----S-------------Xooo--XXX-----?-------------Xoo---XXX-----SS-----------oooo----XXS----S--------------ooo--XXXS----S-------------Xoo---XXXS----S------------ooooo---XXS----S-------------Xooo---XXS----SSS-----------Xoo---XXXS----SS------------oooo---XXS----S-------------oooo--XXX-----?-------------Xooo---XXS----SSS-
--------------------o---------------------------o----------------------------------------------------------------------------------oo---------------------------o---------------------------o---------------------------o--------------------------oo---------------------------o---------------------------o---------------------------o-----------------------------------------------------------------------------------o-------------------------------------------------------o---------------------------o--------------------------ooo----------------------------------------------------------------------------------o------------------------------------------------------oo---------------------------------------------------------------------------------------------------------------o---------------------------o---------------------------o-----------------------------------------------------------------------------------o-----------------------------------------------------------------------------------o---------------------------o----------------------------------------------------------------------------------oo---------------------------o---------------------------o--------------------------oo-------------------------------------------------------------------------------------------------------------------------------------------o--------------------------ooo----------------------------------
--------------------------------------------------------------------------------------------------------------------------------------------------------------------------------------------------------------------------------------------------------------------------------------------------------------------------------------------------------------------------------------------------------------------------------------------S--S----------------------------------------------------S-----------------------------------------------------------------------------------------------------------------------------------------------------------------------------------------------------------------------------------------------------------S---------------------------------------------------------------------------------------------------------------------------------------------------------------------------------------------------------------------------------------------------------------------------------------------------------------------------------------------------------------------------------------------------------------------------------------------------------------------------------------------------------------------------------------------------------------------------------------------------------------------------------------------------------------------------------------
----------------------------------------------------------------------------------------------------------------------------------------------------------------------------------------------------------------------------------------X----X--------------------------------------------------------------------------------------------------------------Q-----------------------------------------------------------------------------S-S---Q-----E---------------------------E---------------SoS--------------------------------------------------------?------------------------------------------------------------------------------------------------------------------------------------------------------------------------------------------------S-S---------E-------------------------------------------------------------------------------------------------------------------------------------------------------------------------------------------------------------------------------------------------------------------------------------------------------------------------------------------------------------------------------------------------Q---------------------------------------------------------------------------------------------------------------------------------------------------------------------------------------------------------------------------------------------------------------------------
-------------XX--<>-XXX------------------XXX----XXX-----XX-----------XX-----XXX--XXX-------------XXX----XXX------------------XXX---XXXX------X-----------XXX----XXX--X---------------XXX---XXXX------------------XXX----XXX--XX-------------XXXX---XXXX------------------XXX----XXX--XX--------------XXX---XXXX------------------XXX----XXX------------------XX-----XXX------------------XXX----XXX------------------XXX----XXX------------SS--------<>------E?X-------------XX--<>-XXX--E--XX----SSS----XX--<>-XXX--XXXX------------XXX----XXX------------------XXX----XXX------------------XXX----XXX--XX--------------XXX----XXX------------------XXX---XXXX--XXX-------------XXX----XXX------------------XXX---XXXX--XX--------------XXX---XXXX--XXX-------SS--------<>------E?S-------------XXX----XXX------------------XXX---XXXX-----X------------XXX---XXXX--XX--------------XXX---XXXX--XX--------------XXX----XXX--XXX-------------XXX---XXXX--XX--------------XXX---XXXX--XX--------------XXX---XXXX--XXX-------------XXX---XXXX--XXX-------------XXX----XXX------------------XXX---XXXX--XXXX------------XXX---XXXXX-XXX-------------XXX---XXXX------------------XXX---XXXX--X--XX-----------XXX---XXXX--XXX-------------XXX---XXXX------------------XXX---XXXX--XXX-------------XXX---XXXX--XXX-------------XXX---XXXX--XXX-------------XXX---XXXX--XXXX------------XXX---XXXX--XXXX------------XXX----XXX------------------XXX---XXXX--XXX
--Eo-------------[]-----------Eo-----------------------------------------<>------------o---------------------------o---------------------------o--------------E-----------Eo---------------------------o------------------------------------------------------Eo--------------E-----------Eo--------------------------Eo---------------------------o--------------E------------o---------------------------o--------------E-----------oo-------------[]------------o-------------[]-----------Eo-------------[]------------o--------------E------------o--------------E-----------Eo---------------------------o---------------------------o---------------------------o---------------------------o---------------------------o-----------------------------------------[]-----------Eo--------------------------Eo--------------------------Eo---------------------------o---------------------------o--------------------------Eo--------------------------Eo---------------------------o--------------------------Eo--------------------------Eo--------------E-----------Eo--------------------------Eo--------------------------Eo--------------------------Eo--------------------------Eo---------------------------o--------------------------Eo--------------------------Eo---------------------------o---------------------------o--------------------------Eo--------------------------Eo--------------------------Eo------------------------
--XXXXXX---------[]-----------XXXXXX----------------------XXXXXX---------[]-----------XXXXXX----------------------XXXXXX----------------------XXXXXX---------<>-----------XXXXXX----------------------XXXXXX-----------------------XXXX-----------------------XXXXXX---------<>-----------XXXXXX----------------------XXXXXX----------------------XXXXXX---------<>-----------XXXXXX----------------------XXXXXX---------<>-----------XXXXX----------[]-----------XXXXX----------[]-----------XXXXX----------[]-----------XXXXXX---------<>-----------XXXXXX---------<>-----------XXXXXX----------------------XXXXXX----------------------XXXXXX---------<>-----------XXXXXX----------------------XXXXXX----------------------XXXXXX----------------------XXXX-----------[]-----------XXXXX-----------------------XXXXX-----------------------XXXXXX----------------------XXXXX-----------------------XXXXXX----------------------XXXXXX----------------------XXXXX-----------------------XXXXX-----------------------XXXXX-----------------------XXXXX----------<>-----------XXXXXX----------------------XXXXXX----------------------XXXXX-----------------------XXXXX-----------------------XXXXX-----------------------XXXXX-----------------------XXXXXX----------------------XXXXX-----------------------XXXXXX----------------------XXXXX-----------------------XXXXXX----------------------XXXXX-----------------------XXXXXX--------------------
-----------------[]------------------------------------------------------[]----------------------------------------------------------------------------------[]--------------------------------------------------------------------------------------------------------------[]----------------------------------------------------------------------------------[]------------------------------------------------------[]--------------------------[]--------------------------[]--------------------------[]--------------------------[]--------------------------[]----------------------------------------------------------------------------------[]--------------------------------------------------------------------------------------------------------------[]--------------------------------------------------------------------------------------------------------------------------------------------------------------------------------------------------------------------------------------------------------------------------------------[]-------------------------------------------------------------------------------------------------------------------------------------------------------------------------------------------------------------------------------------------------------------------------------------------------------------------------------------------------------------------------------------
-----------XX--XXXXXXXXXXXXXX--------------XXXX-----XXXX---------------XXXXXXXX-XXXX---------------XXXXXXX--XXXX---------------XXXX-----XXXX---------------XXXXXXX--XXXX---------------XXXX-----XXXX---------------XXXX-X----XXXX--------------XXXX------XXX---------------XXXXXXX--XXXX---------------XXXX-XX--XXXX---------------XXXX-----XXXXX--------------XXXXXXXX-XXXX---------------XXXXXXX---XXXX--------------XXXXXXXXXXXXX-----------XXXXXXXXXXXXXXXXX-----------XX--XXXXXXXXXXXXX------------X--XXXXXXXXXXXXX---------------XXXXXXXXXXXXX---------------XXXXXXXX-XXXX---------------XXXXXXX---XXX---------------XXXX------XXX---------------XXXXXXX---XXX---------------XXXX-XX--XXXX---------------XXXX------XXX---------------XXXX------XXX----------XXXXXXXXXXXXXXXXXX-----------X---XXXX----XXXXX----------------XXX------XXX---------------XXXX------XXX---------------XXXX------XXX---------------XXXX-X----XXX---------------XXXX-----XXXX---------------XXXX------XXX---------------XXXX------XXX---------------XXXX------XXX---------------XXXXXXX--XXXX---------------XXXX------XXX----------------XXX------XXX----------------XXX-----XXXX---------------XXXX-----XXXX---------------XXXX------XXX---------------XXXX-----XXXX---------------XXXX------XXX---------------XXXX------XXX---------------XXXX------XXX---------------XXXX------XXX---------------XXXX------XXX---------------XXXX-XX--XXXX---------------XXXX------XXX
