--------------------------------------------------------------------------------------------------------------------------------------------------------------------------------------------------------------------------------------------------------------------------------------------------------------------------------------------------------------------------------------------------------------------------------------------------------------------------------------------------------------------------------------------------------------------------------------------------------------------------------------------------------------------------------------------------------------------------------------------------------------------------------------------------------------------------------------------------------------------------------------------------------------------------------------------------------------------------------------------------------------------------------------------------------------------------------------------------------------------------------------------------------------------------------------------------------------------------------------------------------------------------------------------------------------------------------------------------------------------------------------------------------------------------------------------------------
--------------------------------------------------------------------------------------------------------------------------------------------------------------------------------------------------------------------------------------------------------------------------------------------------------------------------------------------------------------------------------------------------------------------------------------------------------------------------------------------------------------------------------------------------------------------------------------------------------------------------------------------------------------------------------------------------------------------------------------------------------------------------------------------------------------------------------------------------------------------------------------------------------------------------------------------------------------------------------------------------------------------------------------------------------------------------------------------------------------------------------------------------------------------------------------------------------------------------------------------------------------------------------------------------------------------------------------------------------------------------------------------------------------------------------------------------------
----oo--------------------------o---------------------------oo--------------------------oo--------------------------oo--------------------------oo------------------------------------------------------oo--------------------------oo--------------------------oo------------------------------------------------------oo--------------------------oo--------------------------oo--------------------------oo--------------------------oo--------------------------oo--------------------------oo--------------------------oo--------------------------oo--------------------------oo--------------------------oo--------------------------oo--------------------------oo----------------------------------------------------------------------------------oo--------------------------oo--------------------------oo------------------------------------------------------o---------------------------oo--------------------------o---------------------------oo--------------------------o---------------------------oo--------------------------oo--------------------------oo--------------------------oo--------------------------o---------------------------oo--------------------------o---------------------------oo--------------------------oo------------------------------------------------------oo--------------------------oo--------------------------oo--------------------------oo--------------------------oo----------------------
----XXX-------------------------XX------------------------XXXXX--------------------E----XXX------------------------XXXX-----------------------XXXXX-----------------------------------------------------XXX------------------------XXXX--------------------E---XXXX----------------------------------------------------XXXX------------------------XXXX--------------------E---XXXX------------------------XXXX-----------------------XXXXXX----------------------XXXXX--------------------E--XXXXX-----------------------XXXXX------------------------XXXX------------------------XXXX------------------------XXXX------------------------XXXX-------------------------XXX-------------------------------------------------------------------------------XXXXXX-------------------E--XXXXX-------------------------XXX--------------------------------------------------------------------------------XXXX----------------------------------------------------XXXX-------------------------XX-------------------------XXXX------------------------XXXX-------------------------XXX------------------------XXXX-------------------------X--------------------------XXXX----------------------------------------------------XXXX------------------------XXXX-----------------------------------------------------XXX-------------------------XXX-------------------------XXX------------------------XXXX-------------------------XXX---------------------
-----------------?-----------------------------------------------------------------------------------?-----------------------------------------------------------------------------------?---------------------------E---------------------------E---------------------------E---------------------------?---------------------------?---------------------------E-------------------------------------------------------------------------------------------------------------------------------------------------------------------------------------------------------------------------------?---------------------------??------------------------------------------------------?---------------------------E---------------------------E-----------------------------------------------------------------------------------?---------------------------?---------------------------?---------------------------?---------------------------?---------------------------?---------------------------?---------------------------?---------------------------E---------------------------?---------------------------?---------------------------?---------------------------E---------------------------?---------------------------?---------------------------?--------------------------E?---------------------------?---------------------------E---------------------------?---------------------------?---------------------------?----------
-----------ooo--XXXS----?---------------oo---ESS----SSS----------ooooo---XX-----SSS------------ooo--XXXS----?--------------ooo---ESS----SSS------------ooo---ESS----SSS-----------Xooo---XXS----?-------------Xooo---XXS----SSS------------oo----XXS----SSS------------ooo---XXS----SS--------------oo--XXXS----S-------------Xoo---XXXS----SSS------------oo----XXS----SSS------------ooo---XXS----SSS------------ooo---XX-----SSS----------oooo----E------SSSS---------oooo----XX-----SSS----------oooo----XX-----SSS------------ooo---ESS----SSS------------ooo---ESS----SSS----------oooo---XXX-----SSS-----------Xooo--XXXS----S--------------ooo---XXS----SSS-----------Xooo---XXS----S---------------o---XXX-----SSS-----------Xooo---XXS----S------------oooo----X------SSS----------ooooo---XX-----SSS-----------oooo--XXXS----?-------------Xooo--XXXS----S-------------Xooo---XXS----SSS----------ooooo--XXXS----SS------------Xooo--XXXS----?--------------ooo---XXS----SSS-----------oooo---XXS----?--------------ooo---XXS----SS-------------oo---XXX-----SSS-----------oooo---XXS----S------------oooo---XXXS----SS------------Xooo---XXS----SSS-----------oooo---XSS----SSS-----------Xooo--XXXS----?-------------Xooo---XXS----SSS-------------o---XXXS----SSS------------oo---XXX-----SS------------Xooo---XXS----S-------------Xoo----XXS----SSS-----------Xooo---XXS----SSS----------oooo----XXS----S-------------oooo--XXXS----S---
--------------------o---------------------------o-------------------------------------------------------o---------------------------o---------------------------o---------------------------o---------------------------o---------------------------o--------------------------oo-----------------------------------------------------------------------------------o---------------------------o---------------------------o-------------------------------------------------------o---------------------------o---------------------------o---------------------------o---------------------------o---------------------------o---------------------------o---------------------------o---------------------------o--------------------------oo---------------------------o---------------------------o---------------------------o---------------------------o-----------------------------------------------------------------------------------o-------------------------------------------------------o---------------------------o---------------------------------------------------------------------------------------------------------------o---------------------------o---------------------------o---------------------------o-------------------------------------------------------o-------------------------------------------------------o---------------------------o---------------------------o-----------------------------------
----------------------------------------------------------------------------------------------------------------------------------------------------------------------------------------------------------------------------------------------------------------------------------------------------------------------------------------------------------------------------------------------------------------------------------------------------------------------------------------------------S---------------------------------------------------------------------------------------------------------------------------------------------------------------------------------------------------------------------------------------------------------------------------------------------------------------------------------------------------------------------------------------------------------------------------------------------------------------------------------------------------------------------------------------------------------------------------------------------------------------------------------------------------------------------------------------------------------------------------------------------------------------------------------------------------------------------------------------------------------------------------------------------------------------------------------------------------
----------------------------------------------------------------S------------------------------------------------------------------------------------?------------------------------------------------------------------------------------------------------------------------------------------------------------------------------------------------------------------------------------------------------------------------------------------------E---------------------------E-----------------S----------------------------?--------------------------------------------------------------------------------------------------------------------------------------------------------------------------Q-------------------------------------------------------------E---------------------------E------------------------------------------------------------------------------------------------------------------------------------------------------------------------------------------------------------------------------------------------------E------------------------------------------------------------------------------------------------------------------------------------------------------------------------------------------------------------------------------------------------------------------------------------------------------------------------------------------------------------------------------------------
-------------XXX----XXX------------------XXX----XXX------------------XX--<>-XXX--XXX-------------XXX----XXX------------------XXX----XXX--X--XX-----------XXX----XXX--XX--------------XXX----XXX------------------XXX----XXX------X-----------XXX---XXXX--XXX-------------XXX---XXXX------------------XXX---XXXX------------------XXX---XXXX--XXX-X-----------XXX----XXX--XXX-------------XXX----XXX------------------XX--<>-XXX------------------XX--<>-XXX--E?-X------------XX--<>-XXX--XXX-------S-----XX--<>-XXX--XXX-------------XX-----XXX------X-----------XXX----XXX------------------XXX----XXX------------------XXX----XXX------------------XXX----XXX------------------XXX----XXX------------------XXX---XXXX------------------XXX----XXX------------------XX--<>-XX---E?X-------------XX--<>-XXX--E---------------XXX---XXXX------------------XXX---XXXX------------------XXX---XXXX--XX-X------------XXX---XXXX--XXX-------------XXX---XXXX--X---------------XXX---XXXX--XXX-------------XXX---XXXX--XX--------------XXX---XXXX--X--------------XXXX---XXXX------------------XXX---XXXX--XXX-------------XXX---XXXX--XXX-------------XXX----XXX--XX-XX-----------XXX----XXX--XXX-------------XXX---XXXX------------------XXX----XXX------------------XXX---XXXX------------------XXX---XXXX------------------XXX---XXXX--XXXXX-----------XXX----XXX--X---------------XXX----XXX-----XX-----------XXX---XXXX--XXX-------------XXX---XXXX--XX-
--Eo---------------------------o--------------E------------o-------------[]-----------Eo---------------------------o--------------E------------o--------------------------Eo---------------------------o---------------------------o---------------------------o---------------------------o---------------------------o---------------------------o--------------E-----------Eo--------------E------------o-------------[]------------o-------------[]-----------Eo-------------[]-----------Eo-------------[]--------------------------oo------------o--------------E-----------Eo--------------E------------o---------------------------o--------------E-----------Eo---------------------------o--------------E-----------Eo---------------------------o-------------[]-----------Eo-------------[]-----------Eo--------------------------Eo---------------------------o--------------------------Eo--------------------------Eo---------------------------o--------------------------Eo--------------------------Eo---------------------------o--------------------------Eo---------------------------o--------------------------Eo---------------------------o--------------------------Eo--------------------------Eo--------------E------------o---------------------------o--------------------------Eo---------------------------o--------------------------Eo---------------------------o--------------------------Eo------------------------
--XXXXX----------<>-----------XXXXXX---------<>-----------XXXXX----------[]-----------XXXXX----------<>-----------XXXXXX---------<>-----------XXXXXX----------------------XXXXXX----------------------XXXXXX----------------------XXXXXX----------------------XXXXXX----------------------XXXXX-----------------------XXXXXX----------------------XXXXXX---------<>-----------XXXXXX---------<>-----------XXXXX----------[]-----------XXXXX----------[]-----------XXXXXX---------[]-----------XXXXX----------[]-----------XXXXX----------[]-----------XXXXXX---------<>-----------XXXXXX---------<>-----------XXXXXX----------------------XXXXXX---------<>-----------XXXXXX----------------------XXXXX----------<>-----------XXXXXX----------------------XXXXX----------[]-----------XXXXX----------[]-----------XXXXX-----------------------XXXXXX----------------------XXXXXX----------------------XXXXX-----------------------XXXXXX----------------------XXXXXX----------------------XXXXX-----------------------XXXXX-----------------------XXXXX-----------------------XXXXXX----------------------XXXXX-----------------------XXXXXX----------------------XXXXXX----------------------XXXXX-----------------------XXXXX----------<>-----------XXXXX-----------------------XXXXX----------<>-----------XXXXXX----------------------XXXXXX----------------------XXXXXX----------------------XXXXX-----------------------XXXXX---------------------
-----------------[]--------------------------[]--------------------------[]--------------------------[]--------------------------[]------------------------------------------------------------------------------------------------------------------------------------------------------------------------------------------------------------------------------[]--------------------------[]--------------------------[]--------------------------[]--------------------------[]--------------------------[]--------------------------[]--------------------------[]--------------------------[]------------------------------------------------------[]------------------------------------------------------[]------------------------------------------------------[]--------------------------[]----------------------------------------------------------------------------------------------------------------------------------------------------------------------------------------------------------------------------------------------------------------------------------------------------------------------------------------------------------------------------------------------------------------------------------[]------------------------------------------------------[]-----------------------------------------------------------------------------------------------------------------------------------------------------
-----------X---XXXX----XXXXX---------------XXXXXXXXXXXXX---------------XXXXXXXXXXXXX-----------X---XXXX----XXXXX---------------XXXXXXX--XXXX---------------XXXXXXX---XXX---------------XXXX-----XXXX---------------XXXX-----XXXX---------------XXXXXXX---XXX---------------XXXX------XXXX--------------XXXX--X--XXXX---------------XXXX------XXX---------------XXXXXXX---XXX---------------XXXXXXX-XXXXX-----------XX--XXXXXXXXXXXXX-----------XXX-XXXXXXXXXXXXX------------X--XXXXXXXXXXXXX-----------XX--XXXXXXXXXXXXX---------------XXXXXXXXXXXXX---------------XXXXXXXX-XXXX---------------XXXXXXXXXXXXX---------------XXXX-----XXXX---------------XXXXXXXXXXXXX---------------XXXX------XXX---------------XXXXXXX-XXXXX---------------XXXX--X--XXXX-----------XXXXXXXXXXXXXXXXX-----------XX--XXXXXXXXXXXXX---------------XXXX------XXX---------------XXXX-----XXXXX--------------XXXX------XXX---------------XXXX------XXX---------------XXXX------XXX---------------XXXX-X----XXX---------------XXXX------XXX---------------XXXX-----XXXXX--------------XXXX------XXX---------------XXXX------XXX---------------XXXX------XXX---------------XXXX------XXX---------------XXXXXXX---XXX----------------XXX------XXX---------------XXXXXXX--XXXXXX-------------XXXXXXX--XXXXX--------------XXXX--X-XXXXX---------------XXXX------XXX---------------XXXX------XXX---------------XXXX-XX--XXXX---------------XXXX------XXX---------------XXXX------XXX
