--------------------------------------------------------------------------------------------------------------------------------------------------------------------------------------------------------------------------------------------------------------------------------------------------------------------------------------------------------------------------------------------------------------------------------------------------------------------------------------------------------------------------------------------------------------------------------------------------------------------------------------------------------------------------------------------------------------------------------------------------------------------------------------------------------------------------------------------------------------------------------------------------------------------------------------------------------------------------------------------------------------------------------------------------------------------------------------------------------------------------------------------------------------------------------------------------------------------------------------------------------------------------------------------------------------------------------------------------------------------------------------------------------------------------------------------------------
--------------------------------------------------------------------------------------------------------------------------------------------------------------------------------------------------------------------------------------------------------------------------------------------------------------------------------------------------------------------------------------------------------------------------------------------------------------------------------------------------------------------------------------------------------------------------------------------------------------------------------------------------------------------------------------------------------------------------------------------------------------------------------------------------------------------------------------------------------------------------------------------------------------------------------------------------------------------------------------------------------------------------------------------------------------------------------------------------------------------------------------------------------------------------------------------------------------------------------------------------------------------------------------------------------------------------------------------------------------------------------------------------------------------------------------------------------
----oo--------------------------oo--------------------------oo--------------------------oo----------------------------------------------------------------------------------oo--------------------------o---------------------------oo--------------------------oo--------------------------o---------------------------o---------------------------o---------------------------oo--------------------------oo--------------------------oo--------------------------oo--------------------------oo--------------------------oo--------------------------oo------------------------------------------------------o---------------------------oo--------------------------o-------------------------------------------------------oo--------------------------oo--------------------------oo------------------------------------------------------oo--------------------------oo--------------------------oo--------------------------oo------------------------------------------------------oo--------------------------oo--------------------------oo--------------------------oo--------------------------oo--------------------------o---------------------------oo--------------------------o-------------------------------------------------------oo--------------------------o---------------------------oo--------------------------o---------------------------oo--------------------------oo--------------------------------------------------
--XXXXX--------------------E---XXXX-----------------------XXXXX--------------------E--XXXXX--------------------------------------------------------------------------------XXXX----------------------------------------------------XXXX------------------------XXXX-------------------------X-------------------------------------------------------X--------------------------XXXX-----------------------XXXXX--------------------E--XXXXX--------------------E--XXXXX------------------------XXXX------------------------XXXX-----------------------XXXXXX-------------------E----XXX-----------------------------------------------------X--------------------------XXXX----------------------------------------------------XXXX------------------------XXXX-------------------------XXX----------------------------------------------------XXXX-----------------------XXXXX-------------------------XXX------------------------XXXX-----------------------------------------------------X---------------------------XXX------------------------XXXX-------------------------XXX------------------------XXXX-----------------------------------------------------XXX--------------------------------------------------------------------------------XXXX-----------------------------------------------------XXX----------------------------------------------------XXXX-------------------------XXX-------------------------------------------------
-----------------?---------------------------?-------------------------------------------------------------------------------------------------------------------------------------------?---------------------------E-------------------------------------------------------?---------------------------E---------------------------?---------------------------?---------------------------E---------------------------------------------------------------------------------------------------------------------------------------------------------------------------------------------------?-------------------------------------------------------E-------------------------------------------------------?-----------------------------------------------------------------------------------?---------------------------E---------------------------E---------------------------?---------------------------?---------------------------E---------------------------?---------------------------E---------------------------?---------------------------?---------------------------?---------------------------E---------------------------?---------------------------?---------------------------?---------------------------?---------------------------?---------------------------?---------------------------?---------------------------E--------------------------E?---------------------------?---------------------------?----------
---------oooo---XXX-----SS-------------ooo---XXS----S-S------------ooo---ESS----SSS------------ooo---SSS----SSS------------ooo---XXS----?-------------oooo---XX-----?--------------oo----XXS----SS-------------ooo---XXS----SS-------------oo----XXS----SSS------------ooo---XSS----SSS------------oo----XXS----SS-------------oo---XXXS----SS------------Xoo----XXS----SS-------------oo----XXS----SSS-----------oooo---XXS----SSS----------oooo----XX-----SSS----------oooo----XX-----SSS------------ooo---E-S----SSS------------ooo---ESS----SSS----------ooooo---XX-----SSS?----------Xooo--XXXS----?--------------ooo---XXS----S--------------ooo---XXS----SSS-------------o----EX-----SSS-----------Xooo--XXXS----?------------ooooo---E------SSS?-----------ooo---XXS----SSS-----------Xooo---XSS----?--------------ooo--XXX-----?-------------oooo---SSS----SSS----------oXooo--XXX-----SS-------------ooo---XXS----S--------------ooo---XXS----SS------------Xooo---XXS----?-------------oooo---XSS----S-------------Xoo---XXXS----S-------------Xooo---XXS----S-------------oooo---XXS----S------------ooooo---XXS----SSS----------ooooo---XXS----?-------------Xoo---XXXS----S-------------Xoo----XXS----S-------------Xooo--XXX-----SS-----------oooo---XXX-----SS------------Xooo---XXS----?-------------oooo---XXS----S-------------oooo---XXS----S--------------oo---XXX-----SSS----------oooo----XXS----S-------------Xooo--XXXS----S---
--------------------o---------------------------o----------------------------------------------------------------------------------ooo-------------------------ooo--------------------------o---------------------------o--------------------------oo-------------------------------------------------------o--------------------------oo---------------------------o---------------------------o---------------------------o---------------------------o---------------------------o-------------------------------------------------------o-------------------------------------------------------o--------------------------oo------------------------------------------------------oo---------------------------o---------------------------o---------------------------o---------------------------o--------------------------oo---------------------------------------------------------------------------------------------------------------o---------------------------o---------------------------o---------------------------------------------------------------------------------------------------------------o---------------------------o-------------------------------------------------------------------------------------------------------------------------------------------o---------------------------o--------------------------oo-------------------------------------------------------o--------------------------oo-------
--------------------------------------------------------------------------------------------------------------------------------------------------------------------------------------------------------------------------------------------------------------------------------------------------------------------------------------------------------------------------------------------------------------------------------------------S---------------------------S-----------------------------------------------------------------------------------S-----------------------------------------------------------------------------------------------------------------------------------------------------------------------SS-S----------------------------------------------------------------------------------------------------------------------------------------------------------------------------------------------------------------------------------------------------------------------------------------------------------------------------------------------------------------------------------------------------------------------------------------------------------------------------------------------------------------------------------------------------------------------------------------------------------------------------------------------------------------------------------------------------------------
-----------------------------------------------------------------?--------------------------------------------------------------------------------------------------------------------------------------------------------------------------------------------------------------------------------------------------------------------------------------------------------------------------------------------------------------------------S---------E-----------------S---------E-------------------------------------------------------------------------S---------------------------------------------------------------------------------------------------------------XX----------------------------------------------------SoS---------E-------------------------------------------------------------------------------------------------------------------------------------------------------------------------------------------------------------------------------------------------------------------------------------------------------------------------------------------------------------------------------------------------------------------------------------------------------------------------------------Q---------------------------Q---------------------------------------------------------------------------------------------------------------Q-----------------------------------------------------------------------
------------XXX--<>-XXX---XX-------------XXX----XXX------------------XXX----XXX--XX--------------XXX----XXX------------------XXX----XXX-----XX-----------XXX----XXX------------------XXX----XXX------------------XXX---XXXX------X-----------XXX---XXXX------------------XXX----XXX--X---------------XXX---XXXX------------------XXX---XXXX------------------XXX---XXXX--XX--------------XXX----XXX--XX-XX-----------XX-----XXX--XXXXX-----SS----XX--<>-XXX--XXXX------SS----XX--<>-XXX--XXX--------------X-----XXX-----X------------XXX----XXX--X--X------------XX--<>-XXX--XXX-------------XXX----XXX------------------XXX----XXX------------------XXX---XXXX--X---X-----------XX----XXXX--X---------------XXX----XXX------------SS--------<>-XXX--E?S-------------XXX----XXX------------------XXX----XXX-----X------------XXX----XXX-----XX-----------XXX---XXXXX-XXX-------------XXX---XXXX--XXX-------------XXX---XXXX--XX--------------XXX---XXXX--XX-X------------XXX----XXX-----XX-----------XXX---XXXX--XXX-------------XXX---XXXX--XXX-------------XXX---XXXX--XX--------------XXX---XXXX--XXXXX-----------XXX---XXXX--XXXX------------XXX---XXXX--XX-X------------XXX---XXXX--XXXX------------XXX---XXXX--XX--------------XXX---XXXX------------------XXX---XXXX--XXX-------------XXX---XXXX--X--XX-----------XXX---XXXX--XXXXX-----------XXX---XXXX--XX--------------XXX---XXXX-----X------------XXX----XXX--XXX-------------XXX---XXXX-----
--Eo-------------[]-----------Eo---------------------------o---------------------------o--------------E------------o--------------E------------o--------------E-----------Eo--------------E------------o---------------------------o---------------------------o---------------------------o---------------------------o---------------------------o---------------------------o--------------E------------o-------------<>-----------Eo-------------[]-----------Eo-------------[]------------o-------------<>-----E-----Eo--------------E------------o-------------[]-----------Eo---------------------------o---------------------------o---------------------------o--------------------------Eo--------------------------oo-------------[]-----------Eo--------------E-----------Eo--------------------------Eo---------------------------o--------------------------Eo--------------------------Eo---------------------------o--------------------------Eo---------------------------o---------------------------o--------------------------Eo---------------------------o--------------------------Eo--------------------------Eo--------------------------Eo---------------------------o---------------------------o---------------------------o--------------------------Eo--------------------------Eo--------------------------Eo---------------------------o--------------------------Eo--------------------------Eo------------------------
--XXXXX----------[]-----------XXXXXX----------------------XXXXXX----------------------XXXXXX---------<>-----------XXXXXX---------<>-----E-----XXXXX----------<>-----E-----XXXXXX---------<>-----------XXXXXX----------------------XXXXX-----------------------XXXXXX----------------------XXXXXX----------------------XXXXXX----------------------XXXXXX----------------------XXXXXX---------<>-----------XXXXXX---------[]-----------XXXXX----------[]-----------XXXXX----------[]-----------XXXXXX---------[]----<>-----XXXXXX---------<>-----------XXXXXX---------[]-----------XXXXX-----------------------XXXXXX----------------------XXXXXX----------------------XXXXX-----------------------XXXXX-----------------------XXXXX----------[]-----------XXXXXX---------<>-----------XXXXXX----------------------XXXXX-----------------------XXXXXX----------------------XXXXXX----------------------XXXXXX----------------------XXXXX-----------------------XXXXXX----------------------XXXXXX----------------------XXXXXX----------------------XXXXXX----------------------XXXXXX----------------------XXXXXX----------------------XXXXX-----------------------XXXXXX----------------------XXXXXX----------------------XXXXX-----------------------XXXXX-----------------------XXXXXX----------------------XXXXXX----------------------XXXXXX----------------------XXXXX-----------------------XXXXX----------<>-----------XXXXXX--------------------
-----------------[]----------------------------------------------------------------------------------[]--------------------------[]--------------------------[]--------------------------[]--------------------------------------------------------------------------------------------------------------------------------------------------------------------------------------------------[]--------------------------[]--------------------------[]--------------------------[]--------------------------[]----[]--------------------[]--------------------------[]----------------------------------------------------------------------------------------------------------------------------------------------------------------------[]--------------------------[]--------------------------------------------------------------------------------------------------------------------------------------------------------------------------------------------------------------------------------------------------------------------------------------------------------------------------------------------------------------------------------------------------------------------------------------------------------------------------------------------------------------------------------------------------------------------------------------------------------------------------------------[]-------------------------------------
----------XXX--XXXXXXXXXXXXX---------------XXXX-----XXXX---------------XXXXXXX---XXX---------------XXXXXXXX-XXXX---------------XXXXXXXXXXXXX---------------XXXXXXXXXXXXX---------------XXXXXXX--XXXX---------------XXXX------XXX---------------XXXXXXX---XXX---------------XXXX------XXX---------------XXXX------XXX---------------XXXX-----XXXX---------------XXXX------XXX---------------XXXXXXX--XXXX---------------XXXXXXXX-XXXX------------X--XXXXXXXXXXXXX-----------XX--XXXXXXXXXXXXX-----------XX--XXXXXXXXXXXXX---------------XXXXXXXX-XXXX---------------XXXXXXXXXXXXX-----------X---XXXX----XXXXX---------------XXXXXXX---XXX---------------XXXX------XXX---------------XXXXXXX---XXX---------------XXXX-----XXXX-----------XXXXXXXXXXXXXXXXX-----------X---XXXXXXXXXXXXX---------------XXXX-----XXXX---------------XXXX-XX-XXXXX----------------XXX------XXX---------------XXXX------XXX---------------XXXX------XXX---------------XXXX------XXX----------------XXX------XXX---------------XXXX------XXX---------------XXXX------XXX---------------XXXX------XXX---------------XXXX------XXX---------------XXXX------XXX----------------XXX------XXX---------------XXXX------XXX---------------XXXX------XXXX----------X---XXXX----XXXXX---------------XXXX------XXX----------------XXX------XXX---------------XXXX------XXX---------------XXXX------XXXX--------------XXXX------XXX---------------XXXX------XXX----------------XXX------XXX
