--------------------------------------------------------------------------------------------------------------------------------------------------------------------------------------------------------------------------------------------------------------------------------------------------------------------------------------------------------------------------------------------------------------------------------------------------------------------------------------------------------------------------------------------------------------------------------------------------------------------------------------------------------------------------------------------------------------------------------------------------------------------------------------------------------------------------------------------------------------------------------------------------------------------------------------------------------------------------------------------------------------------------------------------------------------------------------------------------------------------------------------------------------------------------------------------------------------------------------------------------------------------------------------------------------------------------------------------------------------------------------------------------------------------------------------------------------
---------------------------Q-----------------------------------------------------------------------------------------------------------------------------------------------------------------------Q-------------------------------------------------------------------------------------------------------------------------------------------Q-----------------------------------------------------------------------------------------------------------------------------------------------------------------------------------------------------------------------------Q-----------------------------Q-----------------------------------------------------------------------------------Q-----------------------------------------------------------------------------------------------------------------------------------------------------------------------------------------------------------------------------Q-------------------------------------------------------------------------------------------------------------------------------------------------------------------------Q------------------------------------------------------------------------------------------------------------------------------------------------------------------------------------------------------------------------------------------------------------------------------------------------------------------------------------------------
---------------------------------------------------------------------------------------------------------------------------------------------------------------------------------------------------------------------------------------------------------------------------------------------oo---------------------------------------------------------------------------------------------------------------------------------------------------------------------------------------------------------------------------------------------------------------------------------------------------------------------------------------------------------------------------------------------------------------------------------------------------------------------------------------------------------------------------------------------------------------------------------------------------------------------------------------------------------------------------------------------------------------------------------------------------------------------------------------------------------------------------------------------------------------------------------------------------------------------------------------------------------------------------------------------------------------------------------------------------------------------------------------------------------------------------------------------------------
----------------------------------------------------------XX----------------------------------------------------------------------------------------------------------------------------------------------------------------------------------------------------------------------------------XX--------------------------------------------------------------------------------------------------------------------------------------------------------------------------------------------------------------------------------------------------------------------------------------------------------------------------------------------------------------------------------------------------------------------------------------------------------------------------------------------------------------------------------------------------------------------------------------------------------------------------------------------------------------------------------------------------------------------------------------------------------------------------------------------------------------------------------------------------------------------------------------------------------------------------------------------------------------------------------------------------------------------------------------------------------------------------------------------------------------------------------------------------------
--------------------------------------------------------------------------------------------------------------------------------------------------------------------------------------------------------------------------------------------------------------------------------------------------------------------------------------------------------------------------------------------------------------------------------------------------------------------------------------------------------------------------------------------------------------------------------------------------------------------------------------------------------------------------------------------------------------------------------------------------------------------------------------------------------------------------------------------------------------------------------------------------------------------------------------------------------------------------------------------------------------------------------------------------------------------------------------------------------------------------------------------------------------------------------------------------------------------------------------------------------------------------------------------------------------------------------------------------------------------------------------------------------------------------------------------------------
-------------------------SSS-----------------------------------------------------------------Q--Q-QS-----SSSSSSS-----------QQ------------SQQ------------------------SSSS---------?--E------------------------?-?Q--S---------SS----------?--E---------SSSSSS---------?QQ------------------------------SSS--------QQ----------?S?SSSS---------------------QQ?SSSS--------QQQQ---------?--E---------------------------------------SSSS-------------------------QS----------S-?SSSSS----------------------?-S-------------S---------Q-Q----------------------------ESSS-----SSSSSSS------------------------SSSS---------QQQ-----------SSSQ--------?-QQQ-Q-----------------------?--E------------SSS---------Q-Q-------------------------S?-------------SSSS-------------------------SQQ---------Q-QQ---------------------------------------------------------------------------------S?SSSS---------------------?------------QSSSSS------------------------SSSS--------------------------QQ---------Q-Q-----------------------------------------------------QQQ------------SSQ--------SSSS-------------SSSS---------Q-QQQQS-------------------------------------------------?--E---------SSSSSS-----------------------SSSSS-------Q-QQQQQ-----------------------Q-Q-------------------------?--E------------------------?--E----------SSSSS-----------SSS-----------------------?-QE------------------------?--Q------------------------QQ-----------------
--------------------------------------------------------------------------------------------------------------------------------------------------------------------------------------XXX-------------------------XX-----------------------XX-XXX--------------------------------------------------------------------------------------------------------------------------------------XX-XXX---------------------------------------------------------------------------------------------------------------------------------------------------------------------XX--------------------------------------------------------------------------------------------------------------X-------------------------------------------------------------------------------------------------------------------------------------------------------------------------------------------------------------------------------------------------------------------------------------------------------------------------------XX-----------------------------------------------------------------------------------------------------------------------------XX---------------------------X------------------------------------------------------------------------------------------------------------XXXXX-------------------------------------------------------------------------------XXXXXX-------------------------XX----------------------------------------
---------------------------------------------------------XXX----------------------------------------------------------------------------------------------------------------------------------------------------------------------------------------------------------------------------------------------------------E-----------------------------------------------------------------------XXXX--------------------------------------------------------------------------------------------------------------------------------------------------------E-------------------------------------------------------------------------------------------------------------------------------------------------------------------------------------------------------------------------------------------------------------------------------------X-----------------------------------------------------------------------------------------------------------------------------------------------------------X---------------------------------------------------------------------------------------------------------------------------------------------------------------------------------------------------------------------------------------------------------------------------------Q---------------E-------------------------------------------------------------------Q---XXX---------------------------------------------------------------
----E-----------------------------------------E--E--?-------------------------------------E---------------------------E-----------E-----------E---------------E--S--------E---------------E------------------------------E------------------------E-------------E----------------------------------------------------<>---------------------------E------------------E------------E-----------------------E---------------E-------------------------------------------------------------------E---------------------E-------E-------------------------E--<>-----------E---------------------------E-----E-----E------------------E--------E-----------------------------E-------------E------------------------------E--------E---------------E-------------------------------------------E--------------E---------------E----------------------X-------------------------E------E--o-------o---------E---E-----------E---------------------------E-------------------------------------------------------------------------------------------------E-------------E--E------------------------------------------------------------------E-------------------------E---E-----------E--E------------------------E-----------E------------------E--?---------------------------------E---E--------------E-------<>---------------E--S---------------------------E----------------------------------------E------------------------------------------E------
--E<>----Q--------E-----E--------------------<>-<>---QQQ----------------------<>------E--<>---QQQQ----------------E--<>---QQQ----<>------Q??-<>--------------<>-----E--S-<>----E?S-------<>--------X--E-E<>---QQQ----Q--<>---QQQ---------SQ------<>-----E--X--E<>-----QQQ----Q-----------------Q--Q-QQQ-----------QQ-[]---E--S---------------QQQ-<>----E?SQQQ-------<>---QQQ----E<>--Q-QQ----------------<>--------------<>-----E--S------------------------------E--XX-----Q-Q------E-------<>--------------------<>-----E<>--E?-QQQ-------<>-------<>--[]----------<>-----E--------------------<>----<>----<>----E-SQQQ-------<>---QQQ-<>----E?SQQQ-------<>--------E<>---QQQQQ----<>-----E-------E--E--QQQ-------<>---QQQ-<>--------------<>--------S------------------------------E--<>---QQQQ------<>---QQQ--------<>---------------QQ---X<>------------E-----------<>-----<>-------E-----------<>--<>---Q------<>------S?S-----------------<>-----E--S-----------------<>-----E-----E----E--QQQQ------<>-----Q----E----?-QQ-----------------E<>--E?QQ------<>-<>----E--------S?S--------------------E---EE--QQQQ------<>----QQ--E<>-----QQQ----<>-----E----<>--<>---Q------<>-<>----ES-----------------<>-----E----<>----Q?QQQQQ------<>----------E->---QQQQ---Q-----------<>--<>---QQQ-------<>-------[]------S-------<>-----E--------------------E--<>----------E<>--SQQQQ----------------E--<>---QQQQ---Q--Q----QQ--------Q-QQ---------<>---QQQ
-<>[]------------<>----<>--------------------[]-[]---------------------E------[]-----<>--[]-----------------E----<>--[]----------[]----------[]--------E-----[]----<>----[]--------------[]-----E----<><>[]-------------[]--------E--------------[]----<>----<>[]----------------------------------------------------[]--<>----------------------[]-----------------[]--------E<>[]-------------------X--[]--------------[]----<>--------XX----------------------<>--XX-------------<>-------[]--------------------[]----<>[]---------------[]--E----[]--[]----------[]--------------------------[]----[]----[]-----------------[]-------[]-----------------[]-------<>[]------------[]----<>----<><>---------------[]-------[]--------------[]-----E--------------------------------<>--[]-------------[]--------------[]-------------------XX[]-----------<>-----------[]-----[]-------E-----------[]--[]----------[]--------------------------[]----<>--------------------[]----<>----<>-----------------[]--------E<>-------------------E----<>[]------------[]-[]--E--------------------------------<>--<>-------------[]-------<>[]------------[]----<>----[]--[]----------[]-[]--------E--------------[]----<>----[]-----------------[]--------E<>[]----------------------[]--[]-------------[]--E----[]--------------[]----<>-----E-------------<>--[]--------E<>[]----------------------<>--[]-----------------------------------------[]------
-[][]------------[]----[]--------------------[]-[]--------------------<>----<>[]-----[]--[]----------------<>----[]--[]----------[]----------[]-------<>-----[]-<>-[]----[]--------------[]----<>----[][][]-------------[]-------<><>------------[]----[]----[][]-------------------------------------------<>-------[]--[]----------------------[]-----------------[]-------<>[][]--------------------X->---------------[]----[]-----o--------------------------[]--XX-------------[]-------[]--------------------[]----[][]---------------[]-------[]--[]----------[]--------------------------[]----[]----[]--<>-------------[]-------[]-----------------[]-------[][]------------[]----[]----[][]---------------[]-------[]--------------[]--------------------------------------[]--[]-------------[]--------------[]------------------XXX[]-----------[]-----------[]-----[]------<>-----------[]--[]----------[]--------------------------[]----[]--------------------[]----[]----[]-----------------[]-------<>[]------------------<>----[][]------------[]-[]-----------------------------------[]--[]-------------[]-------[][]------------[]----[]----[]--[]----------[]-[]-------<>--------------[]----[]----[]-----------------[]-------<>[][]----------------------[]--[]-------------[]-<>----[]--------------[]----[]----<>-------------[]--[]-------<>[][]----------------------[]--[]-----------------------------------------[]------
-[][]---------E--[]-E--[]---------E-EE-E--E--[]-[]------------------E-[]----[][]-----[]--[]------EE-E--E-E-[]----[]--[]------EE--[]----------[]-------[]--E--[]-[]-[]----[]-----------E--[]----[]----[][][]------EE-E---[]-------[][]--------EE--[]----[]-E--[][]---------E-EE--E-EE---------------E--E--E--[]-E-EE--[]--[]-------E-EE-----------[]-----------E-E---[]----E--[][][]-E----E--E----E----XX-----E--E--E--E--[]----[]----------------EE-E---------E--[]--XX-------------[]-E-----[]-----------E-EE-E---[]----[][]--------EE-EE--[]-------[]--[]------E---[]-E---------------------E--[]----[]----[]--[]----E--EE----[]-------[]-----------E-EE--[]-E-EE--[][]--------EE--[]----[]----[][]---------E-E---[]----E--[]--------E--E--[]---------------E-------E-EE-----------[]-E[]------EE-EE--[]-----------E--[]-E--E-------------XXX[]--E--------[]-----EE-E--[]--E--[]------[]-----------[]-E[]----E--E--[]------------------E-E--E--[]----[]---------E-EE-E--E--[]----[]----[]-X---------EEEE--[]-EE-E--[][]--------EE-E------[]----[][]---------E--[]-[]--------------E--E--E-EE-E---------[]--[]-------E-EE--[]-------[][]--------EE-EXX--E-[]-X--[]--[]----E-E---[]-[]-------[]--------E--E--[]----[]----[]--------E--EE----[]-E-----[][][]------EE-EE-----------[]--[]------EE-E---[]-[]----[]-------EE--E--[]----[]----[]---------E-E-[]--[]-------[][][]------EE-E--E---------[]-E[]---------E---EE------------------E-EE----[]-E--E-
XXXXXXXXXXXXXXXXXXXXXXXXXXXXXXXXXXXXXXXXXXXXXXXXXXXXXXXXXXXXXXXXXXXXXXXXXXXXXXXXXXXXXXXXXXXXXXXXXXXXXXXXXXXXXXXX-XXXXXXXXXXXXXXXXXXXXXXXXXXX-XXXXXXXXXXXXXXXXXXXXXXXXXXX-XXXXXXXXXXXXXXXXXXXXXXXXXXX-XXXXXXXXXXXXXXXXXXXXXXXXXXX-XXXXXXXXXXXXXXXXXXXXXXXXXXX-XXXXXXXXXXXXXXXXXXXXXXXXXXXXXXXXXXXXXXXXXXXXXXXXXXXXXXX-XXXXXXXXXXXXXXXXXXXXXXXXXXX-XXXXXXXXXXXXXXXXXXXXXXXXXXX-XXXXXXXXXXXXXXXXXXXXXXXXXXXXXXXXXXXXXXXXXXXXXXXXXXXXXXXXXX------XXXXXXXXXXXXXXXXXXX-XX--XX----XXXXXXXXXXXXXXXXX-XXXXXXXXXXXXXXXXXXXXXXXXXXXXXXXXXXXXXXXXXXXXXXXXXXXXXXXXXXXXXXXXXXXXXXXXXXXXXXXXXXXXXXXXX-XXXXXXXXXXXXXXXXXXXXXXXXXXXXXXXXXXXXXXXXXXXXXXXXX-XXXXXXXXXXXXXXXXXXXXXXXXXXXXXXXXXXXXXXXXXXXXXXXXXXXXXXX-XXXXXXXXXXXXXXXXXXXXXXXXXXX-XXXXXXXXXXXXXXXXXXXXXXXXXXXXXXXXXXXXXXXXXXXXXXXXXXXXXXX-XXXXXXXXXXXXXXXXXXXXXXXXXXX-XXXXXXXXXXXXXXXXXXXXXXXXXXXXXXXXX---XXXXXXXXXXXXXXXXXXX-XXXXXXXXXXXXXXXXXXXXXXXXXXX-XXXXXXXXXXXXXXXXXXXXXXXXXXXXXXXXXXXXXXXXXXXXXXXXXXXXXXXXXXXXXXXXXXXXXXXXXXXXXXXXXXX-XXXXXXXXXXXXXXXXXXXXXXXXXXX-XXXXXXXXXXXXXXXXXXXXXXXXXXX-XXXXXXXXXXXXXXXXXXXXXXXXXXXXXXXXXXXXXXXXXXXXXXXXXXXXXXX-XXXXXXXXXXXXXXXXXXXXXXXXXXXXXXXXXXXXXXXXXXXXXXXXXXXXXXX-XXXXXXXXXXXXXXXXXXXXXXXXXXX-XXXXXXXXXXXXXXXXXXXXXXXXXXX-XXXXXXXXXXXXXXXXXXXXXXXXXXX-XXXXXXXXXXXXXXXXXXXXXXXXXXX-XXXXXXXXXXXXXXXXXXXXXXXXXXX-XXXXXXXXXXXXXXXXXXXXXXXXXXX-XXXXXXXXXXXXXXXXXXXXXXXXXXX-XXXXXXXXXXXXXXXXXXXXXXXXXXX-XXXXXXXXXXXXXXXXXXXXXXXXXXXXXXXXXXXXXXXXXXXXXXXXXXXXXXX
