--------------------------------------------------------------------------------------------------------------------------------------------------------------------------------------------------------------------------------------------------------------------------------------------------------------------------------------------------------------------------------------------------------------------------------------------------------------------------------------------------------------------------------------------------------------------------------------------------------------------------------------------------------------------------------------------------------------------------------------------------------------------------------------------------------------------------------------------------------------------------------------------------------------------------------------------------------------------------------------------------------------------------------------------------------------------------------------------------------------------------------------------------------------------------------------------------------------------------------------------------------------------------------------------------------------------------------------------------------------------------------------------------------------------------------------------------------
---------------------------Q---------------------------------------------------------------------------------------------------------------------------------------------------------------------------------------------------------------------------------------------------------------------------------------------------------------------------------------------------------------------------------------------------------------------------------------------------------------------------------------------------------------------Q-------------------------------------------------------------------------------------------------------------------------------------------Q---------------------------------------------------------Q---------------------------Q-------------------------------------------------------------------------------------------------------------------------------------------Q------------------------------------------------------------------------------------------------------------------------------------------------------------------------------------------------------------------------------------------------------------------------------------------------------------------------------------------------------------------------------------------------------------------------------------------------------------------------------------------------------------------------
------------------------------------------------------------------------------------------------------------------------------------------------------------------------------------------------------------------------------------------------------------------------------------------------------------------------------------------------------------------------------------------------------------------------------------------------------------------------------------------------------------------------------------------------------------------------------------------------------------------------------------------------------------------------------------------------------------------------------------------------------------------------------------------------------------------------------------------------------------------------------o-------------------------------------------------------------------------------------------------------------------------------------------------------------------------------------------------------------------------------------------------------------------------------------------------------------------------------------------------------------------------------------------------------------------------------------------------------------------------------------------------------------------------------------------------------------------------
-----XXX---------------------------------------------------------------------------------------------------------------------------------------------------------------------------------------------------------------------------------------------------------------------------------------------------------------------------------------------------------------------------------------------------------------------------------------------------------------------------------------------------------------------------------------------------------------------------------------------------------------------------------------------------------------------------------------------------------------------------------------------------------------------------------------------------------------------------------------------------------------------XXX------------------------------------------------------------------------------------------------------------------------------------------------------------------------------------------------------------------------------------------------------------------------------------------------------------------------------------------------------------------------------------------------------------------------------------------------------------------------------------------------------------------------------------------------------------------------
--------------------------------------------------------------------------------------------------------------------------------------------------------------------------------------------------------------------------------------------------------------------------------------------------------------------------------------------------------------------------------------------------------------------------------------------------------------------------------------------------------------------------------------------------------------------------------------------------------------------------------------------------------------------------------------------------------------------------------------------------------------------------------------------------------------------------------------------------------------------------------------------------------------------------------------------------------------------------------------------------------------------------------------------------------------------------------------------------------------------------------------------------------------------------------------------------------------------------------------------------------------------------------------------------------------------------------------------------------------------------------------------------------------------------------------------------------
-----------------------SSSSSQ------------SSS-----SSSSSSS---------SSS-S----QQ-------------------?-S------------QQ---------------Q---Q-Q------------------------------SSSS-------------------------SSS---------Q--Q------------------------Q---------------SQS--------------QSS--------QQQ--------------S------SSS---S--------------------------SS-----------?-----------S----------------E---------------------------SSSS------QSSSQQ-----------------------------------------------------QQQ---------QQQQ------------SQQ---------Q-?Q------------SQ----------?--E------------------------?-?Q---------QSSSSSo--------QQQQ-----------SSQ----------QQQQ-----------SSQS---------QQQQ----------SSSQQ---------QQ--------------SQQ---------Q--E----------------------?QQQQ--------------Q----------?-Q------------SSS----------?-----------SSSSSSSo--------QQQQ----------SSSSS------------------------SSQQ------------------------SSSS-------------------------------------------------------------------------------------------------------------SSSo--------QQQ--------------------------------------S------------------------------------------------------------------------------------------------------------------------------------------------------------Q-------------------------SSSSSSSS--------SSS-------SSQQ?Q------Q---------------------S-------SQSSSS--------------------------------------?--E-----------SSS----------Q------------------
---------------------------------------------------------------------------------------------------------------------------------------------------------------------------------------------------------------------------------------------------------------------------------------------------------------------------------------------------------------------------------------XX-oo---o--o---XX------------------------------------------------------------------------------------------------------------------------------XX-----------------------XXXXX-------------------------XXX---------------------------------------------------------------------------------------------------------------------------------------------------------------------------------------------------------------------------------------------------------------------------------------------------------------------------------------------------------------------------X--------------------------------------------------------------------------------------------------------------------------X----------------------------------------------------------------------------------------------------------------------------------------------------------------------------------------------------------------------------------------------------------------------------------------------------XXXXX----------------------------------------
--E---------------------------------------------------------------------------------------------------------------------------------------------------------------------------------------------------------------------------------------------------------------------------------------------------------------------------------------------------------------------------------------XXX-XXXXXX--------------------------------------------------------------------------------------------------------------------------------------------------------------Q---------------------------Q-------------------------------------------------------Q-----------------------------------------------------------------------------------------------------------------------------------------------------------------------------------------------------------------------------------------------------------------------------------------------------------------------X----------------------------------------------------------------------------------------------------------------------XX---------------------------XX--------------------------------------------------------------------------------------------------------------------------------------------------------------------------------------------------------------------------------------------------------------------------------------------------------------------
-<>---------------------E-------------------------------------------------------------E---------------E---------------E-----------------------E-----------------------------E-------------E--S--------E---E-----------------------E---------------E-----------E------------------E------------E---------------------------------------E-----E-------E-----------------------------E-----------------------E---------------E---------------------------------------E-------------------------------------------E--E--------E------------------E--------E---------------E--E------------E--------------E------------------------E--E--------E------------------E--------E------------------E--------E------------------E--------E---------------------------E---------------E--E------------E--------------E--?---------E-----------E--E----------E----------------E----------------------------------------------------E---------------------------------------------------------------------------------------------------------------------E------------------------E------------------------------EXX--------------------------XXX-----------------------------------------------------------------------------E-------------------------------------------------------E--------E------------------E----------------------------------------E-------------------------E-------------E---------------------------E-------------E----------------E------
-[]----E-S-------<>----<>---o------Q-------------------------X-----QQ----Q--QQQ------<>-----QQ-------<>-----------E--<>---QQQQ------QQ-------<>----E----------------------E<>----QQQQ----<>-----E-----E--<>---QQQQ---------------<>----E?Q-------<>-----E--S-<>----E--Q---------<>---QQQ--E--<>---Q-------------E--------------------<>----<>-----E<>----<>----Q-Q--Q-----------E<>----QQ------Q---------<>----E--Q-Q----<>------QQ?-----------------------------<>---------------------------E----E--QQQ----<>-<>---QQ?-<>---E--SQQQ----QQ-<>-------<>----E?SQQQ----<>-<>--------E--<>---QQQ----<>-<>-----S--E----E-QQQQ----<>-<>---QQ?-<>----E?SQQQ-------<>-------<>----E?SQQQ-------<>---QQQ-<>----EQQ-------<>-<>----?S-<>----E-SQQQ----QQ----------<>----E?SQ------<>-<>--------E-E<>---QQQ-------<>-----Q--E--<>--QQ------<>------E?S--E<>--E?SQQQ-------<>--------------------------------SS-<>--------------<>--------------------Q-------------QQQ--E<>-----------------------------------------------------E-E---------------E--<>---------E--QQQQ-------<>--------E--X-----------------XXXX-----<>------------------XXXX--------------------------X-------------------------------------QQ----------<>-----------------------E------------E----Q--Q---------<>-------<>--X--------------<>--------E---E??SQQQQ---Q--Q---------E--<>----QQ------------Q----E<>--E--Q------<>-----------E<>----SQQQ----<>-----------E<>---?QQ---------<>------
-[]--------------[]----[]------------------------------------XX----------------------[]--------------[]-----E----<>--[]----------------------[]--------------------------<>[]------------[]----<>----<>--[]-----------------E----[]--------------[]----<>----[]-----------------[]-------<>--[]----------------<>--------------E-----[]----[]----<>[]----[]-------------------E<>[]----------------------[]--------------[]--------------------------------------[]--------------------E-----<>--------------[]-[]-------[]--<>-------------[]-------[]--------------[]-[]--E----<>--[]----------[]-[]-------<><>------------[]-[]-------[]-----------------[]-------[]-----------------[]-------[]--------------[]-[]-------[]---------------------E----[]--------------[]-[]--E----<><>[]-------------[]-------<>--[]----------[]--E-------<>[]---------------[]-----------------------------------[]--------------[]----------<>--------------------------<>[]----------------------------------------------------<><>-----E-----E--<>--[]--------<>----------S--[]-----------XX----------------XXXX-----[]-----------------XXXXX-------------------------XXX----------------------------------------------E-[]---E------------------<>------E----<>-----------------[]-------[]--X--------------[]--E----<>--<>----------------------<>--[]----------------------<>[]------------[]--E-------<>[]------------[]----------<>[]---------------[]------
-[]--------------[]----[]------------------------------------XX----------------------[]--------------[]----<>----[]--[]----------------------[]--------------------------[][]------------[]----[]----[]--[]----------------<>----[]--------------[]-<>-[]----[]-----------------[]-------[]--[]----------------[]-------------<>-----[]----[]----[][]----[]------------------<>[][]----------------------[]--------------[]-<>-----------------------------------[]-------------------<>-----[]--------------[]-[]-------[]--[]-------------[]-------[]--------------[]-[]-<>----[]--[]-------------[]-------[][]------------[]-[]-------[]-----------------[]-------[]-----------------[]-------[]--------------[]-[]-------[]--------------------<>----[]--------------[]-[]-<>----[][][]-------------[]-------[]--[]----------[]-<>-------[][]---------------[]-----------------------------------[]--------------[-----------[]-----------------<>-------[][]----------------------------------------------------[][]----<>---X<>--[]--[]--------[]-------------[]-----------XXX--------------XXXXX-----[]----------------XXXXXX----------------X-------XXXX---------------------------------------------<>-[]--<>------------------[]-----<>----[]-----------------[]-------[]--X--------------[]-------[]--[]-------------<>-------[]--[]-------------<>-------[][]------------[]-<>-----X-[][]------------[]-<>-------[][]---------------[]------
-[]--------E--E--[]E---[]-----------------E--E-E----------XXXXX----------E-----E-EE--[]--EE-------E--[]----[]----[]--[]----------E-----------[]-----------E-EE-----E-----[][]--------EE--[]----[]----[]-E[]------EE-EE-E---[]----[]--------E--E--[]-[]-[]----[]-----------------[]-------[]--[]----E-E---E-E---[]--------EE-E-[]--E--[]----[]----[][]----[]-----E---EE----X--[][][]-E-------E-------E-E--[]--------E--E--[]-[]------------------E-E--E-----------[]--------EE-E-EE----[]-----[]-E---------E--[]-[]-------[]--[]-------E-EE--[]-------[]----------EE--[]-[]-[]----[]-E[]------E------[]-------[][]---------E--[]-[]-------[]--------E--E-----[]-------[]-----------E--E--[]-------[]--EE----E--E--[]-[]-------[]----------EE-EE-----[]----[]--------E--E--[]-[]-[]----[][][]-------E-----[]-E-----[]-E[]------EE--[]-[]-------[][]---------E-----[]------------------E-E-EE-----------[]--E------E-E--E-----E-----[]-----------E-EE--[]-E--E--[][]-----------E----E---------------------------------E-[][]----[]--EX[]--[]--[]--------[]------EEE----[]-----------XXX-----------E-XXXXXX-----[]-------E-------XXXXXXX------------E-----X----XXXX----------------------------------EE-E--EE-E--[]-[]--[]-----E-EE-----E-E-[]-E---[]----[]---------E-EE----[]-------[]--X--------------[]-------[]--[]-------E-EE--[]-------[]-E[]-------E-EE--[]-E--E--[][]--------EE--[]-[]----XX-[][]-E------EE-E[]-[]-------[][]---------E-EE--[]------
-XXXXXXXXXXXXXXXXXXXXXXXXXXXXXXX-XXXXXXXXXXXXXXXXXXXXXXXXXXX-XX----XXXXXXXXXXXXXXXXX-XXXXXXXXXXXXXXXXXXXXXXXXXXXXXXXXXXXXXXXXXXXXXXXXXXXXXXX-XXXXXXXXXXXXXXXXXXXXXXXXXXX-XXXXXXXXXXXXXXXXXXXXXXXXXXX-XXXXXXXXXXXXXXXXXXXXXXXXXXX-XXXXXXXXXXXXXXXXXXXXXXXXXXX-XXXXXXXXXXXXXXXXXXXXXXXXXXX-XXXXXXXXXXXXXXXXXXXXXXXXXXXXXXXXXXXXXXXXXXXXXXXXXXXXXXXXXXXXXXXXXXXXXXXXXXXXXXX-XXX-XXXXXXXXXXXXXXXXXXXXXXXXXXXXXXXXXXXXXXXXXXXXXXXXXXXXXXXXXXXXXX-XXXXXXXXXXXXXXXXXXXX-XXXXXXXXXXXXXXXXXXXXXXXXXXX-XXXXXXXXXXXXXXXXXXXXXXXXXXXXXXXXXXXXXXXXXXXXXXXXXXXXXXX-XXXXXXXXXXXXXXXXXXXXXXXXXXX-XXXXXXXXXXXXXXXXXXXXXXXXXXX-XXXXXXXXXXXXXXXXXXXXXXXXXXX-XXXXXXXXXXXXXXXXXXXXXXXXXXX-XXXXXXXXXXXXXXXXXXXXXXXXXXXXXXXXXXXXXXXXXXXXXXXXXXXXXXXXXXXXXXXXXXXXXXXXXXXXXXXXXXX-XXXXXXXXXXXXXXXXXXXXXXXXXXX-XXXXXXXXXXXXXXXXXXXXXXXXXXX-XXXXXXXXXXXXXXXXXXXXXXXXXXX-XXXXXXXXXXXXXXXXXXXXXXXXXXXXXXX----XXXXXXXXXXXXXXXXXXXXXXXXXXXXXXXXXXXXXXXXXXXXXXXX-XXXXXXXXXXXXXXXXXXXXXXXXXXX-XXXXXXXXXXXXXXXXXXXXXXXXXXXXXXXXX---XXXXX-------XXXXXXXXXXXXXXXXXXXXXXXXXXXXXXXXXS-XXXXXXXXXXXXXXXXXXXXXXXXXXXXXXX--XX---XXXXXXXXXXXXXXXX--XXXXXXXXXXXXXXXXXXXXXXXXXXX-XXXXXX---XXXXXXXX-X--XXXXXXXXXXXXXXXXXXXX----XXXXX---XXXXXXXXXXXXXXXXXXXXXXXXXX-XX--XXXXXXXXXXXXXXXXXXXXXXXXXXXX-XXXXXXXXXXXXXXXXXXXXXXXXXXX-XXXXXXXXXXXXXXXXXXXXXX-XXXX-XXXXXXXXXXXXXXXXXXXXXXXXXXX-XXXXXXXXXXXXXXXXXXXXXXXXXXX-XXXXXXXXXXXXXXXXXXXXXXXXXXXXXXXXXXXXXXXXXXXXXXXXXXXXXXXXXXXXXXXXXXXXXXXXXXXXXXXXXXX
