--------------------------------------------------------------------------------------------------------------------------------------------------------------------------------------------------------------------------------------------------------------------------------------------------------------------------------------------------------------------------------------------------------------------------------------------------------------------------------------------------------------------------------------------------------------------------------------------------------------------------------------------------------------------------------------------------------------------------------------------------------------------------------------------------------------------------------------------------------------------------------------------------------------------------------------------------------------------------------------------------------------------------------------------------------------------------------------------------------------------------------------------------------------------------------------------------------------------------------------------------------------------------------------------------------------------------------------------------------------------------------------------------------------------------------------------------------
-----------------------------------------------------------------------------------------------------------------------------------------------------------------------------------------------------------------------------------------------------------------------------------------------------------------------------------------------------------------------------------------------------------------------------------------------------------------------------------------------------------------------------------------------------------------------------------------------------------------------------------------------------------------------------------------------------------------------------------------------------------------------------------------------------------------------------------------------------------------------------------------------------------------------------Q-Q-----------------------------------------------------------------------------------------------------------------------------------------------------------------------------------------------------------------------------------------------------------------------------------------------------------------------------------------------------------------------------------------------------------------------------------Q---------------------------------------------------------------------------------Q--
-----------------------------------------------------------------------------------------------------------------------------------------------------------------------------o---------------------------------------------------------------------------------------------------------------------------------------------------------------------------------------------------------------------------------------------------------------------------------------------------------------------------------------------------------------------------------------------------------------------------------------------------------------------------------------------------------------------------------------------------------------------------------------------------------------------------------------------------------------------------------------------------------------------------------------------------------------------------------------------------------------------------------------------------------------------------------------------------------------------------------------------------------------------------------------oo-------------------------------------------------------------------------------------------------------------------------------------------o-------------------------------------------------------------------------------------------------------------------------------------
-----------------------------------------------------------------------------------------------------------------------------------------------------------------------------XX-------------------------------------------------------------------------------------------------------------------------------------------------------------------------------------------------------------------------------------------------------------------------------------------------------------------------------------------------------------------------------------------------------------------------------------------------------------------------------------------------------------------------------------------------------------------------------------------------------------------------------------------------------------------------------------------------o------------------------------------------------------------------------------------------------------------------------------------------------------------------------------------------------------------------------------------------------------------------------------------XXX-------------------------------------------------------------------------------------------------------E---------------------------------XXX------------------------------------------------------------------------------------------------------------------------------------
--------------------------------------------------------------------------------------------------------------------------------------------------------------------------------------------------------------------------------------------------------------------------------------------------------------------------------------------------------------------------------------------------------------------------------------------------------------------------------------------------------------------------------------------------------------------------------------------------------------------------------------------------------------------------------------------------------------------------------------------------------------------------------------------------------------------------------------------------------------------------------------------------------------------------------------------------------------------------------------------------------------------------------------------------------------------------------------------------------------------------------------------------------------------------------------------------------------------------------------------------------------------------------------------------------------------------------------------------------------------------------------------------------------------------------------------------------
-------------SSS---SSSSSSS-----------Q---------------S?S---------S??SSSSS---SSSSSS-------------------------------------------S-----Q--------------------SSSS-----SSSSSSS-------------------------SSS-------------------------SSS------------------------------------------SSS------------------------------------------------QQQQ------------SSS------------E------------------------QQ--SSS---------SQ--------------------------------------QQ?QSSS--------SSS--------------------------------------Q----QSS------SSSS-------------E------------SSS----------------------QSSSS----------------------SSSSSSS-------------------------SQS-----------?SSSS---------------------------------------------------Q------------SSQS------------E----------------------?-QQQQ------------------------Q-Q---------------------------?SSSS-----SQSSSSQ-------------------------------------???QSSS--------SSSS---------?-------------SSSSS-----------Q------------SSQ-------------E------------------------?--E----------------------?-QQ?------------SSSS-------------------------SQS---------Q-Q---------------------------?SSSS-----SSSSSSS------------------------SSS-o------?QQQQQ----------SSSSS---------Q-?QSSSS-------QQQ----------Q-?QSQS---------------------?--E--------SSSSSSS---------QQQ------------SSSS---------QQQ-------------SQQ---------?---------------SSS---------SS?SSSS---------SSS---------?-QQ------------------------???S---------SSSSSS
----------------------------------------------------------------------------------------------------------------------------------------------------------------------------------------------------------------------------------------------------------------------------------------------------------------------------------XX--------------------------------------------------------------------------------------------------------------XX-------------------------------------------------------X------------------------------------------------------------------------------------------------------------------------------------------------------------------------------------------------------------------------------X------------------------------------------------------------o------XX----------------------------------------------------------------------XX----------------------------------------------------------------------------------X---------------------------XX--------------------------------------------------------------------------------------------------------------X----------------------------------------------------------------------------------------------------------------------------------------XXXX----------------------------------------------------------------------------------------------------------------------------------------------------------------------XXX------------
------------------------------------------------------------------------------------------------------------------------------------------------------------------------------------------------------------------------------------------------------------------------------------------------------------------------------------------------------------------------------------------------------------------------------------------------------------------------------------------------------------------------------------------------------------------------------------------------------------------------------------------------------------------------------------------------------------------------------------------------------------X---------------------------------Q-------XXX---------------------------------------------------------------------------------------------------------------------------------------------------------------------------------------------------------------------------------------------------------------------------------------------------------------------------------------------------------------------Q-----------------------------------------------------------------------------------------------------------------------------------------------------------------------------------------------------------------------------------------------------------Q-------------
------E-----------------------E---------------E--E------------------------------------------E-----------------E------------X------------------E-------------------------------------------E----o--------------------------------------------------E---------------E--------------E----------E----------------E----------E-------------------------E---------------E------------------------------E----------E-----------------------------E--------------E--------E---------------E--S------------E--------------E----------E-------------------E-----E---E--------------E--------------------------------------E-------------E-----------E-------------------------------------------E-------------------------------------------------------------E-------E----------------E----------E----------------E--------E----------------------------------------------E------------E-----------------------E---------------E-----------------------------------------E-------------------------E------------------E--------E---------------E-------------E----------------E----------E----------------E-----------<>---------------------------------------E--E--------E---------------E---------------E--------------E--------E------------------E------------E-----------E-----------E------------------E--?------------------------E--------E----------------------------------------------E------------E-----------------------E---E---------------------
--E--<>----------------------<>----QQQQ------<>-<>--------E--<>-------Q----Q-SSS-----------<>-------------E--<>-----------XX-----------------<>---------------E-----E--------------------<>-----------------------Q--<>-----E-----------QQQ------<>-----------E--<>---QQQQ------<>----QQ--E<>---------------<>--------E<>--E?SQQQ----------------<>---EE-SQQQ----<>-----------E----Q--Q-Q-------<>--------E<>-------------------------E--<>---QQQ-------<>-----Q-<>------S-------<>-----E-----E-E<>---QQQQ------<>--------E<>----S--------E----<>----<>--<>---QQQ-------<>-------------------------------------<>----Q-------<>----------<>----E--QQQ-------Q----QQQ-----------------<>-------------E-----QQQ-------------Q?--E----E?SQQQ----------<>-----E<>--ESSSQQ-------<>----QQ--E<>--E--QQQ----Q--<>---QQQ-<>---E-----------------QQQQ----------Q---------<>---QQQ--E--<>----QQ----------------<>----E-Q-------<>------Q??--E--<>---QQQ------------QQQ--E<>-----QQQ----------------<>----E-SQQQ-------<>---QQQ-<>----E?SQQQ----<>--------S--E<>---?Q-------E--<>--------E<>--E?-QQQ----Q--<>-----Q--E--[]-----Q-Q----------SSS----E----QQ------<>-<>---QQQ-<>----Q?SQQQ----<>-----------E--<>---QQQQ------<>---QQQ-<>---E---QQQQ---Q--<>---QQQ--E--<>--S-------<>------E??-<>----E?SQQQ-------<>-------------E-QQQQ-------<>---QQQ-<>-----?S-------<>-----E--S--------QQ----------<>--------E--<>---QQQQ---Q---E---QQQ-<>--<>---QQQ----<>--------S
-<>--[]----------------------[]--------------[]-[]--E----<>--[]----------------------------[]------------<>--[]----------XXX-SSS-------------[]--------------<>----<>--------------------[]--------------------------[]----<>----<>--------------[]-----E----<>--[]-------------[]-------<>[]---------------[]-------<>[]-------------------E----[]--<>----------[]-----E----<>-----------------[]-------<>[]------------------------<>--[]-------------[]-------[]--------------[]----<>----<><>[]-------------[]-------<>[]------------<>----[]-X--[]--[]-------------[]--------E-E-------------------------E[]------------[]----------[]---------------------------S--------------[]-----------E<>-------------------------E--------------------[]----<>[]---------------[]-------<>[]---------------[]-------[]--<>---------------------------?-------------[]-------<>--[]----------------E-----[]--------------[]----------<>--[]-------------<>-------<>[]------------------------[]-----------------[]-------[]--------------[]----------<>[]-----------<>--[]-------<>[]---------------[]-------<>--[]----------------------<><>------------[]-[]-------[]--------------[]----------<>--[]-------------[]-------[]--<>-------------[]-------<>--[]----------[]----------[]-----------------[]--------E-----------------[]-------[]--------------[]----<>-----------------------[]-------<>--[]-------------<>-------[]--[]----------[]---------
-[]--[]----------------------[]--------------[]-[]-<>----[]--------<>----------------------[]------------[]--[]--<>-----XXXX-----------------[]--------------[]----[]--------------------[]--------------------------[]----[]----[]--------------[]----<>----[]--[]-------------[]-------[][]---------------[]-------[][]------------------<>----[]--[]----------[]----<>----[]-----------------[]-------[][]------------------------[]--[]-------------[]-------[]--------------[]----[]----[][][]-------------[]-------[][]------------[]----[]-X--[]--[]-------------[]-------<><>------------------------<>[]------------[]----------[]---------------------------------<>-------[]----------<>[]------------------------<>--------------------[]----[][]---------------[]-------[][]---------------[]-------[]--[]-----------------------o-----------------[]-------[]--[]---------------<>-----[]--------------[]-<>-------[]--[]-------------[]-------[][]------------------------[]-----------------[]-------[]--------------[]-<>-------[][]-----------[]--[]-------[][]---------------[]-------[]--[]----------------------[][]------------[]-[]-------[]--------------[]-<>-<>----[]--[]-------------[]-------[]--[]-------------[]-------[]--[]----------[]----------[]-----------------[]-------<>-----------------[]-------[]--------------[]----[]----<>-----------------[]-------[]--[]-------------[]-------[]--[]----------[]---------
-[]--[]------------EE--------[]-------EE-----[]-[]-[]----[]--------[]------EE-E---------E--[]------EE--E-XX--[]--[]----XXXXX-----------E-E---[]--------E-EE--[]E---[]-----------------E--[]--------------------E--E--[]----[]----[]--EE-------E--[]----[]----[]-E[]-------E--E--[]-E--E--[][]---------E-EE--[]-E-----[][]---------E-EE-----[]----[]--[]------EE-E[]----[]----[]--------E--E--E--[]-E-----[][]--------EE-EE-----------[]--[]-------E--E--[]-E-EE--[]-----------E--[]----[]----[][][]------EE-EE--[]-------[][]--------EE-E[]-E--[]----[]-E[]------EE--E--[]-------[][]---------E-EE-----E--E--[][]---------E-E[]----------[]-----------E-EE-----E--E--E---E--[]----E--[]----------[][]---------E-EE-----------[]----------EE-E------[]----[][]---------E-E---[]-E--E--[][]---------E-EE--[]-EE-E--[]--[]-------E-----E-------------------E-EE----[]--E-E--[]--[]-------E-EE----[]-----[]-----------E--[]-[]-------[]--[]-------E-EE--[]-E--E--[][]--------EE-EE-----------[]-Q-E------EE-EE--[]-------[]--------E--E--[]-[]-------[][]-E-------E-[]--[]-------[][]--------EE-E---[]-------[]-E[]------------EE--------[][]---------EE-[]-[]-------[]--------E--E--[]-[]-[]----[]--[]-------E-----[]-------[]--[]------EE-EE--[]-------[]--[]------EE--[]----------[]--------E--E-----[]-------[]-----------E--E--[]-------[]-----------E--[]----[]----[]--E--------E-----[]-------[]-E[]-------E-EE--[]----E--[]-E[]------EE-EXX---------
-XXXXXXXXXXXXXXXXXXXXXXX-XXX-XXXXXXXXXXXXXXXXXXXXXXXXXXX-XX--XXXXXXXXXXXXXXXXXXXXXXXXXXXXXXXXXXXXXXXXXXXXXXXXXXX-XXXXXXXXXX-------XXXXXXXXXXXXXXXXXXXXXXXXXXXXXXXXXXXXXXXXX---XXXXXXXXXXXXXXXXXXXXXXXXXX-XXXXXXXXXXXXXXXXXXXXXXXXXXXXXXXXXXXXXXXXXXXXXXXXXXX-XXXXXXXXXXXXXXXXXXXXXXXXXXX-XXXXXXXXXXXXXXXXXXXXXXXXXXX-XXXXXXXXXXXXXXXXXXXXXXXXXXXXXXXXXXXXXXXXXXXXXXXXXXXXXXX-XXXXXXXXXXXXXXXXXXXXXXXXXXX-XXXXXXXXXXXXXXXXXXXXXXXXXXX-XXXXXXXXXXXXXXXXXXXXXXXXXXX-XXXXXXXXXXXXXXXXXXXXXXXXXXX-XXXXXXXXXXXXXXXXXXXXXXXXXXX-XXXXXXXXXXXXXXXXXXXXXXXXXX--XXXXXXXXXXXXXXXXXXXXXXXXXXX-XXXXXXXXXXXXXXXXXXXXXXXXXXX-XXXXXXXXXXXXXXXXXXXXXXXXXXX-XXXXXXXXXXXXXXXXXXXXXXXXXXXXXXXXXXXXXXXXXXXXXXXXXXXXXXX-XXXXXXXXXXXXXXXXXXXXXXXXXXX-XXXXXXXXXXXXXXXXXXXXXXXXXX--XXXXXXXXXXXXXXXXXXXXXXXXXXX-XXXXXXXXXXXXXXXXXXXXXXXXXXX-XXXXXXXXXXXXXXXXXXXXXXXXXXXXXXX-X---XXXXXXXXXXXXXXXXXXX-XXXXXXXXXXXXXXXXXXXXXXXXXXX-XXXXXXXXXXXXXXXXXXXXXXXXXXXXXXXXXXXXXXXXXXXXXXXXXXXXXXX-XXXXXXXXXXXXXXXXXXXXXXXXXXX-XXXXXXXXXXXXXXXXXXXXXXXXXXXXXXXXXXXXXXXXXXXXXXXXXXXXXXX-XXXXXXXXXXXXXXXXXXXXXXXXXXX-XXXXXXXXXXXXXXXXXXXXXXXXXXX-XXXXXXXXXXXXXXXXXXXXXXXXXXX-XXXXXXXXXXXXXXXXXXXXXXXXXXX-XXXXXXXXXXXXXXXXXXXXXXXXXXX-XXXXXXXXXXXXXXXXXXXXXXXXXXX-XXXXXXXXXXXXXXXXXXXXXXXXXXX-XXXXXXXXXXXXXXXXXXXXXXXXXXX-XXXXXXXXXXXXXXXXXXXXXXXXXXX-XXXXXXXXXXXXXXXXXXXXXXXXXXX-XXXXXXXXXXXXXXXXXXXXXXXXXXX-XXXXXXXXXXXXXXXXXXXXXXXXXXX-XXXXXXXXXXXXXXXXXXXXXXXXXXXXXXXXXXXXXXXXXXXXXXXXXXXXXXX
