--------------------------------------------------------------------------------------------------------------------------------------------------------------------------------------------------------------------------------------------------------------------------------------------------------------------------------------------------------------------------------------------------------------------------------------------------------------------------------------------------------------------------------------------------------------------------------------------------------------------------------------------------------------------------------------------------------------------------------------------------------------------------------------------------------------------------------------------------------------------------------------------------------------------------------------------------------------------------------------------------------------------------------------------------------------------------------------------------------------------------------------------------------------------------------------------------------------------------------------------------------------------------------------------------------------------------------------------------------------------------------------------------------------------------------------------------------
-------------------------------------------------------Q-----------------------------------------------------------------------------------------------------------------------------------------------------------------------------------------------------------------------------------------------------------------------------------------------------------------------------------------------Q-------------------------------------------------------------------------------------------------------------------------------------------------------------------------------------------------------------------------------------------------------------------------------------------------------------------------------------------------------------------------------------------------------------------------------------------------------------------------------------------------------------------------------------------------------------------------------------------------------------------------------------------------------------------Q-------------------------------------------------------Q---------------------------Q---------------------------------------------------------------------------------------------------------------------------------------------------------------------------------------------------Q------------------------------------------------------------------------------------
---------------------------------oo---------------------------------------------------------------------------------------------------------------------------------------------------------------------------------------------------------------------------------------------------------------------------------------------------------------------------------------------------------------------------------------------------------------------------------------------------------------------------------------------------------------------------------------------------------------------------------------------------------------------------------------------------------------------------------------------------------------------------------------------------------------------------------------------------------------------------------------------------------------------------------------------------------------------------------------------------------------------------------------------------------------------------------------------------------------------------------------------------------------------------------------------------------------------------------------------------------------------------------------------------------------------------------------------------------------------------------------------------------------------------------------------------------------------
------------------------------XXXXXX---------------------------------------------------------------------------------------------------------------------------------------------------------------------------------------------------------------------------------------------------------------------------------------------------------------------------------------------------------------------------------------------------------------------------------XXX-----------------------------------------------------------------------------------------------------------------------------------------------------------------------------------------------------------------------------------------------------------X------------------------------------------------------------------------------------------------------------------------------------------------------------------------o-----------------------------------------------------------------------------------------------------------------------o--o-------------------------------------------------------------------------------------------------------------------------------------------------------------------------------------------------------------------X--------------------------------------------------------------------------------------------------------------------------------------------------------------------------------------------
---------------------------------------------------------------------------------------------------------------------------------------------------------------------------------------------------------E---------------------------------------------------------------------------------------------------------------------------------------------------------------------------------------------------------------------------------------------------------------------------------------------------------------------------------------------------------------------------------------------------------------------------------------------------------------------------------------------------------------------------------------------------------------------------------------------------------------------------------------------------------------------------------------------------------------------------------------------------------------------------------------------------------------E----------------------------------------------------------------------------------------------------------------------------------------------------------------------------E-------------------------------------------------------------------------------------------------------------------------------------------------------------------------------------------------------------------------------------------------
--------------------------SS--------------------------------------------------------------------E------------------------------------------------------------------SSSSS-----------SSSSSS----------------E--E----------------------------?--E--------SSSSSSS-----Q-Q-QQ---------------------------S?SSSSS----SQSS------------?--E------------------------------------------S------------------------SSSSo--------QQQ----------SSSSSSo--------Q-Q-----------SSSSS---------QQQ-------------SQS---------QQQQ------------------------Q-?QS-----------------------Q---QQQQ-Q-------------------------------------o------?-Q-Q----S--------------------?--E------------SSS---------Q-QQ---------SSSSSS-------?-Q------------------o--------QQQE-----------SSSS---------QQQ-------------------------------------------------------------------------------------------------SSS-------------------------------------SSSSSSS---S--------------------------------------------------------------------------SSSSSS-----------------E--E----------------------------?--------------SSSS---------?-?SSS---------SSSQ---------QQQE---------------------------------------SSSS-----------Q-------------SS----------SSSSSSS-----SSSSS-----------Q-Q------------SSQ----------QQQQ------------SQ----------QQ?SSSS-------SSQQQ-------------------------------------?--------------SSSS--------------------------SQ------------------------SSS----------?-QQ---------------
-----------------------------------------------------------------X-------------------------------XXX-------------------------------------------------------------------------------------------------------XX-XX---o-------------------------XXX-------------------------------------------------------------------------------XXXXX--------------------------------------------------------------------------------------------------------------------------------------------------------------------------------------E---------------------------------------------------------------------------------------------------------------------------XX----------------------------------------------------------------------------------X--------------------------------------------------------------------------------------------------------------------------------------------------------------------------------------------------------------------------------------------------------------------------------X--X-X-----------------------------XX--------------------------------------------------------------------------------------------------------------------------------------------------------------------------------------------------------------------------------------------------------------------------E-------------------------------------------------------------------------------------------------------------
------------------------------------------------------------X------------------------------------------------------------------------------------------------------------------------------------------------------------------------------------------------------------------------------------------------------------------------------------------------------------------------------------------------------------------------------------------------------------------------------------------------------------<>-----------------------------------------------------------------------------------------------------------------------------------------------------------------------------------------------------------------------------------------------------------------------------------------------------------------------------------------------------------------------------------------------------------------------------------------------------------------------------------------------------------------------E--------------------------------------------------------------------------------------------------------------------------------------------------------------------------------------------------------------------------------------------------------------------------------------<>-------------------------------------------------------E-----------------------------------------------------
------------------------E--o------------------E-------------X------------------------------------------------------------------------E------------------------E-----------------------------------------E-------------------------E---E-----------------E------------------------E--------------------------------------E-------------------------E---E--------------E--------E---------------E---------------------------E---------------------------------------E------------------E----------E----------------E-------[]---------------------------------------------------------E-------------------E-------E----------------E----------E-------------------E------------------------E----------E-----------------------------------------E------------------------------E--?-----------------------------------------------------------------------------------E-----------------------------------S---------------------------------------------------------------------------E------------------------------------------------------------<>---------------------E-----E---------------E---------------------------------------E---------------E--S------------------------E--E--------E----------------------------------------------E--------E------------------E--------E------------------E--------E---E----------------------[]---------------E---------------------------E-----------E---E-----------E------------------------------E------
----E-------------E----<>------------Q-------<>-----E------XX---------------Q------E----E---------------------E---------------------<>----------X------------<>-------SS-----------------Q--Q-Q----Q--E<>-----Q-Q----------------<>--<>----------------<>---------QQQQ----------<>----E--<>----E--Q-QQQ---------------E<>--E?-QQQ----QQ----------<>--<>---QQQ-------<>-------<>--------------<>-------?S---------QQQQ----<>--------S----E--Q-QQ-Q----<>----------<>----Q?-Q------S--<>--------E<>--E?SQQQ-------<>-------[]---EE?SQQQ-------<>---QQQ-------Q--Q--Q--QQQQ----------E<>---------------E---E------<>--Q--QQQQ------<>-----Q--E<>----S--------E----<>-----E---E--SQQQ-------<>-----S--E<>--E??QQQ----S------------E----E?SQQQ----<>-----E-------E-E--QQQQQ------<>----Q----------E---------------QQQ--E-------------------------------------------E-----E------------------------------X--E--X------------------------E----------------------------------Q-------------<>----------------------------------------------------E-----Q-[]----S?S--------E----<>----<>------S-------<>-----------E------S-------Q---------?-<>----E?-Q------<>-----E-------E<>--QQ------<>-<>----E?-<>-----------------------------E-E---QQQ-------<>----QQ-<>----E?SQQQ-------<>---QQQ-<>----E?SQQQ-------<>---QQQ-<>--<>----QQ--------------Q-[]----E?S-------<>-----E--S-----------------<>-----E----<>--<>---Q------<>------QQ?--E--<>--SQQQ-------<>----Q-
---<>------------<>----[]--------------------[]----<>-----XXX-------------------------E<>--------------------<>---------------------[]--E-------X------------[]--------------------------------------<>[]------------------------[]--[]----------------[]------------------E----[]----E--[]--------------------------<>[]----------------E-------[]--[]-------------[]-------[]--------------[]-----E-----E<>------------[]-----------E<>------------[]----------[]-----------------[]-------<>[]---------------[]-------[]-----------------[]----------X------------------------<>[]------------------<>------[]---------------[]-------<>[]------------<>----[]----<>--<>-------------[]-------<>[]-------------------E----<><>------------[]----<>-----E<><>-------------[]--------------<>-------------------<>-----------------------------------------E<>----<>-----------------------------XX-<>--XX----------------------<>--SS--------------------------------------------[]--------------------E-----E-------------?----------<>-------[]--------------<>----[]----[]--------------[]----------<>--------------------------[]--------------[]----<>-----E<>[]----------[]-[]-------[]---------------------------E<><>-------------[]-------[]-----------------[]-------[]-----------------[]-------[]--[]----------------------[]--------------[]--E-<>--------------------[]----<>----[]--[]----------[]--E-------<>--[]-------------[]------
---[]------------[]----[]--------------------[]----[]----XXXX------------------------<>[]--------------------[]-----------------X---[]-<>-------X------------[]--------------------------------------[][]------------------------[]--[]--------<>------[]-----------------<>----[]---<>--[]-----------------<>-------[][]---------------<>-------[]--[]-------------[]-------[]--------------[]----------<>[]------------[]-<>-------<>[]------------[]-<>-------[]-----------------<>-------[][]---------------[]-------[]-----------------[]----------X------------------------[][]------------------[]------[]---------------[]-------[][]------------[]----[]----[]-E[]-------------[]-------[][]------------------<>----[][]------------[]----[]----<>[][]-------------[]--------------[]-------------------[]----------------------------------------<>[]----[]----------------------------XXX-[]--XX----------------------[]------------------------------------------------[]----------X-X------<>----<>------o-----------------[]-------[]--------------[]----[]----[]--------------[]----------[]--------------------------[]--------------[]----[]----<>[][]----------[]-[]-------[]--------------------------<>[][]-------------[]-------[]-----------------[]-------[]-----------------[]-------[]--[]----------------------[]--------------[]-<>-[]--------------------[]-<>-[]----[]--[]----------[]-<>-------[]--[]-------------[]------
---[]--------EE--[]----[]-----------------E--[]----[]-----XXX---------------E--E-----[][]-E---------E--------[]-------------E-E-----[]-[]-------X----E-E-EE--[]-E-E-------------------E-EE--------E--[][]---------E-E-----EE-----[]-E[]------E-[]--EE--[]---------------E-[]-X--[]---[]--[]--------E-----E--[]-------[][]--------EE-E---[]-E-----[]--[]-------E--E--[]-E-----[]--------E--E--[]----------[][]---------E--[]-[]-------[][]---------E--[]-[]-E-----[]--------E--E-----[]-E-----[][]---------E-EE--[]----E--[]-----------E-EE--[]----------X------E-----E-----------[][]--------E--E---E--[]-E----[]---------EE----[]-E-----[][]--------EE-E[]-E--[]----[][][]-------E-----[]-------[][]--------EE-EE-----[]----[][]---------E-EXX----[]----[][][]-------EE----[]--------------[]-------------------[]--------------------E-----------------E-[]XX-E--[]------------------------E--XXXX-[]--XX-----------------X----[]--------------------------------------EE-EE-E---[]------E-E-X-X------[]----[]------------------EE----[]-EE-E--[]-----------E--[]E---[]----[]----------EE--[]----------[]--------E--E--------------[]-----------E--[]----[]----[][][]------EE--[]-[]-------[]-----------------EE-------[][][]-------E-----[]-------[]-----------E-EE--[]-------[]-----------E-EE--[]----E--[]--[]-------E-EE--------E--[]--------E--E--[]-[]-[]-----------------E--[]-[]-[]----[]--[]---EE-----[]-[]-------[]--[]-------E-EE--[]------
XXXXXX---XXXXXXXXXXXXXXXXXXXXXXXXXXXXXXXXXXXXXXXXXXXXXXXXXXXXXXXXXXXXXXXXXXXXXXXXXXX-XXXXXXXXXXXXXXXXXXXXXXXXXXXXXXXXX---XXXXXXXXXXXXXXXXXXXXXX-XXXXXXXXXXXXXXXXXXXXXXXXXXXXXXXX---XXXXXXXXXXXXXXXXX-XXXXXXXXXXXXXXXXXXXXXXXXXXX-XXXXXXXXXXXXXXXXXXXXXXXXXXXXXXXXXX--XXXXXXXXXXXXXXXXXXX-XX--XXXXXXXXXXXXXXXXXXXXXXXXXXXXXXXXXXXXXXXXXXXXXXXXXXX-XXXXXXXXXXXXXXXXXXXXXXXXXXX-XXXXXXXXXXXXXXXXXXXXXXXXXXX-XXXXXXXXXXXXXXXXXXXXXXXXXXX-XXXXXXXXXXXXXXXXXXXXXXXXXXXXXXXXXXXXXXXXXXXXXXXXXXXXXXX-XXXXXXXXXXXXXXXXXXXXXXXXXXXXXXXXXXXXXXXXXXXXXXXXXXXXXXXXXXXXXXXXXXXXXXXXXXXXXXX---X-XXXXXXXXXXXXXXXXXXXXXXXXXX-XXXXXXXXXXXXXXXXXXXXXXXXXXXXXXXXXXXXXXXXXXXXXXXXXXXXXXX-XXXXXXXXXXXXXXXXXXXXXXXXXXXXXXXXXXXXXXXXXXXXXXXXXXXXXXXXXXXXXXXXXXXXXXXXXXXXXXXXXXXXXXXXXXXXXXXXXXXXXXXXXXXXXXXXXXXXXXXXXXXXXXXXXXX--XXXXXXX-XXXXXXXXXXXXXXXXXXXXXXXXXXXXXXXXXXXXXXXXXXXXXXXXXXXXXXXXXXXXXX-XXXXXXXXXX-XXXXXXXXX-XX--XX----------XXXXXXXXX-X-XXXXXXXXXXXXXXXXXXXXXXXXXXXXXXXXXXXXXXXXXXXXXXXXXXXXXXXXXXXXXXXXX---XXXXXXXXXXXXXXXXXXX-----XXXXXXXXXXXXXXXXXXX-XXXXXXXXXXXXXXXXXXXXXXXXXXX-XXXXXXXXXXXXXXXXXXXXXXXXXXX-XXXXXXXXXXXXXXXXXXXXXXXXXXX-XXXXXXXXXXXXXXXXXXXXXXXXXXX-XXXXXXXXXXXXXXXXXXXXXXXXXXX-XXXXXXXXXXXXXXXXXXXXXXXXXXXXXXXXXXXXXXXXXXXXXXXXXXXXXXX-XXXXXXXXXXXXXXXXXXXXXXXXXXX-XXXXXXXXXXXXXXXXXXXXXXXXXXX-XXXXXXXXXXXXXXXXXXXXXXXXXXX-XXXXXXXXXXXXXXXXXXXXXXXXXXXXXXXX---XXXXXXXXXXXXXXXXXXXX-XXXXXXXXXXXXXXXXXXXXXXXXXXX-XXXXXXXXXXXXXXXXXXXXXXXXXXX
