--------------------------------------------------------------------------------------------------------------------------------------------------------------------------------------------------------------------------------------------------------------------------------------------------------------------------------------------------------------------------------------------------------------------------------------------------------------------------------------------------------------------------------------------------------------------------------------------------------------------------------------------------------------------------------------------------------------------------------------------------------------------------------------------------------------------------------------------------------------------------------------------------------------------------------------------------------------------------------------------------------------------------------------------------------------------------------------------------------------------------------------------------------------------------------------------------------------------------------------------------------------------------------------------------------------------------------------------------------------------------------------------------------------------------------------------------------
-------------------------------------------------------------------------------------------------------------------------------------------------------------------------------------------------------------------------------------------------------------------------------------------------------------------Q-------------------------------------------------------------------------------------------------------------------------------------------------------------------------------------------------------------------------------------------------------------------------------------------------------------------------------------------------------------------------------------------------------------------------------------------------------------------------------------------------------------------------------------------------------------------------------------------------------------------------------------------------------------------Q-----------------------------------------------------------------------------------------------------------------------------------------------------------------------Q-----------------------------------------------------------------------------------------------------------------------------------------------------------------------------------------------------------------------------------------------------------Q----------------------------
------------------------------------------------------------------------------------------------------------------------------------------------------------------------------------------------------------------------------------------------------------------------------------------------------------------------------------------------------------------------------------------------------------------------------------------------------------------------------------------------------------------------------------------------------------------------------------------------------------------------------------------------------------------------------------------------------------------------------------------------------------------------------------------------------------------------------------------------------------------------------------------------------------------------------------------------------------------------------------------------------------------------ooo-----------------------------------------------------------------------------------------------------------------------------------------------------------------------------------------------------------------------------------------------------------------------------------------------------------------------------------------------------------------------------------------------------------------------------
------------------------------------------------------------XXXX------------------------------------------------------------------------------------------------------------------------------------------------------------------------------------------------------------------------------------------------------------------------------------------------------------------------------------------------------------------------------------------------------------------------------------------------------------------------------------------------------------------------------------------------------------------------------------------------------------------------------------------------------------------------------------------------------------------------------------------------------------------------------------------------------------------------------------------------------------------------------------------------------------------------------------------------------XXXXXX----------------------------------------------------------------------------------------------------------------------------------------------------------------------------------------------------------------------------------------------------------------------------------------------------------------------------------------------------------------------------------------------------------------------------
--------------------------------------------------------------------------------------------------------------------------------------------------------------------------------------------------------------------------------------------------------------------------------------------------------------------------------------------------------------------------------------------------------------------------------------------------------------------------------------------------------------------------------------------------------------------------------------------------------------------------------------------------------------------------------------------------------------------------------------------------------------------------------------------------------------------------------------------------------------------------------------------------------------------------------------------------------------------------------------------------------------------------------------------------------------------------------------------------------------------------------------------------------------------------------------------------------------------------------------------------------------------------------------------------------------------------------------------------------------------------------------------------------------------------------------------------------
---------?-?E-----------SSSS-------------------------------------------------SSSSSSQ---------Q---------------------------Q-QQQQQQ--------------------QQQQQQ-------Q-QQQQ----------------------SSSSSS---------???------------SSSS---------Q--E---------------------------SSSS-------------------------------------SSS------------------------------------------------------------------------------------------------SSSS---Q---Q-------------------------------S---------------------------S-------------------------------------SS?SSSS--------SSSS---------QQQ------------SSS----------SS?SSSS--------SSS--------?QQQQ--------------Q------------?-------------------------?--E---------------o--------Q-Q------------SSS-----------------------------o------------SSSS----SSSSSSS----------SSSSSS--------------------------------------Q---------SSS-----------SSSSSS---------------------------------------------------------------------------------SQQ-------?-QQ?E--------------------------?SSSS-----SSSSSSS----------------------SSSSSS-----------Q---------------------------Q--------------Q--------------SSS---------------------QQQE------------SQS--------------------------------------------------------------------SSSS---Q--------------------------------SSSS-------------------------------------------------------------------------------------------------------------------------?S-------------SSSS----------S--SSS------------
-----------XXXXX------------------------------------------------------------------------------------------------------------------------------------------------------------------------------------------------------------------------------X------------------------------------------------------------------------------------------------------------------------------------------------------------------------------------------------------------------------------------------------------------------------------------------------------------------------------------------------------------------------------------------------------------o------XX-----------XXXXX---o------X--------------------------------------------------------------------------------------------------------------------------------------------------------------------------------------------------------------------------------------------------------------------------XXX----------------------------------------------------------------------------------------------------------------------------------------------------------------------XX----------------------------------------------------------------------------------------------------------------------------------------------------------------------------------------------------------------------------------------------E-----------------------------------------------------
--------------Q-----------------------------------------------------------------------------------------------------------------------------------------------------------E-------------------------------------------------------------------------------------------------------------------------------------------------------------------------------------------------------------------------------------------------------------------------------------------------------------------------------------------------------------------------------------------------------------------------------------------------------------------------------X-X-------------------------XXXXXXXXXX--------------------------------------------------------------------------------------------------------------------------------------------------------------------------------------------------------------------------------------------------------------------------Q-----------------------------------------------------------------------------------------------------------Q---------------------------------------------------------------------------------------------------------------------------------------------------------------------------------------------------------------------------------------------------------------------------E------------------------------<>-----------------------------------------------------
--E---E-----------------E--o---------------------E--?-----E---------------E------------------------------E------------E------------------------------------------E-------<>---------------E--E----------E-------------------------E---------------------------------------------------------E-------------------E---------------------------------------------------------------E-----------------------------------------------------E-----------------------------E-------------------E----------------------------------------------------E--------E---------------E--E------------------------------------E---------------E--E------------------------------------------------------------------E---------------------------E---------------------------------------------------------------------------------E---------------E--E------------------------E----------------------------------------------------------E----------E-------------E--E--------E---E-----------E-----------E-------------------------------------------E-----------E------------------E----------------------------------------E-----------------------E---------------E--E---------XS--------------------------------------------E--------------------------------------o-------------------E-------------------------------------------------------------------------------------E----------------------E-------[]---------------E--E----------------------------------
-<>--<>---QQQ----------<>-----------------------<>-------<>--------------<>--------S---------Q----------<>--------E--<>---QQQQQQ---------QQQ-------E-QQQQ-------<>---QQQ-[]----E---------<>-<>---E?S--E<>----S-------------------<>----E?SQQQ-------<>---QQQ--E----------------------------<>-------------E----<>------------------------------?---XX--------------Q-----------<>-------------------------E----------------Q-QQ------<>----E---------<>-----E-----E<>-------------E----<>-----E----Q--QQQQ----------------E-E---------------<>-------<>----E?QQ------<>-<>---QQQ-----<>----------------------<>----E?SQ------<>-<>---QQQ----E<>---QQQ----Q--QQ---Q-Q--E---E--SQQQQ---Q-Q----------E<>-----QQQQ---Q------------E<>-----QQQ----Q----------------E---QQQQQ--------------------------------------QQQ-<>----E--QQQ----<>-<>----Q---------------Q--<>-----E---------------------------------E-----------------<>--------E<>---QQQ------<>-<>-------<>--<>--SQQQ----------------<>------------------------------------------<>-----E--S-<>----E--QQ--------<>--------E----E--QQQ-------------Q---E--<>----------------------<>---E--SQQQ----<>-<>-----S--XXXX-----------Q------------------------------<>----Q---E------XX-----------------------------------E----<>--------------------E-------------<>-----Q-QQ------------------E---------------E----<>---E-----?-----------<>-------[]---EE-S-------<>-<>-----------------QQ---------------
-[]--[]----------------[]-----------------------[]-------[]--------------[]-----------E-----------------[]-------<>--[]-----------------------E-----------------[]-------[]--------------[]-[]-------<>[]----------------E-------[]-----------------[]-------<>----------------------------[]------------<>----[]---------------------------------XXX--------------------------[]------------------------<>--XX----------------------[]--------------[]----<>----<>[]------------------[]----<>--------------------------<><>---------------[]-------[]--------------[]-[]-----------[]--------------E-------[]--------------[]-[]--------E<>[]----------------------<>--<>----------------------<>[]------------------------<>[]----------------E--------E------------------------------------------E-----------[]--------------[]-[]-----------------------[]--------------------------------------<>-----------------[]-------<>[]------------[]-[]--E----[]--[]-----------------E----[]------------------------------------------[]----<>----[]-----------------[]-------<><>------------------------<>--[]-----------------E----[]--<>----------[]-[]-------XXXXX------------------------------------------[]-------<>----XXXX---------------------------------E<>----[]-------------------<>-------------[]--------------------------<>-----E--------<>----[]--<>-----------------[]-------[]--------------[]-[]----------------------------------
-[]--[]----------------[]-----------------------[]-------[]--------------[]----------<>-------------X---[]-------[]--[]-------------<>-------<>-----------------[]-------[]--------------[]-[]-------[][]---------------<>-------[]-----------------[]-------[]----------------------------[]------------[]----[]----------------------------------XX--------------------------[]------------------------[]--------------------------[]--------------[]----[]----[][]------------------[]----[]--------------------------[][]---------------[]-------[]--------------[]-[]-----------[]----------------------[]--------------[]-[]-------<>[][]----------------------[]--[]----------------------[][]------------------------[][]---------------<>-------<>-----------------------------------------<>-----------[]--------------[]-[]----------X------------[]--------------------------------------[]-----------------[]-------[][]------------[]-<>-<>----[]--[]----------------<>----[]------------------------------------------[]----[]----[]-----------------[]-------[][]------------------------[]--[]----------------<>----[]--[]----------[]-[]------XXXXXX-----------------------<>-----------------[]-------[]---XXXXXX-------------------------------<>[]----[]-------------------[]-------------[]--------------------------[]----<>--------[]----[]--[]-----------------[]-------[]--------------[]-[]----------------------------------
-[]-E[]----E--E-EE-E---[]--------EE-----E-E-----[]-------[]------E-EE-E--[]----------[]-----E-----E-E---[]-------[]--[]----E-EE-----[]-------[]-----------EE----[]-------[]--------E--E--[]-[]-------[][]--E------E-EE--[]-------[]-----------E-EE--[]----E--[]--E-------------------------[]---------E--[]E---[]----------------EE-EE----------X-XXX--E------E-EE-----E-------[]---------E-EE------E-E--[]--------------E-----------[]--------E--E--[]E---[]----[][]---------E-EE-E---[]----[]----------E--EE----E------[][]---------E-EE--[]-E-E---[]-----------E--[]-[]-----------[]-------E-EE---XX--E---[]--EE-E-----E--[]-[]-------[][][]---------E-------E-E--[]--[]-------E-EE-----------[][]--------EE-EE-----------[][]--------EE-EE--[]-E-----[]-----------E-----E-----------E-E---------[]-----------[]-----------E--XX-[]----------X-----EE-EE--[]-E---------------------EEE------------[]------E-E--EE----[]-------[][]---------E--[]-[]-[]----[]--[]----E-EE--E-----[]----[]----------EE----E--------------------E-E--[]----[]----[]--------EE-EE----[]-------[][]---------E-EE-----E-----[]-E[]------E---------[]----[]--[]-------E--[]-[]------XXXXXX-------EE-EE-----E-----[]---E--E-EE-EE----[]-E-EE--[]--XXXXXXX----------EE--------------E----[][]-E--[]---------------E-E-[]-------------[]--------EE-EE-------------[]----[]----EE--[]----[]--[]---------E-E-----[]-------[]-----------E--[]-[]--------------------E-EE-----E-EE-
-XXXXXXXXXXXXXXXXXXXXXXXXXXXXXXXXXXXXXXXXXXXXXXXXXX-XXXX-XXXXXXXXXXXXXXXXXXXXXXXXXXX-XXXXXXXXXXXXXXXXXXXXXXXXXXX-XXXXXXXXXXXXXXXXXXXXXXXXXXX-XXXXXXXXXXXXXXXXXXXXXXXXXXX-XXXXXXXXXXXXXXXXXXXXXXXXXXX-XXXXXXXXXXXXXXXXXXXXXXXXXXX-XXXXXXXXXXXXXXXXXXXXXXXXXXX-XXXXXXXXXXXXXXXXXXX-X-XXXXXXXXXXXXXXXXXXXXXXXXXXXXXXXXXXXXXXX---XXXXXXXXXXXXXX--XXXXXXX-XXXXXXXXXXXXXXXXXXXXXXXXXXXXXXXXXXXXXXXXXXXXXXXXXXX-XX--XX--X-XXXXXXXXXXXXXXXXXXXXXXXXXXXXXXXXXXXXXXXXXXXXX-XXXXXXXXXXXXXXXXXXXXXXXXXXX-XXXXXXXXXXXXXXXXXXXXXXXXXXX-XXXXXXXXXXXXXXXXXXXXXXXXXXX-XXXXXXXXXXXXXXXXXXXXXXXXXXXXXX--XX--XXXXXXXXXXXXXXXXXXXXXXXXXXXXXXXXXXXXXXXXXXXXXXX-XXXXXXXXXXXXXXXXXXXXXXXXXXX-XXXXXXXXXXXXXXXXXXXXXXXXXXX-XXXXXXXXXXXXXXXXXXXXXXXXXXXXXXXXXXXXXXXXXXXXXXXXXXXXXXX-XXXXXXXXXXXXXXXXXXXXXXXXXXXXXXXXXXXXXXXXXXXXXXXXXXXXXXXXXXXXXXXXXXXXXXXXXXXXXXXXXXXXX--XXXXXXXXXXXXXXXXXXXXXXXXXXXXXX---XXXXXXXXXXXXXXX-XXX-XXXXXXXXXXXXXXXXXXXXXXXXXXX-XXXXXXXXXXXXXXXXXXXXXXXXXXX-XXXXXXXXXXXXXXXXXXXXXXXXXXX-XXXXXXXXXXXXXXXXXXXXXXXXXXXXXXX---XXXXXXXXXXXXXXXXXXXXX-XXXXXXXXXXXXXXXXXXXXXXXXXXXXXXXXXXXXXXXXXXXXXXXXXXXXXXX-XXXXXXXXXXXXXXXXXXXXXXXXXXX-XXXXXXXXXXXXXXXXXXXXXXXXXXXXXXX-----XXXXXXXXXXXXXXXXXXX-XXXXXXXXXXXXXXXXXXXXXXXXXXX-XXXXXXXXX---X---XXXXXXXXXXXXXXXXXXXXXXXXXXXXXXXXXXXXXXXXXXXXX---XXXXXXXXXXXXXXXXXXXXXXXXXXXXXXXXXXXXXXXXXXX-XXXXXXXXXXXXXXXXXXXXXXXXXXXXXXX-XXXXXXXXXXXXXXXXXXXXXXXXXXX-XXXXXXXXXXXXXXXXXXXXXXXXXXXXXXX-XXXXXXXXXXXXXXXXXXXXXXX
