--------------------------------------------------------------------------------------------------------------------------------------------------------------------------------------------------------------------------------------------------------------------------------------------------------------------------------------------------------------------------------------------------------------------------------------------------------------------------------------------------------------------------------------------------------------------------------------------------------------------------------------------------------------------------------------------------------------------------------------------------------------------------------------------------------------------------------------------------------------------------------------------------------------------------------------------------------------------------------------------------------------------------------------------------------------------------------------------------------------------------------------------------------------------------------------------------------------------------------------------------------------------------------------------------------------------------------------------------------------------------------------------------------------------------------------------------------
---------------------------------------------------------------------------------------------------------------------------------------------------------------------------------------------------------------------------------------------------------------------------------------------------------------------------------------------------------------------------------------------------------------------------------------------------------------Q-------------------------------------------------------------------------------------------------------------------------------------------Q-------------------------------------------------------------------------------------------------------------------------------------------------------------------------------------------------------------------------------Q-------------------------------------------------------------------------------------------------------------------------------------------------------------------------------------------------Q----------------------------------------------------------------------------------------------------------------------------------------------------------------------------------------------------------------------------------------------------------------------------------------------------------------------------------------------------------------------------------------------------------
------------------------------------------------------------------------------------------------------------------------------------------------------------------------------------------------------------------------------------------------------------------------------------------------------------------------ooo-----------------------------------------------------------------------------------------------------------------------------------------------------------------------------------------------------------------------------------------------------------------------------------------------------------------------------------------------------------------------------------------------------------------------------------------------------------------------------------------------------------------------------------------------------------------------------------------------------------------------------------------------------------------------------------------------------------------------------------------------------------------------------------------------------------------------------------------------------------------------------------------------------------------------------------------------------------------------------------------------------------------------------------------------------------------------------------------------------------------------------
----------------------------------------------------------------------------------------------------------------------------------------------------------------------------------------------------------------------------------------------------------------------------------------------------------------------X-XXXX-----------------------------------------------------------------------------------------------------------------------------------------------------------------------------------------------------------------------------------------------------------------------------------------------------------------------------------------------------------------------------------------------------------------------------------------------------------------------------------------------------------------------------------------------------------------------------------------------------------------------------------------------------------------------------------------------------------------------------------------------------------------------------------------------------------------------------------------------------------------------------------------------------------------------------------------------------------------------------------------------------------------------------------------------X----------------------------------------------------------------------------
--------------------------------------------------------------------------------------------------------------------------------------------------------------------------------------------------------------------------------------------------------------------------------------------------------------------------------------------------------------------------------------------------------------------------------------------------------------------------------------------------------------------------------------------------------------------------------------------------------------------------------------------------------------------------------------------------------------------------------------------------------------------------------------------------------------------------------------------------------------------------------------------------------------------------------------------------------------------------------------------------------------------------------------------------------------------------------------------------------------------------------------------------------------------------------------------------------------------------------------------------------------------------------------------------------------------------------------------------------------------------------------------------------------------------------------------------------
-------------------------SSS---------?--E------------SSS-----------Q-------------------------------------------------------Q-QQS------?-SSQS---------SSS-----------------------?-QQ-----------------------------SSSS---Q-SSS-----------------------------SQQ-----------------------SSSSS------------------------SSSS---------------------SQSSSSS-----------?SSSSS----?-S-------------?--E-------------SS---------------------SSSSSSS-------------------------SQS---------------------SSSSSSS---------?---------------SQQ-----------?QSSS------QSSS-------------------------------------------------------SQQ-----------Q------------S---------------------------------------------------------?S-------------------------------------QQQ------------SSSS---------Q-QE------------------------Q-?QSSSS------------------------------------SQQ-------------------------SSS-----------------------------------?-QQQQ---------------------------SSSSS---------------------------------SSSSS----------?-----------SSSSSSS---------?-?Q----------SSSSS-------------SS-------Q-SSS-------------------------SSSS---------Q-Q--------------Q----------?-?QS-------------------------------------------------------------------SSS-------------------------------------------------SSSS------------QQQ-S-----------------------Q---SQS-----SQSSSS------------------------SSSSQ---------Q-----SS---------S----------???S-----------SSSS---------?SSS---------------
----------------------------------------X-X-------------------------------------------------------------------------------------------------------------------------------E----------------------------------------------------------------------------------------------------------------------------------------------------------------------------------------------------------------------------------------------------------------------------------------------------------------------------------------------------------XXX------------------------------------------E-------------------------------------------------------------------------------------------------------------------------------------------------------------------------------------------------------------------------------------------------------------------------------------------------------------------------------X---------------------------------------------------------------------------------------------------------------XX-------------------------------------------------------------------------------------------------------------------------------------------------------------------------------------------------------------------------------------------------------------------------------------------------------------------------------------------------------------------------XXX----------------------------------------
--------------------------------------------------------------------------------------------------------------------------------------------------------------------X----<>-----------------------------------------------------------------------------------------------------------------------------------------------------------------------------------------------------------------------------------------------------------------------------------------------------------------------------------------------------------Q------------------------------------------<>-----------------------------------------------------------------------------------------------------------------------------------------------------------------------------------------------------------------------------------------------------------------------------------------------------------------------------------------------------------------------------------------------------------------------------------------------Q-------------------------------------------------------------------------------------------------------------------------------------------------------------------------------------------------------------------------------Q-------------------------------------------------------------------------------------------------------------------------------------------Q-----------------------------------------
--E---------------E-----E--o------------------------E--o---------------------E------------------------E----------------------------------------------------------E--X----[]---------------E--E------------E---------------------------------------E-----------E---------------E-----------E---------------E--E------------------------E---------------E-----------------------E---------------E-----------E---------------E---------------------------E-----------E---------------E-----E-----E---------------E---------------E-------------------------E-------------------E----[]---------------E-------------E--------------------------------E------------------------------------------E---------E--------------E---------------------------E--------E-E-------------E-----------E---E--------------E--------E---------------E--E------------------------E-----E--o---SSS-----------E---E--------E-E-------------E--E------------E---------------------------E-----------E--E--------E---------------E-----------E---------------E---------------E---------------------------------------------------E-------------------------------E-----------------------E---------------E--S----------------------------------------oo--------------------------E------------------------------------------E--------E---E---------------------------------------E--E------------E--------------E--?-------E----------------E----------E---------------<>--?---
-<>--------------<>----<>-----------?S-------<>----<>------------QQQ--------<>--------E--------------<>---------------E---Q-QQ-------------S-----------------E--<>-------[]----E?S-------<>--E------o----<>----QQQ---QQQ-QQ--------->------------<>-----E--S-<>---E---Q------<>------E?S-<>--------------<>-<>---E?S--E---E----------<>------S?S-----<>---QQQQQQ-Q--Q--------<>------Q-------<>-----E----<>---E----------<>-----E??S-----------------<>--------S-<>----E--Q------<>----<>----<>---E---QQQ----<>------QQ?--E--<>---QQQQ---Q--Q-Q--------<>------------<>----<>----[]--------------<>--------S---<>----<>------Q--Q----Q-Q--------<>--------------------E--------------------<>-----E--<>---QQQQ------<>--------E----E?SQQQ-------<>-------<><>--E?SQQQ----<>----------<>--<>---QQQQ------<>---QQQ-<>------Q-------<>-<>----ES-----------------<>----<>-----XX------------<>--<>-------<><>--E?SQQQ----<>-<>-----------<>-------------------E---E--<>--QQ------<>-<>---QQ?-<>--------------<>-------ES-<>---EE-SQQQ----<>--------S--E--<>---QQQQ------<>---QQQ--E--------------------------<>----E?-Q--------------QQQ--E--<>----QQ-------Q----QQQ-<>------S-------<>-----E-----------Q--------<>----<>---------------------------------E--<>---QQQQ-------S--------E----E?-QQQ-------<>---QQQ-<>--<>---Q-Q-Q--XX------QQ?---------Q-------<>-<>---EES--E--<>---Q---------<>---QQQ--E<>---?SQQQ-------<>--------E<>---?--------E--[]------
-[]--------------[]----[]-----E--------------[]----[]-----------------------[]-------<>--------------[]--E-----------<>---------------------------------<>--<>--[]--X----[]--------------[]--E--E--------[]-----------------------E[]------------[]----<>----[]--<>----------[]----------[]--------------[]-[]-------<>--<>----------[]--------------[]--------------E-------[]--------------[]----<>----[]--<>----------[]----<>--------------------[]-----E----[]--------------[]----[]----[]--<>----------[]----------<>--[]------------------------[]------------[]----[]----[]--------------[]-----------E[]----[]-------------------------[]-------------E-----<>--------------E-----[]----<>--[]-------------[]-------<>-----------------[]-------[][]------------[]----------[]--[]-------------[]-------[]--------------[]-[]--E--------------E-----[]----[]---XXXX-SS---------[]--[]-------[][]------------[]-[]--------E--[]-------------E----<>--<>--[]----------[]-[]-------[]--------------[]-------X--[]--------------[]--E--E----<>--[]-------------[]-------<>--------------------------[]------------------E-------<>--[]----------------------[]-------------E[]----<>--------------------[]----[]----ES---S----------------------<>--[]----------------------<>-----------------[]-------[]--[]-----------------------E--------------[]-[]-------<>--[]-------------[]-------<>[]---------------[]-------<>[]-----------<>--[]------
-[]--------------[]----[]----<>--------------[]----[]-----------------------[]-------[]--------------[]-<>-------<>--[]---------------------------------[]--[]--[]--X----[]--------------[]-<>-<>--------[]----------------------<>[]------------[]----[]----[]--[]----------[]----------[]--------------[]-<>-------[]--[]----------[]----------<>--[]-------------<>-------[]--------------[]----[]----[]--[]----------[]----[]--------------------[]-<>-<>----[]--------------[]----[]----[]--[]----------[]-<>-------[]--[]------------------------[]------------[]----[]----[]--------------[]-<>-------<>[]----[]-------------------------[]------------<>-----[]--------------X-----[]----[]--[]-------------[]-------[]-----------------[]-------[][]------------[]----------[]--[]-------------[]-------[]--------------[]-<>-----------------------[]----[]---XXXX------------[]--[]-------[][]------------[]-[]-------<>--[]------------<>----[]--[]--[]----------[]-[]-------[]--------------[]--------X-[]--<>----------[]-<>-<>----[]--[]-------------[]-------[]-----------------<>-------[]-----------------<>-------[]->[]-------------<>-------[]------------<>[]----[]----<>--------------[]----[]---XXo--------------------------[]--[]--------------------X-[]-----------------[]-------[]--[]-------------<>-------<><>------------[]-[]-------[]--[]-------------[]-------[][]---------------[]-------[]-------------[]--[]------
-[]---E-E--EE-E--[]----[]----[]-----E-----E--[]-E--[]---------------E-EE----[]-------[]-------EE-E---[]-[]----XX-[]--[]------EE--------------------E-E--[]--[]--[]--X----[]--------E--E--[]-[]-[]--------[]---------E---E--------[][]--------EE--[]----[]----[]--[]----E--E--[]----------[]-------EE-----[]-[]-------[]-E[]---EE--E--[]----------[]--[]-------------[]-------[]----------EE--[]----[]----[]--[]---EE--E--[]----[]--------EE-------E--[]-[]-[]----[]-------EE-EE--[]----[]----[]--[]----E--E--[]-[]-------[]-E[]---------E---E----------[]---------E--[]----[]----[]-----EE-E--E--[]-[]-------[][]----[]---E-EE-----E--E---EE-E--[]------------[]-----[]--EE-------E-EX-E---[]----[]--[]-------E-EE--[]-E-E---[]-----------E--E--[]-E-E---[][]--------EE-EE-----------[]-E[]-------E-EE--[]----E--[]--------E--E--[]-[]--------------------E--[]----[]---XXXX--EE-E------[]--[]-------[][]--------EE--[]-[]-------[]--[]---------E--[]E---[]--[]--[]----E-E---[]-[]-------[]--------E-EE--[]-------XX-[]--[]----E--E--[]-[]-[]----[]-E[]-------E--E--[]-E-EE--[]--E------E-E--E--[]-E-----[]--------E--E-EE--[]-E--E--[][][]-------E-EE--[]-E--E--[]-----E----E-[][]----[]----[]--------E--E--[]----[]----------------EE-E----E-------[]--[]------EE-E-----E---XX-[]-----------E-----[]-------[]--[]---EE-E------[]-------[][]---------E--[]-[]-------[]--[]----E--EE----[]-------[][]---------E-----[]-------[]---E---------[]--[]------
-XXXXXXXXXXXXXXXXXXXXXXXXXXX-XXXXXXXXXXXXXXXXXXXXXXXXXXXXXXXXX-XXXXXXXXXXXXXXXX-XX-X-XXXX--XXXXXXXXXXXXXXXXXXXXX-XXXXXXXXXXXXXXXXXXXXXXXXXXXXX-X---X-XXXXXXXXXXXXXXXXXXX-XXXXXXXXXXXXXXXXXXXXXXXXXXXXXXXXXXXXXXXXXXXXXXXXXXXXXXX-XXXXX-XXXXXXXXXXXXXXXXXXXXX-XXXXXXXXXXXXXXXXXXXXXXXXXXX-XXXXXXXXXXXXXXXXXXXXXXXXXXX-XXXXXXXXXXXXXXXXXXXXXXXXXXXXXXXXXXXXXXXXXXXXXXXXXXXXXXX-XXXXXXXXXXXXXXXXXXXXXXXXXXX-XXXXXXXXXXXXXXXXXXXXXXXXXXXXXXXXXXXXXXXXXXXXXXXXXXXXXXX-XXXXXXXXXXXXXXXXXXXXXXXXXXX-XXXXXXXXXXXXXXXXXXXXXXXXXXX-XXXXXXXXXXXXXXXXXXXXXXXXXXXXXXXXXXXXXXXXXXXXXXXXXXXXXXX-XXXXXXXXXXXXXXXXXXXXXXXXXXX-XXXXXXXXXXXXXXXXXXXXXXXXXXXXXXXXXXXXXXXXX---XXXXXXXXXXXXXXXXXXXXXXXXXXXXXXXXXXXXXXXXXXXXXXXXXXXXXXXXXXXXXXXXXXX-XXXXXXXXXXXXXXXXXXXXXXXXXXXXXXXXXXXXXXXXXXXXXXXXXXXXXXX-XXXXXXXXXXXXXXXXXXXXXXXXXXX-XXXXXXXXXXXXXXXXXXXXXXXXXXXXXXXXXXXXXXXXXXXXXXXXXXXXXXXXXXXXXXXXXXXXXXXXXXXXXXXXXXX-XXXXXXXXXXXXXXXXXXXXXXXXXXXXXXXXXXXXXXXXXXXXXXXXXXXXXXXXXXXXXXXXXXXXXXXXXXXXXXXXXXX-XXXXXXXXXXXXXXXXXXXXXXXXXXXXXXXXXXXXXXXXXXXXXXXXXXXXXXX-XXXXXXXXXXXXXXXXXXXXXXXXXXX-XXXXXXXXXXXXXXXXXXXXXXXXXXX-XXXXXXXXXXXXXXXXXXXXXXXXXXXXXXXXXXXXXXXXXXXXXXXXXXXXXXX-XXXXXXXXXXXXXXXXXXXXXXXXXXX-XXXXX-XXXXXXXXXXXXXXXXXXXXXXX-XXX---XXXXXXXXXXXXXXXXXXXXXXXXXXXXXXXXXXXXXXXXXXXXXXX-XXXXXXXXXXXXXXXXXXXXXXXXXXXXXXXXXXXXXXXXXXXXXXXXXXXXXXX-XXXXXXXXXXXXXXXXXXXXXXXXXXXXXXXXXXXXXXXXXXXXXXXXXXXXXXXXXXXXXXXXXXXXXXXXXXXXXXXXXXXXXXXXXXXXXXXXXXXXXXXXXXXXXXX
