--------------------------------------------------------------------------------------------------------------------------------------------------------------------------------------------------------------------------------------------------------------------------------------------------------------------------------------------------------------------------------------------------------------------------------------------------------------------------------------------------------------------------------------------------------------------------------------------------------------------------------------------------------------------------------------------------------------------------------------------------------------------------------------------------------------------------------------------------------------------------------------------------------------------------------------------------------------------------------------------------------------------------------------------------------------------------------------------------------------------------------------------------------------------------------------------------------------------------------------------------------------------------------------------------------------------------------------------------------------------------------------------------------------------------------------------------------
-------------------------------------------------------------------------------------------------------------------------------------------------------------------------------------------------------------------------------------------------------------------------------------------------------------------------------------------------------------------------------------------------------------------------------------------------------------------------------------------Q---------------------------------------------------------------------------------------------------------------------------------------------------------------------------------------------------------------------------------------------------------------------------------------------------------------------------------------------------------------------------------------------------------------------------------------------------------------------------------------------------------------------------------------------------------------------------------------------------------------------------------------------------------------------------------------------------------------------------------------------------------------------------------------------------------------Q--------------------------------------------------------------------------------------------------------------------------------------------
---------------------------------------------------------------------------------------------------------------------------------------------------------------------------------------------------------------------------------------------------------------------------------------------------------------------------------------------------------------------------------------------------------------------------------------------------------------------------------------------------------------------------------------------------------------------------------------------------------------------------------------------------------------------------------------------------------------------------------------------------------------------------------------------------------------------------------------------------------------------------------------------------------oo---------------------------------------------------------------------------------------------------------------------------------------------------------------------------------------------------------------------------------------------------------------------------------------------------------------------------------------------------------------------------------------------------------------------------------------------------------------------------------------------------------------------------------------------
-----------------------------------------------------------------------------------------------------------------------------------------------------------------------------------------------------------------------------------------------------------------------------------------------------------------------------------------------------------------------------------------------------------------------------------------------------------------------------------------------------------------------------------------------------------------------------------------------------------------------------------------------------------------------------------------------------XXX-------------------------------------------------------------------------------------------------------------------------------------------------------------------------------------------------XXX--------------------------------------------------------------------------------------------------------------------------------------------------------------------------------------------------------------------------------------------------------------------------------------------------------------------------------------------------------------------------------------------------------------------------------------------------------------------------------------------------------------------------------------------
-------------------------------------------------------------------------------------------------------------------------------------------------------------------------------------------------------------------------------------------------------------------------------------------------------------------------------------------------------------------------------------------------------------------------------------------------------------------------------------------------------------------------------------------------------------------------------------------------------------------------------------------------------------------------------------------------------------------------------------------------------------------------------------------------------------------------------------------------------------------------------------------------------------------------------------------------------------------------------o-----------------------------------------------------------------------------------------------------------------------------------------------------------------------------------------------------------------------------o------------------------------------------------------------------------------------------------------------------------------------------------------------------------------------------------------------------------------------------
------------------------------------------------------------------------------S--SSS------------------------------------------------------QQ-------QQQQQ-------------------------------------------X---------------------------------------------------------------?-QQQQ------------------------QQQ-------------SS----------------------SSSSSSS-------?-QQ-------------SSSS-------SS-------------------------------SSSS-------------------------------------SSS------------------------SSQQ----------------------------------------QSSSS--------SSS---------Q----------------------------QQ-----------SSSSS---------?--E------------------------Q------S-----------------------------------SSSS-------------------------SSS-------------------------SSS---------?--E------------------------?-----------------------------------------------------------------------SQQ--------------------------SS------------------------SSS----------------------------------------------------------------------SSS----------SS-------------------------SSS---------Q-------------------------------------------------------???SS-------SSSSSSS------------------------------------SSSS---------------------------------X---------------------------------------------------------------------------?------------SSSSSS---------QQQ-----------------------------------------------------------------------S--------------------------------------------------S-SSSS
----------------------------------------------------------------------X---------------------------------------------------------------------------------------------------------------------------------------------------------------------------------------------------------------------------------------------------------------------------------------------------------------------------------------------------------------------------------------------------------------------------------------------------------------X---------------------------------------------------------------------------------XXXX--------------------------------------XX------------------------------------------------------------------------------------------------------------------------------XX----------XX-----------------------------------------------------------------------------------------------------------------------------------------------------------------------------------------------------------------------------------------------------------------------------------------------------XXX--------------------------------------------------------------------------------------------------------------------------------------------------------------------------------------------------------------------------------------------------------------------------------------------------------------------------------
-----------------------------------------------------------------------------------------------------------------------------------------------X----------------------------------------------------------------------------------------------------------------------------------------------------------------------------------------------------------------------------------------------------------E-------------------------------------------------------E--------------------------------------------------------------------------------------------------------------------------------------------------------------------------------------------------------------------------------------------------------------------------------------------------------------------------------------------------------------------------------------------------------------------------------------------------------------------------------XX--XX--------------------------------------------------------------------------------------------------------------------------------------------------------------------------------------------------------------------E--------------------------------------------------------------------------------------------------------------------------------------------------------------------------------------------------------------------------------------------------------------------------
----E----------------E----------------------------------------------------------E---------------------------------E---------------E-----------ES-----------------E------------------------------------E-------------------------------------------------E--o--E------------------E------------E--------------E--------E---E-----------E--S-------<>---------------E--E-----------------------------------<>-------------------------------------------E-----E----<>---------------E------------------------------E--------E----------------------------------------------E--------E------------------E----------E-------------E---------------E-----------------------E---------------E--E------------------------E-----------E---------------E-----------E---------------E---------------E-----------------------E---------------E-----------E------------------E--------E---------------------E-------------------------------------------------E-----------------------------------o---E---------------------E---------------------E-----E--o---------------------E-----------------------------------------------------------------------------------E---------------E--<>-------------------o------------------------------------------------------E----------------E-------<>---------------E-----E------------------------E---------------------------S------------------------------E---------E--------------E----------------------------------
---<>------------E--<>-----------------------------E------E--<>--S--------E----<>-------E-----------<>-----------<>--------------<>-----E----<>----E?-QQ--------<>---QQQ-------------------------QQQ-<>------------------E----------------Q-------E----<>----<>---EE?-QQQQ------<>---QQQ-----<>--QQQQ-------<>---QQQ-<>--<>--Q-------<>-----E----[]----E?QQ------<>-<>-----------------------XXX---------[]---E-------------<>---QQQ--E--------------<>----<>----[]--------------<>------E?S--------------------<>---QQQ-<>---E---Q-Q-Q---E-----E-----------------------<>-----Q-<>----Q--Q---------<>--------E<>----S-------<>-----------E--<>---QQQQ---Q--Q----QQQ-<>--------------<>-<>-----S--E----E--Q------<>----------<>--------------<>-----E----<>----E?S-------<>-----------E--<>---QQQQ---Q--<>---Q-Q-<>------Q-------<>-----E----<>----E-QQ------<>-<>---QQ?-<>--------------<>----<>--------------------------<>--------------------<>--------------------------------------<>--X--------Q--------<>--------------------<>----<>----Q-----QQQQQ--------<>-----------------------E------------E-><>--S--------------E-----------------------<>---QQQ---E----<>--[]-------E---E---------------------------------------S----------E-----E----<>---QQQ------<>-<>--E----[]----E---------<>----<>----------Q------------<>-----Q--------------------------------E------------------<>-----E--<>---QQQ-------<>-----------------------------E----
---[]-----------<>--[]---------------X------------<>-----<>--[]----------<>----[]------<>-----------[]---E-------[]--------------[]----<>----[]-----------------[]--------E--------------------------[]------------E----<>-E---------------------<>----[]----[]-----------------[]--------E--[]-------------[]-------[]--[]----------[]----<>----[]--------------[]-[]--E-----------------XX-------------[]-----------------[]-------<>--------------[]----[]----[]--------------[]-----------------------------[]-------[]--<>----------------<>-----------------------[]-------[]-----------------[]-------<>[]------------[]-----E----<>--[]----------------------[]--------------[]-[]-------<>--------------[]----------[]--------------[]----<>----[]--------------[]----------<>--[]-------------[]-------[]--------------[]----<>----[]--------------[]-[]-------[]--------------[]----[]--------------------------[]----EX--XXX---------[]--------------------------------------[]--------------------[]--------------E-----[]----[]-----------------------[]------------X---------<>-----------<>[][]----------------<>-------E---------------[]--------<>----[]--[]------<>--<>---------------------------------<>--------------<>----<>----[]------------[]-[]-<>----[]--------------[]----[]-----------------------[]-------------------------------------<>------------------[]----<>--[]-------------[]----------------------------<>----
---[]-----------[]--[]-------------XXX------------[]-----[]--[]----------[]----[]------[]-----------[]--<>-------[]--------------[]----[]----[]-----------------[]-------<>--------------------------[]-----------<>----[]<>---------------------[]-<>-[]----[]--<>-------------[]-------<>--[]-------------[]-------[]--[]----------[]----[]----[]--------------[]-<>-----------------------------------[]--<>-------------[]-------[]--------------[]----[]----[]--------------[]-----------------------<>----[]-------[]--[]----------------[]-----------------------[]-------[]-----------------[]-------[][]------------[]----<>----[]--[]-------------<>-------[]--------------[]-[]-------[]--------------[]----------[]--------------[]----[]----[]--------------[]----------[]--[]-------------[]-------[]--------------[]-<>-[]----[]-------------->--[]-------[]--------------[]----[]--------------------------[]---XXo--------------[]--------------------------------------[]--XX----------------[]--------------------[]----[]-----------------------[]------------X---------[]-----------[][][]----------------[]------<>---------------[]--------[]----[]--[]------[]--[]---------------------------------[]------<>------[]----[]----[]------------[]-[]-[]----[]--------------[]----[]-----------------------[]-----------------------<>------------[]------------------[]----[]--[]-------------[]----------------------------[]----
---[]-E-----E---[]--[]-------------XXX------------[]-----[]--[]----E-E---[]-E--[]------[]---------E-[]--[]-E-E---[]--------E--E--[]----[]----[]---E----EE-EE----[]----E--[]-----------E-EE------E-E--[]--E------E-[]----[][]------------------E-E[]-[]-[]----[]--[]-------E--E--[]-------[]--[]-------EE----[]-E--E--[]--[]---EE-EE--[]----[]----[]-------EE--E--[]-[]-------------------------------E---[]--[]-------------[]-------[]-------EE-EE--[]----[]----[]------E-E--E--[]---------------------E-[]----[]-E-EE--[]--[]----E-E---E-E---[]-----------------E-E---[]-E--E--[]--------EE-E--E--[]-------[][]--------EE-E[]----[]----[]-E[]-------EEEE--[]-EE-E--[]--------E--E--[]-[]-------[]-----------E--[]----------[]--------E--E--[]----[]----[]-----E-----E--[]----------[]--[]---------EE--[]-E--E--[]----------EE--[]-[]-[]----[]-----------E-----[]-------[]--X----EE-EE--[]----[]-----------EE--E-E-EE-E---[]----XX----------EE--[]--EE---X--------------------------E---[]--XX----E-----E-E---[]-------------E---E--[]-E--[]---------------E-EE----[]-E--E-----------------[]-----------[][][]------EE-E--E---[]------[]---------EEE---[]--E-E---[]-E--[]--[]------[]--[]----------E----------------------[]------[]------[]----[]----[]--------EE--[]-[]-[]----[]--------E--E--[]----[]---------E-----E-E--E--[]-E-EE----E-------------[]------------[]-E-----E-E-E------[]----[]-E[]-------E-EE--[]-E---------------E--E-EE-EE-[]----
XXXXXXXXXXXXXXXXXXXXXXXXXX-XXXXXXXXX-X--------XXXXXXXXXX-XXXXXXXXXXXXXXXXXXXXXXXXXX-XXXXXXXXXXXXXXXXXXXXXXXXXXXX-XXXXXXXXXXXXXXXXXXXXXXXXXXX-XXXXXXXXXXXXXXXXXXXXXXXXXXX-XXXXXXXXXXXXXXXXXXXXXXXXXXX-XXXXXXXXXXXXXXXXXXXXXXXXXXXXXXXXX---XXXXXXXXXXXXXXXXXXXXXXXXXXXXXXXXXXXXXXXXXXXXXXX-XXXXXXXXXXXXXXXXXXXXXXXXXXX-XXXXXXXXXXXXXXXXXXXXXXXXXXXXXXXXXXXXXXXXXXXXXXXXXXXXXXX-XXXXXXXXXX----------XXXXXXX-XXXXXXXXXXXXXXXXXXXXXXXXXXX-XX--XXXXXXXXXXXXXXXXXXXXXXX-XXXXXXXXXXXXXXXXXXXXXXXXXXXXXXXXXXXXXXXXXXXXXXXXXXXXXXX-XXXXXXXXXXXXXXXXXXXXXXXXXXXXXXXXXXXXXXXXXXXXXXXXXXXXXXX-XXXXXXXXXXXXXXXXXXXXXXXXXXX-XXXXXXXXXXXXXXXXXXXXXXXXXXX-XXXXXXXXXXXXXXXXXXXXXXXXXXX-XXXXXXXXXXXXXXXXXXXXXXXXXXX-XXXXXXXXXXXXXXXXXXXXXXXXXXX-XXXXXXXXXXXXXXXXXXXXXXXXXXX-XXXXXXXXXXXXXXXXXXXXXXXXXXXXXXXXXXXXXXXXXXXXXXXXXXXXXXX-XXXXXXXXXXXXXXXXXXXXXXXXXXX-XXXXXXXXXXXXXXXXXXXXXXXXXXX-XX--XXXXXXXXXXXXXXXXXXXXXX-XXXXXXXXXXXXXXXXXXXXXXXXXXXXXXXX-----XXXXXXXXXXXXXXXXXXX----X---XXXXX--------XX-XXXX-XXXXXX-XXXXXXXXXXXXXXXXXXXXXXXXXXXXXXXXXXXXXXXXXXXXXXXXXXXXXXXXXXXXXXXXXXXXXXXXXXXXXXXX---XXXXXXXXXXXXXXXXXXXXXXXXXXXXXXXXXXXXXXXXXXXXXXXXXXXXXXXXXXXXXXXXXXXXXXXXXXXXXXXXXXXXXXXXXXXXXXXXXXXXXXXXXXXXXXX-XXXXXXXXXXXX-----XXXXXXXXXXXXXXXXXXXXXXXXXX-XXXXXXXXXXXXXXXXXXXXXXXXXXXXXXXXX-XXXXXXXXXXXXXXXXXXXXXXXXXXXXXXXXXXXXXXXXXXXXXXXXXXXXXXXXXXXXXXXXXXXXXXXXXXXXXXXXXXXXXXXXX--XXXXXXXXXXXXXXXXXXXX-XXXXXXXXXXXXXXXXXXXXXXXXXXXXXX---XXXXXXXXXXXXXXXXXXXXXX
