--------------------------------------------------------------------------------------------------------------------------------------------------------------------------------------------------------------------------------------------------------------------------------------------------------------------------------------------------------------------------------------------------------------------------------------------------------------------------------------------------------------------------------------------------------------------------------------------------------------------------------------------------------------------------------------------------------------------------------------------------------------------------------------------------------------------------------------------------------------------------------------------------------------------------------------------------------------------------------------------------------------------------------------------------------------------------------------------------------------------------------------------------------------------------------------------------------------------------------------------------------------------------------------------------------------------------------------------------------------------------------------------------------------------------------------------------------
--------------------------------------------------------------------------------------------------------------------------------------------------------------------------------------------------------------------------------------------------------------------------------------------------------------------------------------------------------------------------------------------------------------------------------------------------------------------------------------------------------------------------------------------------------------------------------------------------------------------------------------------------------------------------------------------------------------------------------------------------------------------------------------------------------------------------------------------------------------------------------------------------------------------------------------------------------------------------------------------------------------------------------------------------------------------------------------------------------------------------------------------------------------------------------------------------------------------------------------------------------------------------------------------------------------------------------------------------------------------------------------------------------------------------------------------------------
-----------SSSSSSSSSSSSSS-S---------------------------------------------------------SSSSSSSSSSSSSSSSSSSSSSSSSSSSSSSSSSSS---S-S---------S---SSSSS---------SSS---S-SSSS-SSSSSS-------S----------------SSSSSSSSSSSSSSSSSSSSSSSSSSSSSSSSSSSSS-SSSS-------------SSSSSSSSSSSSSSSSSSSSSSSSSSSSSSSSSSSSSSSSSSSSSSSSSSSSSSSSSSSSSSSSSSSSSSSSSSSSSSSSSSSSSSSSSSSSSSSSSSSSSSSSSSSSSSSSSS---------------------------SSSSSSSSSSSSSSSSSSSSSSSSSSSSSSSSSSSSSSSSSSSSSSSSSSSSSSSSSSSSSSSSSSSSSSSSSSSSSSSSSSSSSSSSSSSSSSSSSSSSSSSSSSSSSSSSSSSSSSSSSSSSSSSSSSSSSSSSSSSSSSSSSSSSSSSSSSSSSSSSSSSSSSSSSSSSSSSSSSSSSSSSSSSSSSSSSSSSSSSSSSSSSSSSSSSSSSSSSSSSSSSSSSSSSSSSSSSSSSSSSSSSSSSSSSSSSSSSSSSSSSSSSSSSSSSSSSSSSSSSSSSSSSSSSSSSSSSSSSSSSSSSSSSSS-SS-----------------------SSSSSSSSSSSSSSSSSSSSSSSSSSSSSSSSSSSSSSSSSSSSSSSSSSSSSSSSSSSSSSSSSSSSSSSSSSSSSSSSSSSSSSSSSSSSSSSSSSSSSSSSSSSSSSSSSSSSSSSSSSSSSSSSSSSSSSSSSSSSSSSSSSSSSSSSSSSSSSSSSSSSSSSSSSSSSSSSSSSSSSSSSSSSSSSSSSSSSSSSSSSSSSSSSSSSSSSSSSSSSSSSSSSSSSSSSSSSSSSSSSSSSSSSSSSSSSSSSSSSSSSSSSSSSSSSSSSSSSSSSSSSSSSSSSSSSSSSSSSSSSSSSSSSSSSSSSSSSSSSSSSSSSSSSSSSSSSSSSSSSSSSSSSSSSSSSSSSSSSSSSSSSSSSSSSSSSSSSSSSSSSSSSSSSSSSSSSSSSSSSSSSSSSSSSSSSSSSSSSSSSSSSSSSSSSSSSSSSSSSSSSSSSSSSSSSSSSSSSSSSSSSSSSSSSSSSSSSSSSSSSSSSS-SSSSSSS--S-SSSSSSSSSSSSSSSSSSSSSSSSSSSSSSSSSSSSSSSSSSSS-SSSSSS---S-SSSS-SSSSSSSSSSSSSSSSSSSSSSSSSSSSSSSSSSSSSSSSSSSSSSSSSSSSSSSSSSSSSSSSSSSSSSSSSSSSSSSSSSSSSSSSSSSSSSSSSSSSSSSSSSSSSSSSSS
--------------------------------------------------------------------------------------------------------------------------------------------------------------------------------------------------------------------------------------------------------------------------------------------------------------------------------------------------------------------------------------------------------------------------------------------------------------------------------------------------------------------------------------------------------------------------------------------------------------------------------------------------------------------------------------------------------------------------------------------------------------------------------------------------------------------------------------------------------------------------------------------------------------------------------------------------------------------------------------------------------------------------------------------------------------------------------------------------------------------------------------------------------------------------------------------------------------------------------------------------------------------------------------------------------------------------------------------------------------------------------------------------------------------------------------------------------
--------------------------------------------------------------------------------------------------------------------------------------------------------------------------------------------------------------------------------------------------------------------------------------------------------------------------------------------------------------------------------------------------------------------------------------------------------------------------------------------------------------------------------------------------------------------------------------------------------------------------------------------------------------------------------------------------------------------------------------------------------------------------------------------------------------------------------------------------------------------------------------------------------------------------------------------------------------------------------------------------------------------------------------------------------------------------------------------------------------------------------------------------------------------------------------------------------------------------------------------------------------------------------------------------------------------------------------------------------------------------------------------------------------------------------------------------------
----SSS---------------------------------------------------------------------------------------------------------------------------------------------------------------------------------------------------------------------------------------------------------S-----------------------------------------------------------------------------------------------------------------------------------------------------------------------------------------------------------------------------------------------------------------------------------------------------------------------------------------------------------------------------------------------------------------------------------S-----------------------------------------------------------------------------------------------------------------------------------------------------------------------S-----------------------------------------------------------------------------------S-------------------------------------------------------------------------------------------------------------------------------------------S-----------oo----------------------------------------------------------------------S-----------------------------------------------------------------------------------S-----------------------------------------------------------------------------------S-------------------------------------------------------------------------------
----------------------------------------------------------------------------------------------------------------------------------------------------------------------------------------------------------------------------------------------------------------------------------------------------------------------------------------------------------------------------------------------------------------------------------------------------------------------------------------------------------------------------------------------------------------------------------------------------------------------------------------------XX--------------------------------------------------------------------------------------------------------------XX---------------------------------------------------------------------------------------------------------------X-----------------------------------------------------------------------------------X-------------------------------------------------------------------------------------------------------------------------------------------------------------------------------------------------------------------------------------------------------------------------------------------------------------------------------------------------------------------------------------------------------X----------------------------------------------------------------------------
----S-----------------------------------------------------------------------------------------------------------------------------------------------------------------------------------------------------------------------------------------------------------S-----------------------------------------------------------------------------------------------------------------------------------------------------------------------------------------------------------------------------------------------------------------------------------------------------------------------------------------------------------------------------------------------------------------------------------S-----------------------------------------------------------------------------------------------------------------------------------------------------------------------------------------------------------------------------------------------------------S-------------------------------------------------------------------------------------------------------------------------------------------------------------------------------------------------------------------------------S-----------------------------------------------------------------------------------S-----------------------------------------------------------------------------------S-------------------------------------------------------------------------------
-----E-------------------------------------------------------------------SSS-------------------------SSS-----------------------E--S--------------------------SS--------------------------SSS-----------------------------------------------------SSS-------------------------SSS-------------------------SSS--------------------------S--------------------E------S--------------------E------SS-------------------------SS--------------------------SS--------------------E------S--------------------E-----SS---------------S----E-----SS---------------------------S---------------------------S--------------------E-----SSS-------------------------SS--------------------E------S--E-----------SS----E-----SSS-------------------E---------------------------------SS--------------------E-----SS--------------------E------S--------------------------SS---------------S----E-----SSS-------------------E---E--S--------------------E------S---------------S----E-----SSS-------------------------SSS-------------------E-----SS--------------------------SS--------------------E------S--------------------E-----SSSS-------------------------S--------------------------SS---------------S----------SS--------------------------SS---------------------------S-------------So-----------SS--------------------E------S--------------------------SSS------------SSS----------SSS-------------------E-----SS--------------------E-----SS---------
XX--SSS----------------------------------------------------------------------------------------E------------o-----------------<>-----E------X-----------------------o----------------------------------------------------------------------E--------------------S----------------o--o----------------------------------------E----------------------------<>---E-----E--o-------------<>---------------------------E---E-----E---------------E-----------E----------------<>--------------------------<>------------o-------------<>---------E--o--------------E---------------------------E---------E----------------<>---------o--o--------------E--<>-----E--o------E-----E<>--------<>------------S---<>------------o-------------<>---------E----------------<>--<>--------o-------------<>---------E--o-------------<>---------E-----------------E----------------------S---<>---------o--o------------E<>--<>-----E---------------E<>---------E--o-o-------S---<>---------o--o-------------<>------------o-------------<>------------o------------------------E----------------<>--------------------------<>---------o-----------------E---E-----E------------------------------o------------------------E--o--------------E---------E----------------<>---E-----E----------S?S-----------------o-------------<>---E-----------------------E---------o----------S-S----E---------o--o-------------<>--------------------------<>------------o---
--------------------------E------------------------E---------------E---E-------E--------------<>------------------------------[]----<>---------------------E---------------------------E--------------------------------------------------<>---E-------------------------------------------------------E--------------------<>-----E----------------------[]--<>----<>----------------[]---E----------------------<>--<>----<>--------------<>-----E----<>----------------[]---E----------------------[]---E----------------------[]---E----<>----------------<>---E----------------------<>---E----<>----------------[]--------------------------<>--[]-----E--------<>----<>[]---E----[]----------------[]---E----------------------[]--------<>----------------[]--[]----------------------[]---E----<>----------------[]---E----<>----------------<>---E----------------------[]---E--------------------<>[]--[]----<>--------------<>[]---E----<>----------------[]--------------------------[]---E----------------------[]---E---------------------E-----E----<>----------------[]---E----------------------[]--------------------------<>--<>----<>---------------------E-----E---------------------E-----E----------------<>---E----<>----------------[]--<>----<>--------------------------------------------[]--<>----------------------<>--------------------------<>---E----------------------[]--------------------------[]----------------
------E------------------<>---------------X-------<>--------------<>--<>------<>--------------[]--------------------------<>--[]----[]--------------------<>--------------------------<>--------------------------------X-----------------[]--<>------------------------------------------------------<>--------------------[]----<>----------------------[]--[]----[]----------------[]--<>----<>----------------[]--[]----[]--------------[]----<>----[]----------------[]--<>----X-----------------[]--<>----------------------[]--<>----[]----------------[]--<>----------------------[]--<>----[]----------------[]--------------------------[]--[]----<>--------[]----[][]--<>----[]----------------[]--<>----------------------[]--------[]----------------[]--[]----<>----------------[]--<>----[]----------------[]--<>----[]----------------[]--<>----------------------[]--<>--------------------[][]--[]----[]--<>----------[][]--<>----[]----------------[]--<>----------------------[]--<>----<>----------------[]--<>----<>--------------<>----<>----[]----------------[]--<>----------------------[]--------------------------[]--[]----[]--------------------<>----<>--------------------<>----<>----------------[]--<>----[]----------------[]--[]----[]--------------------<>----------------------[]--[]----------------------[]--------------------------[]--<>----------------------[]--<>----------------------[]--<>------------
----------------------EE-[]----EE-E-----E-X-------[]-------EE-----[]--[]------[]-E-----EE-E---[]-----------E-EE----E--E---[]--[]----[]---------E----------[]---------EE---EE----------[]-------E-E--E-EE----------------X--E-EE----EE-----[]--[]---------E--E--E---------------------E----EE----------[]---------E--E-EE----[]----[]-------E-EE---EE------[]--[]----[]---E-----E------[]--[]----[]-E-EE----EE-E---[]--[]----[]---E----EE----[]----[]----[]-E-EE-E-EE------[]--[]----X--E-EE-E--E------[]--[]---------E----EE------[]--[]----[]---E--E-EE------[]--[]-------E-EE-E--EE-E---[]--[]----[]-E----E--E------[]-------------EE----E------[]--[]----[]--------[]----[][]--[]----[]--------EE------[]--[]---------E-----EE-E---[]--------[]-E-E-----EE-----[]--[]----[]--------EE------[]--[]----[]---E----EE------[]--[]----[]-E-EE-E-EE------[]--[]-------E-E-----E------[]--[]--------------EE----[][]--[]----[]--[]----EE----[][]--[]----[]---E-----E------[]--[]---------E--E--E------[]--[]----[]---E----EE------[]--[]----[]-E-EE-E-EE----[]----[]----[]-E-EE---EE------[]--[]-------E-E--E--E------[]-------------E----EE------[]--[]----[]---E--E--E----------[]----[]---EE---EE----------[]----[]---E-----EE-----[]--[]----[]-E-E--E-EE--E---[]--[]----[]-E-EE---EE----------[]---------E-----E------[]--[]-------E-EE-E--E------[]-------------E--E--E------[]--[]---------E----EE------[]--[]--------------EE------[]--[]-------E-E--
XXXXXXXXXXXXXXXXXXXXXXXXXXXXXXXXXXXXXXXXXXXXXXXXXXXXXXXXXXXXXXXXXXXXXXXXXXXXXXXXXXXXXXXXXXXXXXXXXXXXXXXXXXXXXXXXXXXXXXXXXXXXXXXXXXXXXXXXXXXXXXXXXXXXXXXXXXXXXXXXXXXXXXXXXXXXXXXXXXXXXXXXXXXXXXXXXXXXXXXXXXXXXXXXXXXXXXXXXXXXXXXXXXXXXXXXXXXXXXXXXXXXXXXXXXXXXXXXXXXXXXXXXXXXXXXXXXXXXXXXXXXXXXXXXXXXXXXXXXXXXXXXXXXXXXXXXXXXXXXXXXXXXXXXXXXXXXXXXXXXXXXXXXXXXXXXXXXXXXXXXXXXXXXXXXXXXXXXXXXXXXXXXXXXXXXXXXXXXXXXXXXXXXXXXXXXXXXXXXXXXXXXXXXXXXXXXXXXXXXXXXXXXXXXXXXXXXXXXXXXXXXXXXXXXXXXXXXXXXXXXXXXXXXXXXXXXXXXXXXXXXXXXXXXXXXXXXXXXXXXXXXXXXXXXXXXXXXXXXXXXXXXXXXXXXXXXXXXXXXXXXXXXXXXXXXXXXXXXXXXXXXXXXXXXXXXXXXXXXXXXXXXXXXXXXXXXXXXXXXXXXXXXXXXXXXXXXXXXXXXXXXXXXXXXXXXXXXXXXXXXXXXXXXXXXXXXXXXXXXXXXXXXXXXXXXXXXXXXXXXXXXXXXXXXXXXXXXXXXXXXXXXXXXXXXXXXXXXXXXXXXXXXXXXXXXXXXXXXXXXXXXXXXXXXXXXXXXXXXXXXXXXXXXXXXXXXXXXXXXXXXXXXXXXXXXXXXXXXXXXXXXXXXXXXXXXXXXXXXXXXXXXXXXXXXXXXXXXXXXXXXXXXXXXXXXXXXXXXXXXXXXXXXXXXXXXXXXXXXXXXXXXXXXXXXXXXXXXXXXXXXXXXXXXXXXXXXXXXXXXXXXXXXXXXXXXXXXXXXXXXXXXXXXXXXXXXXXXXXXXXXXXXXXXXXXXXXXXXXXXXXXXXXXXXXXXXXXXXXXXXXXXXXXXXXXXXXXXXXXXXXXXXXXXXXXXXXXXXXXXXXXXXXXXXXXXXXXXXXXXXXXXXXXXXXXXXXXXXXXXXXXXXXXXXXXXXXXXXXXXXXXXXXXXXXXXXXXXXXXXXXXXXXXXXXXXXXXXXXXXXXXXXXXXXXXXXXXXXXXXXXXXXXXXXXXXXXXXXXXXXXXXXXXXXXXXXXXXXXXXXXXXXXXXXXXXXXXXXXXXXXXXXXXXXXXXXXXXXXXXXXXXXXXXXXXXXXXXXXXXXXXXXXXXXXXXXXXXXXXXXXXXXXXXXXXXXXXXXXXXXXXXXXXXXXXXXXXXXXXXXXXXXXXXXXXXXXXXXXXXXXXXXXXXXXXXXXXXXXXXXXXXXXXXXXXXXXXXXXXX
