--------------------------------------------------------------------------------------------------------------------------------------------------------------------------------------------------------------------------------------------------------------------------------------------------------------------------------------------------------------------------------------------------------------------------------------------------------------------------------------------------------------------------------------------------------------------------------------------------------------------------------------------------------------------------------------------------------------------------------------------------------------------------------------------------------------------------------------------------------------------------------------------------------------------------------------------------------------------------------------------------------------------------------------------------------------------------------------------------------------------------------------------------------------------------------------------------------------------------------------------------------------------------------------------------------------------------------------------------------------------------------------------------------------------------------------------------------
--------------------------------------------------------------------------------------------------------------------------------------------------------------------------------------------------------------------------------------------------------------------------------------------------------------------------------------------------------------------------------------------------------------------------------------------------------------------------------------------------------------------------------------------------------------------------------------------------------------------------------------------------------------------------------------------------------------------------------------------------------------------------------------------------------------------------------------------------------------------------------------------------------------------------------------------------------------------------------------------------------------------------------------------------------------------------------------------------------------------------------------------------------------------------------------------------------------------------------------------------------------------------------------------------------------------------------------------------------------------------------------------------------------------------------------------------------
----------------------------S--------------------SSSS-SSSSSSSSSSSSSSSSSSSSSSSSSSSSSSSSSSSSSSSSSSSSSSS-SSSSSSSSSSS----------------------S--SSSSSSSSSSSSSSSSSSSSSSSSSSSSSSSSSSSSSSSSSSSSSSSSSSSSSSSSSSSSSSSSSSSSSSSSSSSSSSSSSSSSSSSSSSSSSSSSSSSSSSSSSSSSSSSSSSSSSSSSSSSSSSSSSSS--SSSSSSSSSSSSSSSSSSSSSSSSSSSSSSSSSSSSSSSSSSSSSSSSSSSSSS-SSSSSSSSSSSSSSSSSSSSSSSSSSSSSSSSSSSSSSSSSSSSSSSSSSSSSSSSSSSSSSSSSSSSSSSSSSSSSSSSSSSSSSSSSSSSSSSSSSSSSSSSSSSSSSSSSSSSSSSSSS----------------------------S--------------------SSSS-SSSSSSSSSSSSSSSSSSSSSSSSSSSSSSSSSSSSSSSSSSSSSSSSSSSSSSSSSSSSSSSSSSSSSSSSSSSSSSSSSSSSSSSSSSSSSSSSSSSSSSSSSSSSSSSSSSSSSSSSSSSSSSSSSSSSSSSSSSSSSSSSSSSSSSSSSSSSSSSSSSSSSSSSSSSSSSSSSSSSSSSSSSSSSSSSSSSSSSSSSSSSSSSSSSSSSSSSSSSSSSSSSSSSSSSSSSSSSSSSSSSSSSSSSSSSSSSSSSSSSSSSSSSSSSSSSSSSSSSSSSSSSSSSSSSSSSSSSSSSSSSSSSSSSSSSSSSSSSSSSSSSSSSSSSSSSSSSSSSSSSSSSSSSSSSSSSSSSSSSSSSSSSSSSSSSSSSSSSSSSSSSSSSSSSSSSSSSSSSSSSSSSSSSSSSSSSSSSSSSSSSSSSSSSSSSSSSSSSSSSSSSSSSSSSSSSSSSSSSSSSSSSSSSSSSSSSSSSSSSSSSSSSSSSSSSSSSSSSSSSSSSSSSSSSSSSSSSSSSSSSSSSSSSSSSSSSSSSSSSSSSSSSSSSSSSSSSSSSSSSSSSSSSSSSSSSSSSSSSSSSSSSSSSSSSSSSSSSSSSSSSSSSSSSSSSSSSSSSS--------------------SSSS-SSSSSSSSSSSSSSSSSSS-SSSSSSSSSSSSSSSSSSSSSSSSSSSSSSSSSSSSSSSSSSSSSSSSSSSSSSSSSSSSSSSSSSSSSSSSSSSSSSSSSSS-SSSSSSSSSSSSSSSSSSSSSSSSSSSSSSSSSSSSSSSSSSSSSSSSSSSSSSSSSSSSSSSSSSSSSSSSSSSSSSSSSSSSSSSSSSSSSSSSSSSSSSSSSSSSSSSSSSSSSSSSSSSSSSSSSSSSSSSSSSSSSSSSSSSSSS
--------------------------------------------------------------------------------------------------------------------------------------------------------------------------------------------------------------------------------------------------------------------------------------------------------------------------------------------------------------------------------------------------------------------------------------------------------------------------------------------------------------------------------------------------------------------------------------------------------------------------------------------------------------------------------------------------------------------------------------------------------------------------------------------------------------------------------------------------------------------------------------------------------------------------------------------------------------------------------------------------------------------------------------------------------------------------------------------------------------------------------------------------------------------------------------------------------------------------------------------------------------------------------------------------------------------------------------------------------------------------------------------------------------------------------------------------------
-----------------------------------------------------------------------------------------------------------------------------------------------------------------------------------------------------------------------------------------------------------------------------------------------------------------------------------------------------------------------------------------------------------------------------------------------------------------------------------------------------------------------------------------------------------------------------------------------------------------------------------------------------------------------------------------------------------------------------------------------------------------------------------------------------------------------------------------------------------------------------------------------------------------------------------------------------------------------------------------------------------------------------------------------------------------------------------------------------------------------------------------------------------------------------------------------------------------------------------------------------------------------------------------------------------------------------------------------------------------------------S--------------------------------------------------------------------------
------------------------------------------------------------------------------------------------------------------------------------------------------------------------------------------------------------------------------------------------------------------------------------------------------------------------------------------------------------------------------------------------------------------------------------------------------------------------------------------------------------------------------------------------------------------------------------------------------------------------------------------------------------------------------------------------------------------------------------------------------------------------------------------------------------------------------------------------S-------------------------------------------------------------------------------------------------------------------------------------------S---------------------------S-----------oo----------------------------------------------------------------------------------------------------------------------------------------------------------------------------------------------------------------------------------------------------------------------------------------------------------------------------------S-----------oo------------------------------------------------------------------
-----XXX---------------------------------------------------------------------------------------------------------------------------------------------------------------------------------------------------------------------------------------------------------------------------------------------------------------------------------------------------------------------------------------------------------------------------------------------------------------------E-----------------------------------------------------------------------------X--------------------------XX-----------------------------------------------------------------------------------------------------------------------------------------------------------------------------------------------------------------------------------------------------------X----------------------------------------------------------------------------------------------------------------------------------------------------------------------------------------------------------------------------------------------------------------------------------------------------------------------------------------------------------------------------------------------------------------------------------------------------------------------------------------------------------------------------------------------------------------------------------------------------
-------------------------------------------------------------------------------------------------------------------------------------------------------------------------------------------------------------------------------------------------------------------------------------------------------------------------------------------------------------------------------------------------------------------------------------------------------------------------------------------------------------------------------------------------------------------------------------------------------------------------------------------------------------------------------------------------------------------------------------------------------------------------------------------------------------------------------------------------------------------------------------------------------------------------------------------------------------------------------------------------------------------------------------S------------------------------------------------------------------------------------------------------------------------------------------------------------------------------------------------------------------------------------------------------------------------------------------------------------------------------------------------------------------------------------------------------------------
-------------------------------------------------------------------------SSS--------------------------S--------------------------SS--------------------------SS--------------------------SSS--------------------------S--------------------E------S---------------------------S--------------------E------S--------------------------SS--------------------------SS--------------------------SSS-------------------E-----SS--------------------------SSS-------------------E---------------------------E---------------------------E------S--------------------------SSS-------------------------SSSS------------------------SSS-------------------E------S--------------------E------S--------------------E------S---------------S----E-----SS--------------------------SSS-------------------------SS--------------------E------S---------------S----------SSS-------------------E-----SSS-------------------E-----SSS-------------------E------S--------------------E------S--------------------------SSS--------------S---------SSSS-------------------------SS--------------------E---------------------------E-----SSS--------------------------S---------------------------S--------------------------SS--------------------------S---------------------E-----SS--------------------E---------------------------------SS--------------------E------S--------------------E-----SSS-------------------E-----SSS-------------------E------S---------
-----------------------------------------------------------------------------------------------E-------------------------------------------------------E---E-----E--o--------------E---------------------------E---E-----E----------------<>---------E--o-------------<>---E-----E---------------E<>---------E------------------------------o--Q-----------E---------E--o--------------E---------o--o-------------<>---------E--o--------------E---------o----------------<>--------------------------<>--------------------------<>-------------------------------------o--o--------------E---------o--o-----------------------------------------<>---------E----------------<>---E-----E--o-------------<>---------E--o-------------<>------------o-------------<>------------o--------------E------------o------------E<>----------------------S----E---------o----------------<>------------o-------------<>---------o--o------------E<>---E-----E----------------<>---------E----------------<>---------o--o------------------------o--o------------------------o----------------<>--------------------------<>------------o------------------------E--o----------------------------------------------------E-----Q--------------------------------------<>---------E--o-------------<>-------------------------E--------------o-------------<>--<>-----E--o-------------<>---------o--o-------------<>--------------------------<>---------E------
--------------<>-------E----------------------------------------------------------------------<>---E---------------------------E----------------------<>--<>----<>----------------<>--------------------------<>--<>----<>----------------[]--<>----<>----------------[]--<>----<>--------------<>[]---E----<>---------------------E----------------------<>---E----<>----------------<>---E----------------------[]---E----<>----------------<>---E---------------E------[]--------------------------[]--------------------------[]------------------------------<>----------------------<>---E---------------------------E-----E----------------[]---E----<>---------E------[]--<>----<>----------------[]---E----<>----------------[]---E----------------------[]-------------------------E<>---E--------------------<>[]--------------------------<>--------------------------[]---E----------------------[]---E--------------------<>[]--<>----<>----------------[]---E----<>----------------[]---E-------------------------------------------------------E---------E------------[]--------------------------[]---E-----E---------------------E----<>-------------------------------------------------E----<>----------------<>--------------------------[]---E----<>----------------[]------------------------<>-----E----------------------[]--[]----<>----------------[]--------------------------[]---E-----E----------------[]---E----<>------
--<>----------[]------<>--------------X-------------------------------------------------------[]--<>----<>--------------------<>----------------------[]--[]----[]----------------[]--------------------------[]--[]----[]----------------[]--[]----[]----------------[]--[]----[]--------------[][]--<>----[]----------------<>--<>----<>----------------[]--<>----[]----------------[]--<>----------------------[]--<>----[]----------------[]--<>--------------<>------[]--------------------------[]--<>----<>----------------[]------------------------------[]----------------------[]--<>--------------------------<>----<>--------------<>[]--<>----[]--------<>------[]--[]----[]----------------[]--<>----[]----------------[]--<>----<>----------------[]------------------------<>[]--<>----<>--------------[][]--------------------------[]--------------------------[]--<>----------------------[]--<>--------------------[][]--[]----[]----------------[]--<>----[]----------------[]--<>----------------------<>------------------------------<>--------<>------------[]--------------------------[]--<>----<>--------------------<>----[]----------------<>--<>----------------------<>--<>----[]----------------[]--------------------------[]--<>----[]----------------[]--------<>--------------[]----<>----------------------[]--[]----[]----------------[]--<>----------------------[]--<>----<>----------------[]--<>----[]------
--[]-------E--[]------[]----E--EE-E---X-----------EE-E--E-EE---------------------E----EE------[]--[]----[]---E----EE-----E----[]-------E-E-----E------[]--[]----[]---EE-E--EE-----[]-------------EE---EE------[]--[]----[]-E-E----EE------[]--[]----[]---E----EE------[]--[]----[]-E-EE---EE----[][]--[]----[]-E------EE------[]--[]----[]---EE---EE------[]--[]----[]---------EE-----[]--[]---------EE-E--E------[]--[]----[]---------EE-----[]--[]--------------[]------[]----------EE-E-----EE-----[]--[]----[]-E-E--E-EE------[]-----------E-E----EE-------E--[]---------E-----E------[]--[]---------E-----EE-E-------[]----[]-E-EE-E-EE----[][]--[]----[]-E-E----[]------[]--[]----[]--------EE------[]--[]----[]------E-EE------[]--[]----[]---EE-E--E------[]-------------E----EE----[][]--[]----[]--------EE----[][]-----------E-E--E-EE------[]----------------E--E------[]--[]---------E--E--E------[]--[]---------EE---EE----[][]--[]----[]-E-EE-E--EE-E---[]--[]----[]-E-------EE-----[]--[]---------------E------[]------------------EE-----E----[]--------[]--E-EE------[]----------EE-E--E--EE-----[]--[]----[]---E----EE----------[]----[]-E-EE----E------[]--[]---------E-----E--E---[]--[]----[]---EE---EE------[]-------------E--E-EE------[]--[]----[]--------EE------[]--------[]---EE-E-EE----[]----[]---------E-----E------[]--[]----[]---E--E--EE-----[]--[]---------E--E--EE-E---[]--[]----[]-E-E----EE------[]--[]----[]-E-E--
XXXXXXXXXXXXXXXXXXXXXXXXXXXXXXXXXXXXXXXXXXXXXXXXXXXXXXXXXXXXXXXXXXXXXXXXXXXXXXXXXXXXXXXXXXXXXXXXXXXXXXXXXXXXXXXXXXXXXXXXXXXXXXXXXXXXXXXXXXXXXXXXXXXXXXXXXXXXXXXXXXXXXXXXXXXXXXXXXXXXXXXXXXXXXXXXXXXXXXXXXXXXXXXXXXXXXXXXXXXXXXXXXXXXXXXXXXXXXXXXXXXXXXXXXXXXXXXXXXXXXXXXXXXXXXXXXXXXXXXXXXXXXXXXXXXXXXXXXXXXXXXXXXXXXXXXXXXXXXXXXXXXXXXXXXXXXXXXXXXXXXXXXXXXXXXXXXXXXXXXXXXXXXXXXXXXXXXXXXXXXXXXXXXXXXXXXXXXXXXXXXXXXXXXXXXXXXXXXXXXXXXXXXXXXXXXXXXXXXXXXXXXXXXXXXXXXXXXXXXXXXXXXXXXXXXXXXXXXXXXXXXXXXXXXXXXXXXXXXXXXXXXXXXXXXXXXXXXXXXXXXXXXXXXXXXXXXXXXXXXXXXXXXXXXXXXXXXXXXXXXXXXXXXXXXXXXXXXXXXXXXXXXXXXXXXXXXXXXXXXXXXXXXXXXXXXXXXXXXXXXXXXXXXXXXXXXXXXXXXXXXXXXXXXXXXXXXXXXXXXXXXXXXXXXXXXXXXXXXXXXXXXXXXXXXXXXXXXXXXXXXXXXXXXXXXXXXXXXXXXXXXXXXXXXXXXXXXXXXXXXXXXXXXXXXXXXXXXXXXXXXXXXXXXXXXXXXXXXXXXXXXXXXXXXXXXXXXXXXXXXXXXXXXXXXXXXXXXXXXXXXXXXXXXXXXXXXXXXXXXXXXXXXXXXXXXXXXXXXXXXXXXXXXXXXXXXXXXXXXXXXXXXXXXXXXXXXXXXXXXXXXXXXXXXXXXXXXXXXXXXXXXXXXXXXXXXXXXXXXXXXXXXXXXXXXXXXXXXXXXXXXXXXXXXXXXXXXXXXXXXXXXXXXXXXXXXXXXXXXXXXXXXXXXXXXXXXXXXXXXXXXXXXXXXXXXXXXXXXXXXXXXXXXXXXXXXXXXXXXXXXXXXXXXXXXXXXXXXXXXXXXXXXXXXXXXXXXXXXXXXXXXXXXXXXXXXXXXXXXXXXXXXXXXXXXXXXXXXXXXXXXXXXXXXXXXXXXXXXXXXXXXXXXXXXXXXXXXXXXXXXXXXXXXXXXXXXXXXXXXXXXXXXXXXXXXXXXXXXXXXXXXXXXXXXXXXXXXXXXXXXXXXXXXXXXXXXXXXXXXXXXXXXXXXXXXXXXXXXXXXXXXXXXXXXXXXXXXXXXXXXXXXXXXXXXXXXXXXXXXXXXXXXXXXXXXXXXXXXXXXXXXXXXXXXXXXXXXXXXXXXXXXXXXXXXXXXXXXXXXXXXXXXXXXXXXXXXXXXXX
