--------------------------------------------------------------------------------------------------------------------------------------------------------------------------------------------------------------------------------------------------------------------------------------------------------------------------------------------------------------------------------------------------------------------------------------------------------------------------------------------------------------------------------------------------------------------------------------------------------------------------------------------------------------------------------------------------------------------------------------------------------------------------------------------------------------------------------------------------------------------------------------------------------------------------------------------------------------------------------------------------------------------------------------------------------------------------------------------------------------------------------------------------------------------------------------------------------------------------------------------------------------------------------------------------------------------------------------------------------------------------------------------------------------------------------------------------------
--------------------------------------------------------------------------------------------------------------------------------------------------------------------------------------------------------------------------------------------------------------------------------------------------------------------------------------------------------------------------------------------------------------------------------------------------------------------------------------------------------------------------------------------------------------------------------------------------------------------------------------------------------------------------------------------------------------------------------------------------------------------------------------------------------------------------------------------------------------------------------------------------------------------------------------------------------------------------------------------------------------------------------------------------------------------------------------------------------------------------------------------------------------------------------------------------------------------------------------------------------------------------------------------------------------------------------------------------------------------------------------------------------------------------------------------------------
--------------------------------------------------------SSSSSSSSSSSSSSSSSSSSSSSSSSSSSSSSSSSSSSSSSSSSSSSSSSSSSSSSSSSSSSSSSSSSSSSSSSSSSSSSSSSSSSSSSSSSSSSSSSSSSSSSSSSSSSSSSSSSSSSSSSSSSSSSSSSSSSSSSSSSSSSSSSSSSSSSSSSSSSSSSSSSSSSSSSSSSSSSSSSSSSSSSSSSSSSSSSSSSSSSSSSSSSSSSSSSSSSSSSSSSSSSSSSSSSSSSSSSSSSSSSSSSSSSSSSSSSSSSSSSSSSSSSSSSSSSSSSSSSSSSSSSSSSSSSSSSSSSSSSSSSSSSSSSSSSSSSS------SSS---SSSSSSSSSSSSSSSSSSSSSSSSSSSSSSSSSSSSSSSSSSSSSSSSSSSSSSSSSSSSSSSSSSSSSSSSSSSSSSSSSSSSSSSSSSSSSSSSSSSSS---SSSSS-----SSSS-SSSSSSSSSSSSSSSSSSSSSSSSSSSSSSSSSSSSSSSSSSSSSSSSSSSSSSSSSSSSSSSSSSSSSSSSSSSSSSSSSSSSSS----------------------------SSSSSSSSSSSSSSSSSSSSSSSSSSSSSSSSSSSSSSSSSSSSSSSSSSSSSSSSSSSSSSSSS-SSSSSS---SSSSSSSSSSSSSSSSSSSSSSSSSSSSSSSSSSSSSSSSSSSSSSSSSSSSSSSSSSSSSSSSSSSSSSSSS---S---------SSSS-SSSSSSSSSSSSSSSSSSSSSSSSSSSSSSSSSSSSSSSSSSSSSSSSSSSSSSSSSSSSSSSSSSSSSSSSSSS----S-S--SSSSSSSSSSSSSSSSSSSSSSSSSSSSSSSSSSSSSSSSSSSSSSSSSSSSSSSSSSSSSSSSSSSSSSSSSSSSSSSSSSSSSSSSSSSSSSSSSSSSSSSSSSSSSSSSSSSSSSSSSSSSSSSSSSSSSSSSSSSSSSSSSSSSSSSSSSSSSSSSSSSSSSSSSSSSSSSSSSSSSSSSSSSSSSSSSSSSSSSSSSSSSSSSSSSSSSSSSSSSSSSSSSSSSSSSSSSSSSSSSSSSSSSSSSSSSSSSSSSSSSSSSSSSSSSSSSSSSSSSSSS--------------------SSSS-SSSSSSSSSSSSSSSSSSSSSSSSSSSSSSSSSSSSSSSSSSSSSSSSSSSSSSSSSSSSSSSSSSSSSSSSSSSSSSSSSSSSSSSSSSSSSSSSSSSSSSSSSSSSSSSSSSSSSSSSSSSSSSSSSS-----SSSSSSSSSSSSSSSSSSSSSSSSSSSSSSSSSSSSSSSSSSSSSSSSSSSSSSSSSSSSSSSSSSSSSSSSSSSSSSSSSSSSSSSSSSS
--------------------------------------------------------------------------------------------------------------------------------------------------------------------------------------------------------------------------------------------------------------------------------------------------------------------------------------------------------------------------------------------------------------------------------------------------------------------------------------------------------------------------------------------------------------------------------------------------------------------------------------------------------------------------------------------------------------------------------------------------------------------------------------------------------------------------------------------------------------------------------------------------------------------------------------------------------------------------------------------------------------------------------------------------------------------------------------------------------------------------------------------------------------------------------------------------------------------------------------------------------------------------------------------------------------------------------------------------------------------------------------------------------------------------------------------------------
--------------------------------------------------------------------------------------------------------------------------------------------------------------------------------------------------------------------------------------------------------------------------------------------------------------------------------------------------------------------------------------------------------------------------------------------------------------------------------------------------------------------------------------------------------------------------------------------------------------------------------------------------------------------------------------------------------------------------------------------------------------------------------------------------------------------------------------------------------------------------------------------------------------------------------------------------------------------------------------------------------------------------------------------------------------------------------------------------------------------------------------------------------------------------------------------------------------------------------------------------------------------------------------------------------------------------------------------------------------------------------------------------------------------------------------------------------
----------------------------------------------------------------------------------------------------------------------------------------------------------------------------------------------------------------------------------------------------------------------------------------------------------------------------------------------------------------------------------------------------------------------------------------S-------------------------------------------------------------------------------------------------------------------------------------------------------------------------------------------------------------------------------------------------------------------------------------------------------------------------------------------------------------------------------------------------------S---------------------------------------------------------------------------------------------------------------------------------------------------------------------------------------------------------------------------------------------------------------------------------------------------------------------------------------------------------------------------------------------------------------------------------------------------------------S---------------------------------------------------------------------------------------------------------------------------------------
-------------------------------------------------------------------------------------------------------------------------------------------------------------------------------------------------------------------------------------------------------------------------------------------------------------------------------------------------------------------------------------------------------------------------------------------------------------------------------------------------------------------------------------------------------------------------------------------------------------------------E-----------------------------------------------------------------------------------------------------------------------------------------------------------------------E----------------------------------------------------------------------------------------------------------------------------------------------------------------------------------------------------------------------------------------------------------------------------------------------------------------------------------------XX------------------------------------------------------------------------------------------------------------------------------------------XX----------------------------------------------------------------------------------------------------------------------------------------------------------------
--------------------------------------------------------------------------------------------------------------------------------------------------------------------------------------------------------------------------------------------------------------------------------------------------------------------------------------------------------------------------------------------------------------------------------------------------------------------------------------------------------------------------------------------------------------------------------------------------------------------------------------------------------------------------------------------------------------------------------------------------------------------------------------------------------------------------------------------------------------------------------------------------------------------------------------------------------------------------------------------------------------------------------------------------------------------------------------------------------------------------------------------------------------------------------------------------------------------------------------------------------------------------------------------------------------------------------------------------------------------------------------------------------------------------------------------------------
----------------------------------------------------------------------S--SSS-------------------E-----SSS-------------------------SS--------------------E------S--------------------------SSS-------------------E---------------------------E------S--------------------------SS------------------------E--S--------------------E------S--------------------E-----SS--------------------E------S--------------------E------S---------------S----E-----SSS-------------------------SS---------------------------S--------------------------SSS--------------------------S--------------------------SS--------------------E----------------------------------S--------------------------SS--------------------E--------------------------------------------------------------S--------------------E---------------------------E-----SSS--------------S----------SSS-------------------E------S--------------------E------S--------------------E------S--------------------------SSS-------------------------SS---------------------------S--------------------E------S--------------------E-----SS--------------------E------S--------------------------SSS-------------------------SSS-----------------------------------------------------SS--------------------------SSS-------------------------SS--------------------------SSS-------------------E-----SSS-------------------E------S--------------------E------S---------------------------S---------
X--------------------E------X--------------------------------------E--------------------------<>-------------------------------------E---------------E<>---------E-----------------E------------o-------------<>--------------------------<>---------E---------------------E-----E--o--Q----------<>--<>-----E----------------<>---------E--o-------------<>------------o-------------<>------------o-------------<>----------------------S---<>------------o------------E-----------E--o------------------E-----------Q------------------------o--------------E---------E-----Q-----------E--------------------------<>---------------------------E---------E--o--Q---------E<>---------E----------------<>---------E---------------------------E----------------<>---E-----E---------------E<>---------E----------------<>------------o---------------------------o-------------<>-------------------------E<>--------------------------<>---------E-----------------E---------------------------E---E-----E--o--Q-----------E---------E----------------<>--------------------------<>---------E--o-------------<>-------------------------------------o---------------------------------------------E-------------------------E--------------o------------E--------------o--Q-----------E---E--------o---------------------------o-------------<>-------------------------E<>---------E------X---------<>------------o------------E-----------E------
---------------E----<>---------------------E----------------------<>--------------------------[]---E-----E-----------------E---E----<>---------E----<>[]---E----<>----------------<>---E----------------------[]--------------------------[]---E----<>--------------------<>----<>----------------[]--[]----<>----------------[]--<>----<>----------------[]--------------------------[]---E----------------------[]---E----------------------[]------------------------<>----<>----<>---------------E----<>-----E---------------------E---------------------E<>--<>----<>---------------E<>---E----------------------[]--<>---------------------E<>---E----<>--------------<>[]---E-----E----------------[]---E----<>---------------E-----E----<>----------------[]--<>----<>--------------<>[]---E----<>----------------[]---E-----E---------------------E----------------------[]---E--------------------<>[]---E----------------------[]---E----<>----------------<>---E----------------------<>--<>----<>---------------E<>---E----<>----------------[]---E----------------------[]---E----<>----------------[]------------------------------<>---------------------------E----------------------<>---E-----E--------------<>----<>--------------------<>-----E----------------------<>--<>-----E---------------E-----E----------------------[]---E--------------------<>[]--------<>----------------[]---E-----E--------------<>-----E----<>------
--------------<>----[]--------------------<>----------------------[]--------------------------[]--<>----<>----------------<>--<>----[]--------<>----[][]--<>----[]----------------[]--<>----------------------[]--------------------------[]--<>----[]--------------------[]----[]----------------[]--[]----[]--------------<>[]--[]----[]--------------<>[]--------------------------[]--<>----------------------[]--<>----------------------[]------------------------[]----[]----[]--------------<>----[]----<>--------------------<>--------------------<>[]--[]----[]--------------<>[]--<>--------------------<>[]--[]----<>--------------<>[]--<>----[]--------------[][]--<>----<>----------------[]--<>----[]--------------<>----<>----[]--------------<>[]--[]----[]--------------[][]--<>----[]----------------[]--<>----<>--------------<>----<>----------------------[]--<>--------------------[][]--<>----------------------[]--<>----[]----------------[]--<>----------------------[]--[]----[]--------------<>[]--<>----[]----------------[]--<>----------------------[]--<>----[]----------------[]--------------------------<>--[]--------------------------<>----------------------[]--<>----<>--------------[]----[]----<>--------------[]----<>----<>----------------[]--[]----<>--------------<>----<>----------------------[]--<>--------------------[][]--<>----[]----------------[]--<>----<>--------------[]----<>----[]------
------------E-[]----[]-E-------EE---------[]------EE-------EE-E---[]-----------E-EE----E------[]--[]----[]---E-----EE-E---[]--[]----[]---E----[]----[][]--[]----[]---------E------[]--[]---------EE-E-EE------[]----------EE-EE-E--E------[]--[]----[]-E-EE----E-------E--[]----[]---EE---EE--E---[]--[]----[]--------EE----[][]--[]----[]---E----EE----[][]------------------EE------[]--[]-------E-EE-E-EE------[]--[]-------E-E--E-EE------[]-----------E-EE---EE----[]----[]----[]--------EE----[]-E--[]----[]-E-EE---EE----------[]---------E-----E----[][]--[]----[]---EE---EE----[][]--[]--------------EE--E-[][]--[]----[]-E-E----EE----[][]--[]----[]-E-EE---EE----[][]--[]----[]---EE---EE------[]--[]----[]---EE-E-EE----[]----[]----[]-E-EE---EE----[][]--[]----[]-E-E----EE----[][]--[]----[]---E----EE------[]--[]----[]---E--E-EE----[]----[]------------E-EE------[]--[]-------E-EE-E-EE----[][]--[]-------E-E-----E------[]--[]----[]---------E------[]--[]---------EE---EE------[]--[]----[]---EE-E-EE----[][]--[]----[]-E-E----EE------[]--[]-------E-E----EE------[]--[]----[]------E-EE------[]-----------E-EE---EE------[]--[]-------E-EE----EE---------[]-------E-EE---EE------[]--[]----[]-E-E----EE----[]----[]----[]--------EE----[]----[]----[]-E-EE---EE------[]--[]----[]--------EE----[]----[]-------E-EE---EE------[]--[]---------EE---EE----[][]--[]----[]---EE---EE------[]--[]----[]-E-EE---EE----[]----[]----[]---E--
XXXXXXXXXXXXXXXXXXXXXXXXXXXXXXXXXXXXXXXXXXXXXXXXXXXXXXXXXXXXXXXXXXXXXXXXXXXXXXXXXXXXXXXXXXXXXXXXXXXXXXXXXXXXXXXXXXXXXXXXXXXXXXXXXXXXXXXXXXXXXXXXXXXXXXXXXXXXXXXXXXXXXXXXXXXXXXXXXXXXXXXXXXXXXXXXXXXXXXXXXXXXXXXXXXXXXXXXXXXXXXXXXXXXXXXXXXXXXXXXXXXXXXXXXXXXXXXXXXXXXXXXXXXXXXXXXXXXXXXXXXXXXXXXXXXXXXXXXXXXXXXXXXXXXXXXXXXXXXXXXXXXXXXXXXXXXXXXXXXXXXXXXXXXXXXXXXXXXXXXXXXXXXXXXXXXXXXXXXXXXXXXXXXXXXXXXXXXXXXXXXXXXXXXXXXXXXXXXXXXXXXXXXXXXXXXXXXXXXXXXXXXXXXXXXXXXXXXXXXXXXXXXXXXXXXXXXXXXXXXXXXXXXXXXXXXXXXXXXXXXXXXXXXXXXXXXXXXXXXXXXXXXXXXXXXXXXXXXXXXXXXXXXXXXXXXXXXXXXXXXXXXXXXXXXXXXXXXXXXXXXXXXXXXXXXXXXXXXXXXXXXXXXXXXXXXXXXXXXXXXXXXXXXXXXXXXXXXXXXXXXXXXXXXXXXXXXXXXXXXXXXXXXXXXXXXXXXXXXXXXXXXXXXXXXXXXXXXXXXXXXXXXXXXXXXXXXXXXXXXXXXXXXXXXXXXXXXXXXXXXXXXXXXXXXXXXXXXXXXXXXXXXXXXXXXXXXXXXXXXXXXXXXXXXXXXXXXXXXXXXXXXXXXXXXXXXXXXXXXXXXXXXXXXXXXXXXXXXXXXXXXXXXXXXXXXXXXXXXXXXXXXXXXXXXXXXXXXXXXXXXXXXXXXXXXXXXXXXXXXXXXXXXXXXXXXXXXXXXXXXXXXXXXXXXXXXXXXXXXXXXXXXXXXXXXXXXXXXXXXXXXXXXXXXXXXXXXXXXXXXXXXXXXXXXXXXXXXXXXXXXXXXXXXXXXXXXXXXXXXXXXXXXXXXXXXXXXXXXXXXXXXXXXXXXXXXXXXXXXXXXXXXXXXXXXXXXXXXXXXXXXXXXXXXXXXXXXXXXXXXXXXXXXXXXXXXXXXXXXXXXXXXXXXXXXXXXXXXXXXXXXXXXXXXXXXXXXXXXXXXXXXXXXXXXXXXXXXXXXXXXXXXXXXXXXXXXXXXXXXXXXXXXXXXXXXXXXXXXXXXXXXXXXXXXXXXXXXXXXXXXXXXXXXXXXXXXXXXXXXXXXXXXXXXXXXXXXXXXXXXXXXXXXXXXXXXXXXXXXXXXXXXXXXXXXXXXXXXXXXXXXXXXXXXXXXXXXXXXXXXXXXXXXXXXXXXXXXXXXXXXXXXXXXXXXXXXXXXXXXXXXXXXXXXXXXXXXXXXXX
