--------------------------------------------------------------------------------------------------------------------------------------------------------------------------------------------------------------------------------------------------------------------------------------------------------------------------------------------------------------------------------------------------------------------------------------------------------------------------------------------------------------------------------------------------------------------------------------------------------------------------------------------------------------------------------------------------------------------------------------------------------------------------------------------------------------------------------------------------------------------------------------------------------------------------------------------------------------------------------------------------------------------------------------------------------------------------------------------------------------------------------------------------------------------------------------------------------------------------------------------------------------------------------------------------------------------------------------------------------------------------------------------------------------------------------------------------------
--------------------------------------------------------------------------------------------------------------------------------------------------------------------------------------------------------------------------------------------------------------------------------------------------------------------------------------------------------------------------------------------------------------------------------------------------------------------------------------------------------------------------------------------------------------------------------------------------------------------------------------------------------------------------------------------------------------------------------------------------------------------------------------------------------------------------------------------------------------------------------------------------------------------------------------------------------------------------------------------------------------------------------------------------------------------------------------------------------------------------------------------------------------------------------------------------------------------------------------------------------------------------------------------------------------------------------------------------------------------------------------------------------------------------------------------------------
----------------------------S-SSSSSSSSSSSSSSSSSSSSSSSSSSSSSSSSSSSSSSSSSSSSSSSSSSSSSSSSSSSSSSSSSSSSSSSSSSSSSSSSSSSSSSSSSSSSSSSSSSSSSSSSSSSSSSSSSSSSSSSSSSSSSSSSSSSSSSSSSSSSSSSSSSSSSSSSSSSSSSSSSSSSSSSSSSSSSSSSSSSSSSSSSSSSSSSSSSSSSSSSSSSSSSSSSSSSSSSSSSSSSSSSSSSSSSSSSSSSSSSSSSSSSSSSSSSSSSSSSSSSSSSSSSS--S-SSSSSSSSSSSSSSSSSSSSSSSSSSSSSSSSSSSSSSSSSSSSSSSSSSSSSSSSSSSSSSSSSSSSSSSSSSSSSSSSSSSSSSSSSSSSSSSSSSSSSSSSSSSSSSSSSSSSSSS---------------------SSS--SSSSSSSSSSSSSSSSSSSSSSSSSSSSSSSSSSSSSSSSSSSSSSSSSSSSSSSSSSS---------------------------SSSSSSSSSSSSSSSSSSSSSSSSSSSS----------------------------SSSSSSSSSSSSSSSSSSSSSSSSSSSSSSSSSSSSSSSSSSSSSSSSSSSSSSSS---------------------------SSSSSSSSSSSSSSSSSSSSSSSSSSSSSSSSSSSSSSSSSSSSSSSSSSSSSSSSSSSSSSSSSSSSSSSSSSSSSSSSSSSSSSSSSSSSSSSSSSSSSSSSSSSSSSSSSSSSSSSSSSSSSSSSSSSSSSSSSSSSSSSSSSSSSSSSSSSSSSSSSSSSSSSSSSSSSSSSSSSSSSSSSSSSSSSSSSSSSSSSSSSSSSSSSSSSSS----SSSS-SSSSSSSSSSSSSSSSSSSSSSSSSSSSSSSSSSSSSSSSSSSSSSSSSSSSSSSSSSSSSSSSSSSSSSSSSSSSSSSSSSSSSSSSSSSSSSSSSSSSSSSSSSSSSSSSSSS---------------------------SSSSSSSSSSSSSSSSSSSSSSSSSSSSSSSSSSSSSSSSSSSSSSSSSSSSSSSSSSSSSSSSSSSSSSSSSSSSSSSSSSSSSSSSSSSSSSSSSSSSSSSSSSSSSSSSSSSSSSSSSSSSSSSSSSSSSSSSSSSSSSSSSSSSSSSSSSSSSSSSSSSSSSSS----------------------------SSSSSSSSSSSSSSSSSSSSSSSSSSSSSSSSSSSSSSSSSSSS-----SSSS-SSSSSSSSSSSSSSSSSSSSSSSSSSSSSSSSSSSSSSSSSSSSSSSSSSSSSSSSSSSSSSSSSSS-SSSSSS---S-SSSSSSSSSSSSSSSSSSSSSSSSSSSSSSSSSSS
---------------------------------------------------------S-------SS-------------------------------------------------------------------------------------------------------------------------------------------------------------------------------------------------------------------------------------------------------------------------------------------------------------------------------------------------------------------------------------------------------------------------------------------------------------------------------------------------------------------------------------------------------------------------------------------------------------------------------------------------------------------------------------------------------------------------------------------------------------------------------------------------------------------------------------------------------------------------------------------------------------------------------------------------------------------------------------------------------------------------------------------------------------------------------------------------------------------------------------------------------------------------------------------------------------------------------------------------------------------------------------------------------------------------------------------------------------------------------------
-----------------------------------------------------------------SS-------------------------------------------------------------------------------------------------------------------------------------------------------------------------------------------------------------------------------------------------------------------------------------------------------------------------------------------------------------------------------------------------------------------------------------------------------------------------------------------------------------------------------------------------------------------------------------------------------------------------------------------------------------------------------------------------------------------------------------------------------------------------------------------------------------------------------------------------------------------------------------------------------------------------------------------------------------------------------------------------------------------------------------------------------------------------------------------------------------------------------------------------------------------------------------------------------------------------------------------------------------------------------------------------------------------------------------------------------------------------------------
--------------------------------S---------------------------S-----------oo----------------------------------------------------------------------------------------------------------------------------------------------------------S-------------------------------------------------------------------------------------------------------------------------------------------------------------------------------------------------------------------------------------------------------------------------------------------------------------------------------------------------------------------------------------------------------------------------------------------------------------------------------------------S-----------oo----------------------------------------------------------------------------------------------------------------------------------------------------------------------------------------------------------------------------------------------------------------------------------------------------------------------------------S-------------------------------------------------------------------------------------------------------------------------------------------S-------------------------------------------------------------------------------------------------------------------------------------------S-------------------------------------------------------------------------------
------XX-------------------------------------------------------------------------------------------------------------------------------------------------------------------------------------------------------------------------------------------------------------------------------------------------------------------------------------------------------------------------------------------------------------------------------------------------------------------------------------------------------------------------------------------------------------------------------------E-------------------------------------------------------------------------------------------------------------------------------------X-------------------------------------------------------------------------------------------------------------------------------------------X---------------------------------------------------------------------------------------------------------------------------------------------------------------------------------------------------X-----------------------------------------------------------------------------------------------------------------------------------------------------------------------------E--------------------------------------------------------------------------------------------------------------------------------------------------------------------------------------
--------------------------------S---------------------------S------------S------------------------------------------------------------------------------------------------------------------------------------------------------------------------------------------------------------------------------------------------------------------------------------------------------------------------------------------------------------------------------------------------------------------------------------------------------------------------------------------------------------------------------------------------------------------------------------------------------------------------------------------------------S------------S----------------------------------------------------------------------------------------------------------------------------------------------------------------------------------------------------------------------------------------------------------------------------------------------------------------------------------S---------------------------------------------------------------------------------------------------------------------------------------------------------------------------------------------------------------------------------------------------------------------------------------S-------------------------------------------------------------------------------
---------------E---------E------So-----------SS-------------S------E----SSSS-------------------E-----SSS-------------------E-----SSS--------------------------S--------------------E------S---------------------------S---------------S----------SS---------------------------S--------------------E------S--------------------------SS--------------------------SSS-------------------E------S--------------------E------S--------------------E---------------------------------SSS-------------------E------S---------------------------SS-------------------------SS--------------------E---------------------------E---------------------------E-----SSS--------------------------S---------------------------S-------------S-S-------S-SSSS--------------------------S--------------------------SSS-------------------E------S--------------------E------S--------------------E------S--------------------E---------------------------E------S--------------------------SS--------------------E-----SS--------------------E-----SS---------------------------S-------------SSS----------SSS--------------------------S--------------------E-----SS--------------------E-----SSS-------------------E------S---------------S----------SSS-------------------E----------------------------------S--------------------E----------------------------------S-------------SoS----------SSS-------------------E---------------------------------SS---------
--------------<>-----E--<>--XX--SSS---------------------------S---<>---------o----------------<>--------------------------<>-------------------------E-E---------E----------------<>---E-----E--o--Q----------<>---E-----E-----------------E---------E--o------------------------E-----Q----------<>---------------------------E---------E--o-------------<>---------o--o-------------<>---------------Q----------<>---------E--o---X---------<>---E--------------------------------------------------<>---------E-----------------E-------------------------------------E--o-------------<>--------------------------<>---------E----------------<>---------E--o------------E-----------E-----------------E---E-----E----------S-S--------------o---------------------------E----------------<>--------------------------<>---------E----------------<>---------E--o-------------<>---E-----E--o-------------<>--------------------------<>---------------------------E--------------------------<>---------E--o-------------<>--------------------------->---E-----E----------S-S----E------------ooo----------------------E----------------<>------------o-------------<>---------E----------------<>---E-----E-----------------E------------o-------------<>---------------------------E--------------------------<>---------E-----Q---------E-E---------E----------S-S--------------o----------------<>--------------------------<>------------o---
--------------[]----<>--[]-----------------E----------------------[]--------------------------[]--------------------------[]------------------------<><>---E----<>----------------[]--<>----<>----------------[]--<>----<>----------------<>---E----<>---------------E-----E----<>----------------[]---E-----E----------------<>---E----<>----------------[]--------------------------[]---E----------------------[]---E----<>----------------[]--<>--------------------------------------------------[]---E----<>----------------<>-------------------------E----<>----<>----------------[]---E-----E----------------[]--------<>-E--------------[]---E----<>--------------<>-----E----<>----------------<>--<>----<>-----------------E-------------------------------E----<>----------------[]---E----------------------[]---E----<>----------------[]---E----<>----------------[]--<>-----E----------------[]---E----------------------[]---E----------------------<>---E----------------------[]---E----<>----------------[]---E---------------------X[]--<>----<>----------------<>---E---------------------------E----<>----------------[]---E-----E----------------[]---E-----E----------------[]--<>----<>---------------E<>---E----------------------[]---E----------------------<>---E-----E----------------[]---E----<>--------------<>-E---E----<>--------------------------------------------[]--------------------------[]---E------------
--------------[]----[]--[]----------------<>----------------------[]--------------------------[]--------------------------[]------------------------[][]--<>----[]----------------[]--[]----[]----------------[]--[]----[]----------------[]--<>----[]--------------<>----<>----[]----------------[]--<>----<>----------------[]--<>----[]----------------[]--<>----------------------[]--<>----<>----------------[]--<>----[]----------------[]--[]--------------------------------------------------[]--<>----[]----------------[]------------------------<>----[]----[]----------------[]--<>----<>----------------[]----X---[]<>--------------[]--<>----[]--------------[]----<>----[]----------------[]--[]----[]----------------<>------------------------------<>----[]----------------[]--<>----------------------[]--<>----[]----------------[]--<>----[]----------------[]--[]----<>----------------[]--<>----------------------[]--<>----------------------[]--<>--------------<>------[]--<>----[]----------------[]--<>--------------------<>[]--[]----[]----------------[]--<>----------------------<>--<>----[]----------------[]--<>----<>----------------[]--<>----<>--------<>------[]--[]----[]--------------<>[]--<>----<>----------------[]--<>----------------------[]--<>----<>----------------[]--<>----[]--------------[]----<>----[]--------------------<>----------------------[]--------------------------[]--<>------------
--------------[]----[]--[]-----E----------[]------EE-E--E--EE-----[]----------------E--E------[]-----------E----E--E------[]-------------EE---EE----[][]--[]----[]---E-----E------[]--[]----[]---EE----EE-E---[]--[]----[]------E-EE------[]--[]----[]---E-----E----[]----[]----[]---E-----EE-E---[]--[]----[]---E----EE------[]--[]----[]------E-EE------[]--[]---------E----EE------[]--[]----[]-E-EE----E------[]--[]----[]---E----EE------[]--[]------EE-E--E-EE---------------------E-----EE-E---[]--[]----[]------E--EE-E---[]-----------E-EE---EE----[]----[]----[]---E----EEE-E---[]--[]----[]-E-EE----EE-E---[]----X---[][]----E--E------[]--[]----[]--------EE----[]----[]----[]---E----EE------[]--[]----[]-E-EE----E------[]----------------E-EE----------[]----[]-E-E--E--E------[]--[]---------E--E-EE------[]--[]----[]---E----EE------[]--[]----[]---E-----E------[]--[]----[]--------EE------[]--[]------EE-E----EE------[]--[]------EE-------EE-----[]--[]---------E--E-[]------[]--[]----[]---E----EE------[]--[]-------E-E----EE----[][]--[]----[]-E-EE---EE------[]--[]---------E-----E------[]--[]----[]-E-EE---EE------[]--[]----[]------E-EE------[]--[]----[]---E----[]------[]--[]----[]--------EE----[][]--[]----[]---E-----EE-E---[]--[]---------EE---EE------[]--[]----[]-E-EE---EE------[]--[]----[]-E-EE---EE----[]----[]----[]-E-E-----E----------[]-------E----E-EE------[]-----------E-E-----E------[]--[]---------EE-
XXXXXXXXXXXXXXXXXXXXXXXXXXXXXXXXXXXXXXXXXXXXXXXXXXXXXXXXXXXXXXXXXXXXXXXXXXXXXXXXXXXXXXXXXXXXXXXXXXXXXXXXXXXXXXXXXXXXXXXXXXXXXXXXXXXXXXXXXXXXXXXXXXXXXXXXXXXXXXXXXXXXXXXXXXXXXXXXXXXXXXXXXXXXXXXXXXXXXXXXXXXXXXXXXXXXXXXXXXXXXXXXXXXXXXXXXXXXXXXXXXXXXXXXXXXX-XXXXXXXXXXXXXXXXXXXXXXXXXXXXXXXXXXXXXXXXXXXXXXXXXXXXXXXXXXXXXXXXXXXXXXXXXXXXXXXXXXXXXXXXXXXXXXXXXXXXXXXXXXXXXXXXXXXXXXXXXXXXXXXXXXXXXXXXXXXXXXXXXXXXXXXXXXXXXXXXXXXXXXXXXXXXXXXXXXXXXXXXXXXXXXXXXXXXXXXXXXXXXXXXXXXXXXXXXXXXXXXXXXXXXXXXXXXXXXXXXXXXXXXXXXXXXXXXXXXXXXXXXXXXXXXXXXXXXXXXXXXXXXXXXXXXXXXXXXXXXXXXXXXXXXXXXXXXXXXXXXXXXXXXXXXXXXXXXXXXXXXXXXXXXXXXXXXXXXXXXXXXXXXXXXXXXXXXXXXXXXXXXXXXXXXXXXXXXXXXXXXXXXXXXXXXXXXXXXXXXXXXXXXXXXXXXXXXXXXXXXXXXXXXXXXXXXXXXXXXXXXXXXXXXXXXX-XXXXXXXXXXXXXXXXXXXXXXXXXXXXXXXXXXXXXXXXXXXXXXXXXXXXXXXXXXXXXXXXXXXXXXXXXXXXXXXXXXXXXXXXXXXXXXXXXXXXXXXXXXXXXXXXXXXXXXXXXXXXXXXXXXXXXXXXXXXXXXXXXXXXXXXXXXXXXXXXXXXXXXXXXXXXXXXXXXXXXXXXXXXXXXXXXXXXXXXXXXXXXXXXXXXXXXXXXXXXXXXXXXXXXXXXXXXXXXXXXXXXXXXXXXXXXXXXXXXXXXXXXXXXXXXXXXXXXXXXXXXXXXXXXXXXXXXXXXXXXXXXXXXXXXXXXXXXXXXXXXXXXXXXXXXXXXXXXXXXXXXXXXXXXXXXXXXXXXXXXXXXXXXXXXXXXXXXXXXXXXXXXXXXXXXXXXXXXXXXXXXXXXXXXXXXXXXXXXXXXXXXXXXXXXXXXXXXXXXXXXXXXXXXXXXXXXXXXXXXXXXXXXXXXXXXXXXXXXXXXXXXXXXXXXXXXXXXXXXXXXXXXXXXXXXXXXXXXXXXXXXXXXXXXXXXXXXXXXXXXXXXXXXXXXXXXXXXXXXXXXXXXXXXXXXXXXXXXXXXXXXXXXXXXXXXXXXXXXXXXXXXXXXXXXXXXXXXXXXXXXXXXXXXXXXXXXXXXXXXXXXXXXXXXXXXXXXXXXXXXXXXXXXXXXXXX
