--------------------------------------------------------------------------------------------------------------------------------------------------------------------------------------------------------------------------------------------------------------------------------------------------------------------------------------------------------------------------------------------------------------------------------------------------------------------------------------------------------------------------------------------------------------------------------------------------------------------------------------------------------------------------------------------------------------------------------------------------------------------------------------------------------------------------------------------------------------------------------------------------------------------------------------------------------------------------------------------------------------------------------------------------------------------------------------------------------------------------------------------------------------------------------------------------------------------------------------------------------------------------------------------------------------------------------------------------------------------------------------------------------------------------------------------------------
--------------------------------------------------------------------------------------------------------------------------------------------------------------------------------------------------------------------------------------------------------------------------------------------------------------------------------------------------------------------------------------------------------------------------------------------------------------------------------------------------------------------------------------------------------------------------------------------------------------------------------------------------------------------------------------------------------------------------------------------------------------------------------------------------------------------------------------------------------------------------------------------------------------------------------------------------------------------------------------------------------------------------------------------------------------------------------------------------------------------------------------------------------------------------------------------------------------------------------------------------------------------------------------------------------------------------------------------------------------------------------------------------------------------------------------------------------
SSSSSSSSSSSSSSSSSSSSSSSSSSSS----------------------------SSSSSSSSSSSSSSSSSSSSSSSSSSSSSSSSSSSSS-SSSSSS---S-SSSSSSSSSSSSSSSSSSSSSSSSSSSSSSSSSSSSSSSSSSSSSSSSSSSSSSSSSSSSSSSSSSSSSSSSSSSSSSSSSSSSSSSSSSSSSSSSSSSSSSSSSSSSSSSSSSSSSSSS-SS-------S-SS--------S---SS--S-----------------------SSSSSSSSSSSSSSSSSSSSSSSSSSSSSSSSSSSSSSSSSSSSSSSSSSSSSSSSSSSSSSSSSSSSSSSSSS-SSSSSSSSSSSSSSSSSSSSSSSSSSSSSSSSSSSSSSSSSSSSSSSSSSSSSSS--SSSSSSSSSSSSSSSSSSSSSSSSSSSSSSSSSSSSSSSSSSSSSSSSSSSSS-----SSSS-SSSSSSSSSSSSSSSSSSSSSSSSSSSSSSSSSSSSSSSSSSSSSSSSSSSSSSSSSSSSSSSSSSSSSSSSSSSSSSSSSSSSSSSSSSSSSSSSSSSSSSSSSSSSSSSSSSSSSSSSSSSSSSSSSSSSSSSSSSSSSSSSSSSSSSSSSSSSSSSSSSSSSSSSSSSSSSSSSSSSSSSSSSSSSSSSSSSSSSSSSSSSSSSSSSSSSSSSSSSSSSSSSSSSSSSSSSSSSSSSSSSSSSSSSSSSSSSSSSSSSSSSSSSSSSSSSSSSSSSSSSSSSSSSSSSSSSSSSSS--SSSSSSSSSSSSSSSSSSSSSSSSSSSSSSSSSSSSSSSSSSSSSSSSSSSSSSSSSSSSSSSSSSSSSSSSSSSSSSSSSSSSSSSSSSSSSSSSSSSSSSSSSSSSSSSSSSSSSSSSS----------------------------SSSSSSSSSSSSSSSSSSSSSSSSSSSSSSSSSSSSSSSSSSSSSSSSSSSSSSSSSSSSSSSSSSSSSSSSSSSSSSSSSSSSSSSSSSSSSSSSSSSSSSSSSSSSSSSSSSSSSSSSSSSSSSSSSSSSSSSSSSSSSSSSSSSSSSSSSSSS-----SSSS-SSSSSSSSSSSSSSSSSSSSSSSSSSSSSSSSSSSSSSSSSSSSSSSSSSSSSSSSSSSSSSSSSSSSSSSSSSSSSSSSSSSSSSSSSSSSSSSSSSSSSSSSSSSSSSSSSSSSSSSSSSSSSSSSSSSSSSSSSSSSSSSSSSSSSSSSSSSSSSSSSSSSSSSSSSSSSSSSSSSSSSSSSSSSSSSSSSSSSSSSSSSSSSSSSSSSSSSSSSSSSSSSSSSSSSSSSSSSSSSSSSSSSSSSSSSSSSS--------------------------SSSSSSSSSSSSSSSSSSSSSSSSSSSSS
----------------------------------------------------------------------------------------------------------------------------------------------------------------------------------------------------------------------------------------------------------------------------------------------------------------------------------------------------------------------------------------------------------------------------------------------------------------------------------------------------------------------------------------------------------------------------------------------------------------------------------------S---------------------------------------------------------------------------------------------------------------------------------------------------------------------------------------------------------------------------------------------------------------------------------------------------------------------------------------------------------------------------------------------------------------------------------------------------------------------------------------------------------------------------------------------------------------------------------------------------------------------------------------------------------------------------------------------------------------------------------------------------------------------------------------------------------------
--------------------------------------------------------------------------------------------------------------------------------------------------------------------------------------------------------------------------------------------------------------------------------------------------------------------------------------------------------------------------------------------------------------------------------------------------------------------------------------------------------------------------------------------------------------------------------------------------------------------------------------------------------------------------------------------------------------------------------------------------------------------------------------------------------------------------------------------------------------------------------------------------------------------------------------------------------------------------------------------------------------------------------------------------------------------------------------------------------------------------------------------------------------------------------------------------------------------------------------------------------------------------------------------------------------------------------------------------------------------------------------------------------------------------------------------------------
--------------------------------------------------------------------------------------------------------------------------------------------------------------------------------------------------------------------------------------------------------------------------------------------------------------------------------------------------------------------------------------------------------------------------------------------------------------------------------------------------------------------------------------------------------S-----------------------------------------------------------------------------------S-----------oo------------------------------------------S---------------------------------------------------------------------------------------------------------------------------------------------------------------------------------------------------------------------------------------------------------------------------------------------------------------------------------------------------------------------------S------------o------------------------------------------S-------------------------------------------------------S------------o------------------------------------------------------------------------------------------------------------------------------------------------------------------------------------------------------------------------------------------
------XX---------------------------------------------------------------------------------------------------------------------------------------------------------------------------------------------------------------------------------------------------------------------------------------X-----------------------------------------------------------------------------------------------------------------------------------------------------------------------------------------------------------------------------------------------------------X----------------------------------------------------------------------------------XX---------------------------------------------------------------------------------------------------------------------------------------------------------------------------------------------------X-----------------------------------------------------------------------------------------------------------------------------------------------------------------------------------------------------------------------------------------------------------------------------------------------------------------------------------------------X-------------------------------------------------------------------------------------------------------------------------------------------X--------------------------------------------------------------------------------------------------------
---------------------------------------------------------------------------------------------------------------------------------------------------------------------------------------------------------------------------------------------------------------------------------------------------------------------------------------------------------------------------------------------------------------------------------------------------------------------------------------------------------------------------------------------------------------------------------------------------------------------------------------------------------S------------------------------------------------------------------------------------------------------------------------------------------------------------------------------------------------------------------------------------------------------------------------------------------------------------------------------------------------------------------------------------------------------------------------------------------------------------------------------S---------------------------------------------------------------------------------------------------------------------------------------------------------------------------------------------------------------------------------------------------------------------------------------------------------------
------------------S-------------------------------------------------------S------------------------------------------------------SSS-------------------E------S---------------------------S--------------------------SSS-------------------E------S------------------------------E---------------------ESSS------------------------------------------------------S---------------------------S---------------------------SS--------------------------SS--------------------E------S--------------------------SS--------------------------SS--------------------E-----SSSS------------------------SSS--------------S----E------S---------------S----------SS-S------------------E------S---------------S----------SS--------------------E-----SSS---------------------------------------------------------------------------E-----SSS-----------------------ESSS--------------------E------S--------------------------SSS-----------------------------------------------------SS--------------------E-----SSS-------------------E---------------------------E-----SS---------------S----------SSS-------------------E------S---------------S----------SS--------------------------SS--------------------------SSSS------------------------SS--------------------E------SS-------------------E------S--------------------E------S--------------------------SSS--------------------------S--------------------E----------------------S----------SSS--------
---------------E-----E---------------------------E---------------E-------------------------------------------------------------------o--o-------------<>---------E---------------E-E---------E--o--Q-----------E--------------------------<>---E-----------------------E--------<>-----------------E--<>-----E--ooo----------------------E--o--Q-----------E---------------------------E--------------------------------------------------------------------o-------------<>---------E---------------E<>------------o---X-----------------------o---------S---<>---------o--o-------------<>-------------------E-----E<>---------E---------------------------o--o-------------<>---E-----E-----------------E------------o-------------<>----------------------------------------------------------------------------------<>------------------------------<>-----E--o-------------<>---------E-------------------------------------------E-----------E----------------<>---------E----------------<>------------o-------------<>--------------------------<>----------------------S----E---------o--o-------------<>---E-----E------------S----E---------E--oo------------<>------------o--------------E---------o--oo-----------E--------------o-------------<>-------------------------E<>---------E----------------<>---------E-----------------E---------o--o--------------E---------E----------------<>---------E---------------E-E------------o---
--------------<>----<>---------------------E----<>-E------------<>-------------------------------------------------------------E----------------------[]---E----<>--------------<><>---E----<>----------------<>---E----------------------[]--<>-----E----------------<>---E----[]----------------<>--[]----<>---------------------E----<>----------------<>--------------------------<>--------------------------<>---E--------------------------------------------------[]---E----<>--------------<>[]---E-----E---------------------E----------------------[]--------------------------[]---E-----E--------<>----<>[]---E----<>---------------------E----------------------[]--<>----<>----------------<>---E----------------------[]---E---------------------------E---------------------------E-----E----------------[]---E--------------------------[]----<>----------------[]---E----<>------------------------------------------<>-----E----<>----------------[]---E----<>----------------[]---E---------------------E[]-----------E--------------[]---E----------------------<>--------------------------[]--<>----<>----------------<>--<>----<>----------------[]---E----------------------<>---E--------------------<>-----E----------------------[]---E--------------------<>[]---E----<>----------------[]---E----<>----------------<>---E----------------------<>---E----<>----------------[]---E----<>--------------<><>---E-----E------
--------------[]----[]--------------------<>----[]<>------------[]----------<>------------------------------------------------<>----------------------[]--<>----[]--------------[][]--<>----[]----------------[]--<>----------------------[]--[]----<>----------------[]--<>----[]----------------[]--[]----[]--------------<>----<>----[]----------------[]--------------------------[]--------------------------[]--<>----<>--------------------------------------------[]--<>----[]--------------[][]--<>----<>----------------<>--<>----------------------[]--<>----------------------[]--<>----<>--------[]----[][]--<>----[]--------------<>----<>--------------------<>[]--[]----[]----------------[]--<>----------------------[]--<>--------------------------<>--------------------------<>----<>----------------[]--<>--------------------------[]----[]----------------[]--<>----[]--------------------<>--------------------[]----<>----[]----------------[]--<>----[]----------------[]--<>--------------------<>[]--<>------<>--------------[]--<>----------------------[]------------------<>------[]--[]----[]----------------[]--[]----[]----------------[]--<>----<>----------------[]--<>--------------------[]----<>----------------------[]--<>--------------------[][]--<>----[]----------------[]--<>----[]----------------[]--<>----------------------[]--<>----[]----------------[]--<>----[]--------------[][]--<>----<>------
--------------[]----[]---------EE-E-----E-[]----[][]-E----EE----[]----------[]---E--E--E------------------EE-E-----E----------[]---------E-----E------[]--[]----[]--------EE----[][]--[]----[]---E--E--EE-E---[]--[]-------E-EE----EE-E---[]--[]----[]-E-E--E--EE-E---[]--[]----[]-E-E-----E------[]--[]----[]---------E----[]----[]----[]---EE---EE------[]-------------E----EE------[]-----------E-E-----E------[]--[]----[]---E--E--E-------------------E-E-----EE-E---[]--[]----[]-E-E----EE----[][]--[]----[]---E----EE------[]--[]-------E-E--E--E------[]--[]---------E--E-EE------[]--[]----[]-E-EE---[]----[][]--[]----[]---E-----E----[]----[]--------------EE----[][]--[]----[]--------EE------[]--[]-------E-E--E--E------[]--[]---------E----EE----------[]-------E-EE----E--E-------[]----[]--------EE------[]--[]-------E-E-----E--E----E--[]----[]------E--E------[]--[]----[]-E-E--E--E----------[]-------E-EE---EE----[]----[]----[]-E-E--E--E------[]--[]----[]---EE---EE------[]--[]---------EE-E-EE----[][]--[]------[]-E----EE------[]--[]-------E-E--E-EE------[]-------------E----[]------[]--[]----[]---E--E--E------[]--[]----[]------E-EE------[]--[]----[]---E--E--E------[]--[]---------E----EE-E--[]----[]-------E-E--E-EE------[]--[]---------E----EE----[][]--[]----[]-E-E--E--E------[]--[]----[]--------EE------[]--[]---------E--E-EE--E---[]--[]----[]-E-EE---EE------[]--[]----[]-E-EE---EE----[][]--[]----[]---E--
-XXXXXXXXXXXXXXXXXXXXXXXXXXXXXXXXXXXXXXXXXXXXXXXXXXXXXXXXXXXXXXXXXXXXXXXXXXXXXXXXXXXXXXXXXXXXXXXXXXXXXXXXXXXXXXXXXXXXXXXXXXXXXXXXXXXXXXXXXXXXXXXXXXXXXXXXXXXXXXXXXXXXXXXXXXXXXXXXXXXXXXXXXXXXXXXXXXXXXXXXXXXXXXXXXXXXXXXXXXXXXXXXXXXXXXXXXXXXXXXXXXXXXXXXXXXXXXXXXXXXXXXXXXXXXXXXXXXXXXXXXXXXXXXXXXXXXXXXXXXXXXXXXXXXXXXXXXXXXXXXXXXXXXXXXXXXXXXXXXXXXXXXXXXXXXXXXXXXXXXXXXXXXXXXXXXXXXXXXXXXXXXXXXXXXXXXXXXXXXXXXXXXXXXXXXXXXXXXXXXXXXXXXXXXXXXXXXXXXXXXXXXXXXXXXXXXXXXXXXXXXXXXXXXXXXXXXXXXXXXXXXXXXXXXXXXXXXXXXXXXXXXXXXXXXXXXXXXXXXXXXXXXXXXXXXXXXXXXXXXXXXXXXXXXXXXXXXXXXXXXXXXXXXXXXXXXXXXXXXXXXXXXXXXXXXXXXXXXXXXXXXXXXXXXXXXXXXXXXXXXXXXXXXXXXXXXXXXXXXXXXXXXXXXXXXXXXXXXXXXXXXXXXXXXXXXXXXXXXXXXXXXXXXXXXXXXXXXXXXXXXXXXXXXXXXXXXXXXXXXXXXXXXXXXXXXXXXXXXXXXXXXXXXXXXXXXXXXXXXXXXXXXXXXXXXXXXXXXXXXXXXXXXXXXXXXXXXXXXXXXXXXXXXXXXXXXXXXXXXXXXXXXXXXXXXXXXXXXXXXXXXXXXXXXXXXXXXXXXXXXXXXXXXXXXXXXXXXXXXXXXXXXXXXXXXXXXXXXXXXXXXXXXXXXXXXXXXXXXXXXXXXXXXXXXXXXXXXXXXXXXXXXXXXXXXXXXXXXXXXXXXXXXXXXXXXXXXXXXXXXXXXXXXXXXXXXXXXXXXXXXXXXXXXXXXXXXXXXXXXXXXXXXXXXXXXXXXXXXXXXXXXXXXXXXXXXXXXXXXXXXXXXXXXXXXXXXXXXXXXXXXXXXXXXXXXXXXXXXXXXXXXXXXXXXXXXXXXXXXXXXXXXXXXXXXXXXXXXXXXXXXXXXXXXXXXXXXXXXXXXXXXXXXXXXXXXXXXXXXXXXXXXXXXXXXXXXXXXXXXXXXXXXXXXXXXXXXXXXXXXXXXXXXXXXXXXXXXXXXXXXXXXXXXXXXXXXXXXXXXXXXXXXXXXXXXXXXXXXXXXXXXXXXXXXXXXXXXXXXXXXXXXXXXXXXXXXXXXXXXXXXXXXXXXXXXXXXXXXXXXXXXXXXXXXXXXXXXXXXXXXXXXXXXXXXXXXXXXXXXXXXXXXXXXXXXXXXXXXXX
