--------------------------------------------------------------------------------------------------------------------------------------------------------------------------------------------------------------------------------------------------------------------------------------------------------------------------------------------------------------------------------------------------------------------------------------------------------------------------------------------------------------------------------------------------------------------------------------------------------------------------------------------------------------------------------------------------------------------------------------------------------------------------------------------------------------------------------------------------------------------------------------------------------------------------------------------------------------------------------------------------------------------------------------------------------------------------------------------------------------------------------------------------------------------------------------------------------------------------------------------------------------------------------------------------------------------------------------------------------------------------------------------------------------------------------------------------------
--------------------------------------------------------------------------------------------------------------------------------------------------------------------------------------------------------------------------------------------------------------------------------------------------------------------------------------------------------------------------------------------------------------------------------------------------------------------------------------------------------------------------------------------------------------------------------------------------------------------------------------------------------------------------------------------------------------------------------------------------------------------------------------------------------------------------------------------------------------------------------------------------------------------------------------------------------------------------------------------------------------------------------------------------------------------------------------------------------------------------------------------------------------------------------------------------------------------------------------------------------------------------------------------------------------------------------------------------------------------------------------------------------------------------------------------------------
SSSSSSSSSSSSSSSSSSSSSSSSS-SS----------------------------SSSSSSSSSSSSSSSSSSSSSSSSSSSSSSSSSSSSSSSSSSSSSSSSSSSSSSSSSSSSSSSSSSSSSSSSSSSSSSSSSSSSSSSSSSSSSSSSSSSSSSSSSSSSSSSSSSSSSSS----SSSSS-----SSSS-SSSSSSSSSSSSSSSSSSSSSSSSSSSSSSSSSSSSSSSSSSSSSSSSSSSSSSSSSSSSSSSSSSSSSSSSSSSSSSSSSSSSSSSSSSSSSSSSSSSSSSSSSSSSSSSSSSSSSSSSSSSSSSSSSSSSSSSSSSSSSSSSSSSSSSSSSSSSSSSSSSSSSSSSSSSSSSSSSSSSSSSSSSSSSSSSSSSSSSS---------------------------SSSSSSSSSSSSSSSSS-SSSSSSSSSS----------------------------SSSSSSSSSSSSSSSSSSSSSSSSSSSSSSSSSSSSSSSSSSSSSSSSSSSSSSSSSSSSSSSSSSSSSSSSSSSSSSSSSSSSSSSSSSSSSSSSSSSSSSSSSSSSSSSSSSSS------------------------SSSSSSSSSSSSSSSSSSSSSSSSSSSSS--S-SSS---SSSSSSSSSSSSSSSSSSSSSSSSSSSSSSSSSSSSSSSSSSSSSSSSSSSSSSSSSSSSSSSSSSSSSSSSSSSSSSSSSSSSSSSSSSSSSSSSSSSSSSSSSSSSSSSSSSSSSSSSSSSSSSSSSSSSSSSSSSSSSSSSSSSSSSSSSSSSSSSSSSSSSSSSSSSSSSSSSSSSSSSSSSSSSSSSSSSSSSSSSSSSSSSSSSSSSSSSSSSSSSSSSSSSSSSSSSSSSSSSSSSSSSSSSSSSSSSSSSSSSSSSSSSSSSSSSSSSSSSSSSSSSSSSSSSSSSSSSSSSSSSSSSSSSSSSSSSSSSSSSSSSSSSSSSSSSSSSSSSSSSSSSSSSSSSSSSSSSSSSSSSSSSSSSSSSSSSSSSSSSSSSSSSSSSSSSSSSS-----SSSS-SSSSSSSSSSSSSSSSSSSSSSSSSSSSSSSSSSSSSSSSSSSSSSSSSSSSSSSSSSSSSSSSSSSSSSSSSSSSSSSSSSSSSSSSSSSSSSSSSSSSSSSSSSSSSSSSSSSSSSSSSSSSSSSSSSSSSSSSSSSSSSSSSSSSSSS-SSSSSS-----SSSS-SSSSSSSSSSSSSSSSSSSSSSSSSSSSSSSSSSSSSSSSSSSSSSSSSSSSSSSSSSSSSSSSSSSSSSSS--------------SSSSSSSSSSSSSSS------SSS--SSSSSSSSSSSSSSSSSSSSSSSSSSSSSSSSSSSSSSS-SSSSSS-----SSSS-SS
--------------------------------------------------------------------------------------------------------------------------------------------------------------------------------------------------------------------------------------------------------------------------------------------------------------------------------------------------------------------------------------------------------------------------------------------------------------------------------------------------------------------------------------------------------------------------------------------------------------------------------------------------------------------------------------------------------------------------------------------------------------------------------------------------------------------------------------------------------------------------------------------------------------------------------------------------------------------------------------------------------------------------------------------------------------------------------------------------------------------------------------------------------------------------------------------------------------------------------------------------------------------------------------------------------------------------------------------------------------------------------------------------------------------------------------------------------
--------------------------------------------------------------------------------------------------------------------------------------------------------------------------------------------------------------------------------------------------------------------------------------------------------------------------------------------------------------------------------------------------------------------------------------------------------------------------------------------------------------------------------------------------------------------------------------------------------------------------------------------------------------------------------------------------------------------------------------------------------------------------------------------------------------------------------------------------------------------------------------------------------------------------------------------------------------------------------------------------------------------------------------------------------------------------------------------------------------------------------------------------------------------------------------------------------------------------------------------------------------------------------------------------------------------------------------------------------------------------------------------------------------------------------------------------------
----------------------------------------------------------------------------------------------------------------------------------------------------------------------------------------------------------------------------------------------------------------S-----------------------------------------------------------------------------------------------------------------------------------------------------------------------------------------------------------------------------------------------------------S---------------------------S-------------------------------------------------------------------------------------------------------------------------------------------S-------------------------------------------------------S-------------------------------------------------------------------------------------------------------------------------------------------------------------------------------------------------------------------------------------------------------------------------------------------------------------------------------------------------------------------------------------------------------------------------------------------------------------------------------------------------------------------------------------------------------------------------------------------------------------------------------------------------------------------------------------------
---------------------------------------------------------------------------------------------------------------------------------------------------------------------------------------------------------------------------------------------------------------------------------------------------------------------------------------------------------------------------------------------------------------------------------------------------------------------------------------------------------------------------------------------------------------------------------------------------------------------------------------------------------------------------------------------------------------------------------------------------------------------------------------------------------------------------------------------------X-----E----------------------------------------------------------------------------------------------------------------------------------------------------------------------------------------------------------------------------------------------------------------------------------------------------------------------------------------------------------------------------------------------------------------------------------------------------------------------------------------------------------------------------------------------------------------------------------------------
----------------------------------------------------------------------------------------------------------------------------------------------------------------------------------------------------------------------------------------------------------------S---------------------------------------------------------------------------------------------------------------------------------------------------------------------------------------------------------------------------------------------------------------------------------------------------------------------------------------------------------------------------------------------------------------------------------------------------------------------------------------------------------------------------------------------------S-----------------------------------------------------------------------------------------------------------------------------------------------------------------------------------------------------------------------------------------------------------------------------------------------------------------------------------------------------------------------------------------------------------------------------------------------------------------------------------------------------------------------------------------------------------------------------------------------------------------------------------
--------------------------------------------------------------------------S--------------------E------SS-------------------E-----SSS-------------------E---------------------------E---------------------------------SS--------------------E------S-------------SoS----------SSS-------------------E-----SS--------------------E------S---------------------------S--------------------------SS---------------------------SS--------------------------S---------------------------S------------------------------------------------------SS--------------------------SSS-------------------E-----SSS-----------------------E--S---------------------------S------------------------------------------------E-----SS--------------------E-----SS---------------------------S-------------------------SSS------------------------------------------------E-----SS--------------------E-----SSS--------------------------S--------------------E------S--------------------------SSS-------------------------SS--------------------------SS--------------------------SS--------------------E---------------------------E---------------------------E------S--------------------E-----SS--------------------E------S--------------------E-----SSS-------------------E---------------------------------SS--------------------E-----SSS-------------------E---------------------------E------S--------------------------SS--------------------E------S---------
X---S--------------------------------------------------------------E---------E----------------<>--------------------------<>--------------------------<>--------------------------<>---------E-----------------E---------E--o-------------<>--------------------SSS----E------------o-------------<>---------E----------------<>---------E----------------<>---E-----E--------------------------------------------<>-------------------------------------E-----------------E---E-----E-----------------E---------------------------E---------E--oooQ---------------------o--o-------------<>---------o-----------------E--<>-----E---------------E-----E-----E--o--Q--------------------------------------<>---------o--o-------------<>------------o------------------------E--o--Q---------------------o----------S-S-------------------------------<>---------o----------------<>---------o-----------------E--<>-----E----------------<>--------------------------<>---------o-----------------E---E-----E--o------------------------------------------E---------E--o-------------<>---------E----------------<>--------------------------<>---------E----------------<>---------E----------------<>---------E--o-------------<>------------o-------------<>---------E---------------------------E--o-------------<>---------o--o-------------<>--------------------------<>---E-----E-----Q---------------------E----------------<>---------E------
---------------E---------------------------E-----E----------------<>---E----<>----------------[]---E----------------------[]---E----------------------[]---------E----------------[]---E----<>----------------<>---E----<>----------------[]---E----------------------<>---E----------------------[]---E----<>----------------[]---E----<>----------------[]--<>----<>--------------------------------------------[]---E---------------------E-----E----<>---------------E<>--<>----<>----------------<>--------------------------<>---E----<>--------------------------------------------[]---E---------------------E<>--[]----<>--------------<>----<>----<>---------------------E----------------------[]--------------------------[]---E---------------------E----------<>-------------------------------------------------E----------------------[]---E----------------------[]--------------------------<>--[]----<>----------------[]---E----------------------[]--------------------------<>--<>----<>-----------------E---E----------------------<>--<>-----E----------------[]---E----<>----------------[]--------------------------[]---E----<>----------------[]---E----<>----------------[]---E----<>----------------[]---E---------------E------[]---E----<>--------------------<>-----E----------------[]---E----------------------[]--------------------------[]--<>----<>---------------------E----<>----------------[]---E----<>------
--------------<>----------------------<>--<>----<>----------------[]--<>----[]----------------[]--<>----------------------[]--<>----------------------[]--------<>----------------[]--<>----[]----------------[]--<>----[]----------------[]--<>----------------------[]--<>----------------------[]--<>----[]----------------[]--<>----[]----------------[]--[]----[]--------------------------------------------[]--<>--------------------<>----<>----[]--------------<>[]--[]----[]----------------[]--------------------------[]--<>----[]----------------<>--------------------------[]--<>--------------------<>[]--[]----[]--------------[]----[]----[]----------------<>--<>----------------------[]--------------------------[]--<>--------------------<>----------[]------------------------------------------------<>----------------------[]--<>----------------------[]--------------------------[]--[]----[]----------------[]--<>----<>----------------[]--<>----------------------[]--[]----[]----------------<>--<>----------------------[]--[]----<>----------------[]--<>----[]----------------[]--<>----------------------[]--<>----[]----------------[]--<>----[]----------------[]--<>----[]----------------[]--<>--------------<>------[]--<>----[]----------------<>--[]----<>----------------[]--<>----------------------[]--------------------------[]--[]----[]--------------------<>----[]----------------[]--<>----[]------
---EE---------[]------EE-EE----EE-----[]--[]----[]-E-E--E--EE-E---[]--[]----[]-E-EE-E--EE-----[]--[]------EE-------EE-E---[]--[]-------E-E----EE------[]--------[]-E-E----EE------[]--[]----[]-E-EE-E-EE------[]--[]----[]---E--E--E------[]--[]---------------EE-----[]--[]-------E-EE---EE------[]--[]----[]-E-E-----E------[]--[]----[]-E-E-----EE-E---[]--[]----[]-------------------------------------EE-E---[]--[]-------E-EE-E-EE--E-[]----[]----[]-E-EE---EE--E-[][]--[]----[]-E-E--E-EE------[]-------------E-----E------[]--[]----[]---E-----E------[]-------------E--E-EE------[]--[]-------E-E----EE--E-[][]--[]----[]---E----EE----[]----[]----[]------E-EE--E---[]--[]------EE-E--E--EE-----[]-----------E-E----EE------[]--[]---------E----EE-E--[]----------[]---EE---------EE--------------------EE-----E----[]-------E------EE------[]--[]------------E--E------[]-------------E----EE--E---[]--[]----[]-E-E----EE------[]--[]----[]------E--E------[]--[]--------------EE------[]--[]----[]---------E------[]--[]---------EE----E------[]--[]----[]---------E--E---[]--[]----[]------E-EE------[]--[]------EE-E-----EE-E---[]--[]----[]-E-EE-E-EE------[]--[]----[]--------EE------[]--[]----[]---E----EE------[]--[]---------E----[]------[]--[]----[]--------EE------[]--[]----[]---E----EE------[]--[]---------E-----EE-----[]-----------E-E-----E------[]--[]----[]---E-----E----------[]----[]-E----E-EE------[]--[]----[]-E-E--
XXXXXXXXXXXXXXXXXXXXXXXXXXXXXXXXXXXXXXXXXXXXXXXXXXXXXXXXXXXXXXXXXXXXXXXXXXXXXXXXXXXXXXXXXXXXXXXXXXXXXXXXXXXXXXXXXXXXXXXXXXXXXXXXXXXXXXXXXXXXXXXXXXXXXXXXXXXXXXXXXXXXXXXXXXXXXXXXXXXXXXXXXXXXXXXXXXXXXXXXXXXXXXXXXXXXXXXXXXXXXXXXXXXXXXXXXXXXXXXXXXXXXXXXXXXXXXXXXXXXXXXXXXXXXXXXXXXXXXXXXXXXXXXXXXXXXXXXXXXXXXXXXXXXXXXXXXXXXXXXXXXXXXXXXXXXXXXXXXXXXXXXXXXXXXXXXXXXXXXXXXXXXXXXXXXXXXXXXXXXXXXXXXXXXXXXXXXXXXXXXXXXXXXXXXXXXXXXXXXXXXXXXXXXXXXXXXXXXXXXXXXXXXXXXXXXXXXXXXXXXXXXXXXXXXXXXXXXXXXXXXXXXXXXXXXXXXXXXXXXXXXXXXXXXXXXXXXXXXXXXXXXXXXXXXXXXXXXXXXXXXXXXXXXXXXXXXXXXXXXXXXXXXXXXXXXXXXXXXXXXXXXXXXX-XXXXXXXXXXXXXXXXXXXXXXXXXXXXXXXXXXXXXXXXXXXXXXXXXXXXXXXXXXXXXXXXXXXXXXXXXXXXXXXXXXXXXXXXXXXXXXXXXXXXXXXXXXXXXXXXXXXXXXXXXXXXXXXXXXXXXXXXXXXXXXXXXXXXXXXXXXXXXXXXXXXXXXXXXXXXXXXXXXXXXXXXXXXXXXXXXXXXXXXXXXXXXXXXXXXXXXXXXXXXXXXXXXXXXXXXXXXXXXXXXXXXXXXXXXXXXXXXXXXXXXXXXXXXXXXXXXXXXXXXXXXXXXXXXXXXXXXXXXXXXXXXXXXXXXXXXXXXXXXXXXXXXXXXXXXXXXXXXXXXXXXXXXXXXXXXXXXXXXXXXXXXXXXXXXXXXXXXXXXXXXXXXXXXXXXXXXXXXXXXXXXXXXXXXXXXXXXXXXXXXXXXXXXXXXXXXXXXXXXXXXXXXXXXXXXXXXXXXXXXXXXXXXXXXXXXXXXXXXXXXXXXXXXXXXXXXXXXXXXXXXXXXXXXXXXXXXXXXXXXXXXXXXXXXXXXXXXXXXXXXXXXXXXXXXXXXXXXXXXXXXXXXXXXXXXXXXXXXXXXXXXXXXXXXXXXXXXXXXXXXXXXXXXXXXXXXXXXXXXXXXXXXXXXXXXXXXXXXXXXXXXXXXXXXXXXXXXXXXXXXXXXXXXXXXXXXXXXXXXXXXXXXXXXXXXXXXXXXXXXXXXXXXXXXXXXXXXXXXXXXXXXXXXXXXXXXXXXXXXXXXXXXXXXXXXXXXXXXXXXXXXXXXXXXXXXXXXXXXXXXXXXXXXXXXXXXXXXXXXXXXXXXXXXXXX
