--------------------------------------------------------------------------------------------------------------------------------------------------------------------------------------------------------------------------------------------------------------------------------------------------------------------------------------------------------------------------------------------------------------------------------------------------------------------------------------------------------------------------------------------------------------------------------------------------------------------------------------------------------------------------------------------------------------------------------------------------------------------------------------------------------------------------------------------------------------------------------------------------------------------------------------------------------------------------------------------------------------------------------------------------------------------------------------------------------------------------------------------------------------------------------------------------------------------------------------------------------------------------------------------------------------------------------------------------------------------------------------------------------------------------------------------------------
--------------------------------------------------------------------------------------------------------------------------------------------------------------------------------------------------------------------------------------------------------------------------------------------------------------------------------------------------------------------------------------------------------------------------------------------------------------------------------------------------------------------------------------------------------------------------------------------------------------------------------------------------------------------------------------------------------------------------------------------------------------------------------------------------------------------------------------------------------------------------------------------------------------------------------------------------------------------------------------------------------------------------------------------------------------------------------------------------------------------------------------------------------------------------------------------------------------------------------------------------------------------------------------------------------------------------------------------------------------------------------------------------------------------------------------------------------
--------------------------------------------------------SSSSSSSSSSSSSSSSSSSSSSSSSSSSSSSSSSSSSSSSSSSSSSSSSSSSSSSSSSSSSSSSSSSSSSSSSSSSSSSSSSSSSSSSSSSSSSSSSSSSSSSSSSSSSSSSSSSSSSSSSSSSSSSSSSSSSSSSSSSSSSSSSSSSSSSSSSSSSSSSSSSSSSSSSSSSSSSSSSSSSSSSSSSSSSSSSSSS----------------------------SSSSSSSSSSSSSSSSSSSSSSSSSSSSSSSSSSSSSSSSSSSSSSSSSSSSSSSSSSSSSSSSSSSSSSSSSSSSSSSSSSSSSSSSSSSSSSSSSSSSSSSSSSSSSSSSSSSSSSSSSSSSSSSSSSSSSSSSSSSSSSSSSSSSSSSSSSSSSSSSSSSSSSSSSSSSSSSSSSSSSSSSSSSSSSSSSSSSSSSSSSSSSSSSSSSSSSSSSSSSSSSSSSSSSSSSSSSSSSSSSSSSSSSSSSSSSSSSSSSSSSSSSSSSSSSSSSSSSSSSSSSSSSSSSSSSSSSSSSSSSSSSSSSSSSSSSSSSSSSSSSSSSSSSSSSSSSSSS-S-------------------------SSSSSSSSSSSSSSSSS--S-SSSSSSSSSSSSSSSSSSSSSSSSSSSSSSSSSSSSSSSSSSSSSSSSSSSSSSSSSSSSSSSSSSSSSSSSSSSSSSSSSSSSSSSSSSSSSSSSSSSSSSSSSSSS-SSSSSSSSSSSSSSSSSSSSSSSSSSSSSSSSSSSSSSSSSSSSSSSSSSSSSSSSSSSSSSSSSSSSSSSSSSSSSSSSSSSSSSSSSSSSSSSSSSSSSSSSSSSSSSSSSSSSSSSSSSSSSSSSSSSSSSSSSSSSSSSSSSSSSSSSSSSSSSSSSSSSSSSSSSSSSSSSSSSSSSSSSSSSSSSSSSSSSSSSSSSSSSSSSSSSSSSSSSSSSSSSSSSSSSSSSSSSSSSSSSSSSSSSSSSSSSSSSSSSSSSSSSSSSSSSSSSSSSSSSSSSSSSSSSSSSSSSSSSSSSSSSSSSSSSSSSSSSSSSSSSSSSSSSSSSSSSSSSSSSSSSSSSSSSSSSSSSSSSSSSS----SSSS-SSSSSSSSSSSSSSSSSSSSSSSSSSSSSSSSSSSSSSSSSSSSSSSSSSSSSSSSSS--------------------------------------------------------SSSSSSSSSSSSSSSS---SSSSSSSSSSSSSSSSS---SSSSSSSSSSSSSSSSSSSSSSSSSSSSSSSSSSSSSSSSSSSSSSSSSSSSSSSSSSSSSSSSSSSSSSSSSSSSSSSSSSSSSSSSSSSSSSSSSSSSS
--------------------------------------------------------S-------------------------------------------------------------------------------------------------------------------------------------------------------------------------------------------------------------------------------------------------------------------------------------------------------------------------------------------------------------------------------------------------------------------------------------------------------------------------------------------SS--------------------------------------------------------------------------------------------------------------------------------------------------------------------------------------------------------------------------------------------------------------------------------------------------------------------------------------------------------------------------------------------------------------------------------------------------------------------------------------------------------------------------------------------------------------------------------------------------------------------------------------------------------------------------------------------------------------------------------------------------------------------------------------------------------------------------------------------------------------------------------------------------
--------------------------------------------------------S-------------------------------------------------------------------------------------------------------------------------------------------------------------------------------------------------------------------------------------------------------------------------------------------------------------------------------------------------------------------------------------------------------------------------------------------------------------------------------------------S--------SS-----------------------------------------------------------------------------------------------------------------------------------------------------------------------------------------------------------------------------------------------------------------------------------------------------------------------------------------------------------------------------------------------------------------------------------------------------------------------------------------------------------------------------------------------------------------------------------------------------------------------------------------------------------------------------------------------------------------------------------------------------------------------------------------------------------------------------------------------------------------------------------------
--------------------------------------------------------S---S-----------o---------------------------------------------------------------------------------------------------S-------------------------------------------------------S-------------------------------------------------------S-----------------------------------------------------------------------------------------------------------------------------------------------------------------------------------------------------------------------------------------------------------S-----------oo------------------------------------------S-------------------------------------------------------------------------------------------------------------------------------------------------------------------------------------------------------------------------------------------------------------------------------------------------------------------------------------------------------------------------------------------------------S-----------------------------------------------------------------------------------------------------------------------------------------------------------------------------------------------------------------------------------------------------------------------------------------------------------------------------------------------S-------------------------------------------------------------------------------
--------------------------------------------------------S--------------------------------XXX--------------------------------------------------------------------------------------------------------------------------------------------------------------------------------------------------------------------------------------------------------------------------------------XX----------------------------------------------------------------------------------------------------------------------------------------------------------------------XX-----------------------------------------------------------------------------------------------------------------------------------------------------------------------------------------------------------------------------------------------------------X--------------------------------------------------------------------------------------------------------------------------------------------------------------------------------------------------------------------------------------------------------------------------------------------------------------------------------------------------------------------------------------------------------------------------------------------------------------------------------------------------------------------------------------------------------------------------------------------------------------------------------
--------------------------------------------------------S---S-S----------S----------------------------------------------------------------------------------------------------------------------------------------------------------S-------------------------------------------------------S------------------------------------------------------------------------------------------------------------------------------------------------------------------------------------------------------------------------------------------------------------------------S----------------------------------------------------------------------------------------------------------------------------------------------------------------------------------------------------------------------------------------------------------------------------------------------------------------------------------------------------------------------------------------------------------------------------------------------------------------------------------------------------------------------------------------------------------------------------------------------------------------------------------------------------------------------------------------------------------------------------------------------------------------------------------------------------------------------------------------------------------------------------------
--------------------------------------------------------S---SoS----------SSS-------------------------SSSS------------------------SS--------------------E------S--------------------E-----SSS-------------------------SS-------------SoS----------SS--------------------E----------------------S----------SS--------------------E------S--------------------------SS--------------------------SSS-------------------------SS--------------------------SS--------------------------SS--------------------E------S---------------------------S--------------SS----------SSS-------------------E-----SS--------------------------SS---------------------------S--------------------E------S--------------------------SS--------------------------SSS-----------------------------------------------------SS--------------------E-----SSS-------------------------SS--------------------------SS--------------------------SS--------------------------SS--------------------------SSS-------------------E------S--------------------E-----SSS-------------------------SSS--------------------------S---------------S----E-----SSS-------------------------SS--------------------E------S---------------------------S--------------------------SSSS-------------------------SS----------------------------------------------------------------------------------S---------------S----------SS--------------------E------S---------------------------S---------
-------------------------E--X-------------------------------SSS--------------------------------E---E-----o-----------------E---------E----------------<>---------E----------------<>------------o--------------E---------E--o-------SSS----E------------ooo----------E<>---------------------------E---------E--o-------------<>---------------------------E---------E--o------------------------------------------E--<>-----E--o-------------<>------------o------------E--------------o-------------<>-------------------------E-----------E--o--Q------S----E---------o--o------------E<>---------E--o--Q------------------------oooo----------<>---E-----E----------------<>---------E---------------E-E---------E--o-------------<>---------o---------------E-----------E-----Q-----------E--------------------------<>-------------------------E-----------E--o------------------E-----------------------E------------o--Q-----------E---------E--o--------------E--------------------------<>--------------------------<>------------o--------------E-------------------------E----------------------------<>--------------------------<>---------E--o-------------<>---------------------------E---------E----------o------E---------o-----------------E---------------------------E-------------------------E-----------E---------------------------E---------------------------E----------------<>---------E--o------------------------E--o---
---------------E--E-----<>-------------------------E------------------------------------------<>--<>----------------------<>---E----<>----------------[]---E----<>----------------[]--------------------------<>---E----<>----------------<>---E--------------------<>[]---E-----E----------------<>---E-----E---------E------[]---E----------------------<>--------<>----------------<>---E----------------------<>--[]----<>----------------[]---E--------------------<>-E---E----------------------[]---E-----E--------------<>-----E----<>----------------<>---E--------------------<>[]---E----<>---------------------E----------------------[]--<>----<>----------------[]---E----<>--------------<><>---E-----E----------------[]------------------------<>----------<>----------------<>---E----------------------[]---E--------------------<>-----E----<>--------------------<>-----E----------------<>---E-----E---------------E<>---E----<>----------------<>--------------------------[]---E----------------------[]--------------------------<>------------------------<>-----E----------------------[]---E----------------------[]---E----<>----------------[]---E----------------------<>---E----<>----------------<>--------------------------<>---E----------------------<>---E--------------------<>-----E----<>---------------------E-----E---------------E-----E----<>----------------[]---E-----E---------------------E----<>------
--------------<>-<>-----[]------------------------<>----------E-----------------------<>------[]--[]----------------------[]--<>----[]----------------[]--<>----[]----------------[]--------------------------[]--<>----[]----------------[]--<>--------------------[][]--<>----<>----------------[]--<>----<>--------<>------[]--<>----------------------[]--<>----[]----------------[]--<>----------------------[]--[]----[]----------------[]--<>----<>--------------[]<>--<>----<>----------------[]--<>----<>--------------[]----<>----[]----------------[]--<>--------------------[][]--<>----[]--------------------<>----<>----------------[]--[]----[]----------------[]--<>----[]--------------[][]--<>----<>----------------[]--X---------------------[]----------[]----------------[]--<>----------------------[]--<>--------------------[]----<>----[]--------------------[]----<>----------------[]--<>----<>--------------<>[]--<>----[]----------------[]--------------------------[]--<>----<>----------------[]--------------------------[]------------------------[]----<>----<>--------<>------[]--<>----------------------[]--<>----[]----------------[]--<>----<>----------------[]--<>----[]----------------[]--------------------------[]--<>----------------------[]--<>----<>--------------[]----<>----[]--------------<>----<>----<>--------------<>----<>----[]----------------[]--<>----<>--------------------<>----[]------
---------E--E-[]-[]-----[]-----E------X-----------[]-E------------------------EE-E----[]------[]--[]---------------E--E---[]--[]----[]--------EE------[]--[]----[]---E----EE------[]-------------E-----E------[]--[]----[]---E-----E------[]--[]---------E----EE----[][]--[]----[]-E-EE---EE------[]--[]----[]--------[]------[]--[]-------E-E--E--E------[]--[]----[]-E-E-----E------[]--[]-------E------EE------[]--[]----[]------E--E------[]--[]----[]---E-----E----[][]--[]----[]---E----EE------[]--[]----[]-E-E----EE-E--[]----[]----[]-E-EE----E------[]--[]--------------EE----[][]--[]----[]-E-EE----E----------[]----[]---EE----EE-E---[]--[]----[]-E-E----EE------[]--[]----[]-E-E----EE----[][]--[]----[]-E-E-----EE-----[]--X----------E----EE-E--[]----------[]---EE---EE------[]--[]------EE-E-----E------[]--[]---------E----EE----[]-X--[]----[]---E----EE-------E--[]----[]-E-E-----E------[]--[]----[]---EE---EE----[][]--[]----[]------E--EE-----[]-----------E-E--E-EE------[]--[]----[]--------EE------[]-----------E-E--E-EE------[]-------------EE---EE----[]----[]----[]---E----[]------[]--[]-------E-E----EE------[]--[]----[]-E-EE----E------[]--[]----[]-E-E--E-EE------[]--[]----[]-E-E-----EE-----[]-------------E--E--EE-E---[]--[]------EE-E-----EE-E---[]--[]----[]---E----EE----[]----[]----[]-E-EE---EE----[]----[]----[]---E----EE----[]----[]----[]---------E------[]--[]----[]---E-----E----------[]----[]-E-EE-
XXXXXXXXXXXXXXXXXXXXXXXXXXXXXXXXXXXXXXXX-XXXXXXXXXXXXXXXXXXXXXXXXXXXXXXXXXXXXXXXXXXXXXXXXXXXXXXXXXXXXXXXXXXXXXXXXXXXXXXXXXXXXXXXXXXXXXXXXXXXXXXXXXXXXXXXXXXXXXXXXXXXXXXXXXXXXXXXXXXXXXXXXXXXXXXXXXXXXXXXXXXXXXXXXXXXXXXXXXXXXXXXXXXXXXXXXXXXXXXXXXXXXXXXXXXXXXXXXXXXXXXXXXXXXXXXXXXXXXXXXXXXXXXXXXXXXXXXXXXXXXXXXXXXXXXXXXXXXXXXXXXXXXXXXXXXXXXXXXXXXXXXXXXXXXXXXXXXXXXXXXXXXXXXXXXXXXXXXXXXXXXXXXXXXXXXXXXXXXXXXXXXXXXXXXXXXXXXXXXXXXXXXXXXXXXXXXXXXXXXXXXXXXXXXXXXXXXXXXXXXXXXXXXXXXXXXXXXXXXXXXXXXXXXXXXXXXXXXXXXXXXXXXXXXXXXXXXXXXXXXXXXXXXXXXXXXXXXXXXXXXXXXXXXXXXXXXXXXXXXXXXXXXXXXXXXXXXXXXXXXXXXXXXXXXXXXXXXXXXXXXXXXXXXXXXXXXXXXXXXXXXXXXXXXXXXXXXXXXXXXXXXXXXXXXXXXXXXXXXXXXXXXXXXXXXXXXXXXXXXXXXXXXXXXXXXXXXXXXXXXXXXXXXXXXXXXXXXXXXXXXXXXXXXXXXXXXXXXXXXXXXXXXXXXXXXXXXXXXXXXXXXXXXXXXXXXXXXXXXXXXXXXXXXXXXXXXXXXXXXXXXXXXXXXXXXXXXXXXXXXXXXXXXXXXXXXXXXXXXXXXXXXXXXXXXXXXXXXXXXXXXXXXXXXXXXXXXXXXXXXXXXXXXXXXXXXXXXXXXXXXXXXXXXXXXXXXXXXXXXXXXXXXXXXXXXXXXXXXXXXXXXXXXXXXXXXXXXXXXXXXXXXXXXXXXXXXXXXXXXXXXXXXXXXXXXXXXXXXXXXXXXXXXXXXXXXXXXXXXXXXXXXXXXXXXXXXXXXXXXXXXXXXXXXXXXXXXXXXXXXXXXXXXXXXXXXXXXXXXXXXXXXXXXXXXXXXXXXXXXXXXXXXXXXXXXXXXXXXXXXXXXXXXXXXXXXXXXXXXXXXXXXXXXXXXXXXXXXXXXXXXXXXXXXXXXXXXXXXXXXXXXXXXXXXXXXXXXXXXXXXXXXXXXXXXXXXXXXXXXXXXXXXXXXXXX-XXXXXXXXXXXXXXXXXXXXXXXXXXXXXXXXXXXXXXXXXXXXXXXXXXXXXXXXXXXXXXXXXXXXXXXXXXXXXXXXXXXXXXXXXXXXXXXXXXXXXXXXXXXXXXXXXXXXXXXXXXXXXXXXXXXXXXXXXXXXXXXXXXXXXXXXXXXXXXXXXXXXXXX
