--------------------------------------------------------------------------------------------------------------------------------------------------------------------------------------------------------------------------------------------------------------------------------------------------------------------------------------------------------------------------------------------------------------------------------------------------------------------------------------------------------------------------------------------------------------------------------------------------------------------------------------------------------------------------------------------------------------------------------------------------------------------------------------------------------------------------------------------------------------------------------------------------------------------------------------------------------------------------------------------------------------------------------------------------------------------------------------------------------------------------------------------------------------------------------------------------------------------------------------------------------------------------------------------------------------------------------------------------------------------------------------------------------------------------------------------------------
--------------------------------------------------------------------------------------------------------------------------------------------------------------------------------------------------------------------------------------------------------------------------------------------------------------------------------------------------------------------------------------------------------------------------------------------------------------------------------------------------------------------------------------------------------------------------------------------------------------------------------------------------------------------------------------------------------------------------------------------------------------------------------------------------------------------------------------------------------------------------------------------------------------------------------------------------------------------------------------------------------------------------------------------------------------------------------------------------------------------------------------------------------------------------------------------------------------------------------------------------------------------------------------------------------------------------------------------------------------------------------------------------------------------------------------------------------
SSSSSSSSSSSSSSSSSSSSSSSSSSSS----------------------------SSSSSSSSSSSSSSSSSSSSSSSSSSSSSSSSSSSSSSSSSSSSSSSSSSSSSSSSSSSSSSSSSSSSSSSSSSSSSSSSSSSSSSSSSSSSSSSSSSSSSSSSSSSSSSSSSSSSSSSSSSSSSSSS-------SS-SSSSSSSSSSSSSSSSSSSSSSSSSSSSSSSSSSSSSSSSSSSSSSSSSSSSSSSSSSSSSSSSSSSSSSSSSSSSSSSSSSSSSSSSSSSSSSSSSSSSSSSSSSSSSSSSSSSSSSSSSSSSSSSSSSSSSSSSSSSSSSSSSSSSSSSSSSSSSSSSSSSSSSSSSSSSSSSSSSSSSSSSSSSSSSSSSSSSSSSSSSSSSSSSSSSSSSSSSSSSSSSSSSSSSSSSSSSSSSSSSSSSSSSSSSSSSSSSSSSSSSSSSSSSSSS--SSSSSSSSSSSSSSSSSSSSSSSSSSSSSSSSSSSSSSSSSSSSSSSSSSSSSSSSSSSSSSSSSSSSSSSSSS-SSSSSS---S-SSSSSSSSSSSSSSSSSSSSSSSSSSSSSSSSSSSSSSSSSSSSSSSSSSSSSSSSSSSSSSSSSSSSSSSSSSSSSSSSSSSSSSSSSSSSSSSSSSSSSSSSSSSSSSSSSSSSSSSSSSSSSSSSSSSSSSSSSSSSSSSSSSSSSSSSSSSSSSSSSSSSSSSSSSSSSSSSSSSSSSSSSSSSSSSSSSSSSSSSSSSSSSSSSSSSSSSSSSSSSSSSSSSSSSSSSSSSSSSSSSSSSSS-----SSSS-SSSSSSSSSS---SSSSS-----SSSS-SSSSSSSSSSS-SSSSSS---SSSSSSSSSSSSSSSSSSSSSSSSSSSSSSSSSSSSSSSSSSSSSSSSSSSSSSSSSSSSSSSSSSSSSSSSSSSSSSSSSSSSSSSSSSSSSSSSSSSSSSSSSSSSSSSSSSSSSSSSSSSSSSSSSS-SSSSSS-----SSSSSSSSSSSSSSSSSSSSSSSSSSSSSSSSSSSSSSSSSSSSSSSSSSSSSSSSSSSSSSSSSSSSSSSSSSSSSSSSSSSSSSSSSSSSSSSSSSSSSSSSSSSSSSSSSSSSSSSSSSSSSSSSSSSSSSSSSSSSSSSSSSSSSSSSSSSSSSSSSSSSSSSSSSSSSSSSSSSSSSSSSSSSSSSSSSSSSSSSSSSSSSSSSSSSSSSSSSSSSSSSSSSSSSSSSSSSSSSSSSSSSSSSSSSSSSSSSSSSSSSSSSSSSSSSSSSSSSSSSSSSSSSSSSSSSSSSSSSSSSSSSSSSSSSSSSSSSSSSSSSSSSSSSSSSSSSSSSSSSSSSSSSSSSSSSSSSSSSSSSSSSSSSSSSSSSSSSSSSSSSSSSSSSSSSSSSSSSS
--------------------------------------------------------------------------------------------------------------------------------------------------------------------------------------------------------------------------------------------------------------------------------------------------------------------------------------------------------------------------------------------------------------------------------------------------------------------------------------------------------------------------------------------------------------------------------------------------------------------------------------------------------------------------------------------------------------------------------------------------------------------------------------------------------------------------------------------------------------------------------------------------------------------------------------------------------------------------------------------------------------------------------------------------------------------------------------------------------------------------------------------------------------------------------------------------------------------------------------------------------------------------------------------------------------------------------------------------------------------------------------------------------------------------------------------------------
------------------------------------------------------------------------------------------------------------------------------------------------------------------------------------------------------------------------------------------------------------------------------------------------------------------------------------------------------------------------------------------------------------------------------------------------------------------------------------------------------------------------------------------------------------------------------------------------------------------------------------------------------------------------------------------------------------------------------------------------------------------------------------------------------------------------------------------------------------------------------------------------------------------------------------------------------------------------------------------------------------------------------------------------------------------------------------------------------------------------------------------------------------------------------------------------------------------------------------------------------------------------------------------------------------------------------------------------------------------------------------------------S-------------------------------------------------------
----S-----------------------------------------------------------------------------------------------------------------------------------------------------------------------------------------------------------------------------------------------------------S------------o----------------------------------------------------------------------------------------------------------------------------------------------------------------------------------------------------------------------------------------------------------------------------------------------------------------------------------S-----------oooo--------------------------------------------------------------------S-------------------------------------------------------S-------------------------------------------------------------------------------------------------------------------------------------------------------------------------------------------------------------------------------------------------------------------------------------------------------------------------------------------------------------------------------------------------------------------------------------------------------------------------------------------------------------------------------------------------------------------------------S-------------------------------------------------------S-----------oo--------------S-----------------------
-----------------------------------------------------------------------------------------------------------------------------------------------------------------------------------------------------------------------------------------------------------------------------------------------------------------------------------------------------------------------------------------------------------------------------------------------------------------------------------------------------------------------------------------------------------------E-------------------------------------------------X-----------------------------------------------------------------------------------X----------------------------------------------------------------------------------------------------------------------------------------------------------------------------------------------------------------------------------------------------------------------------------------------------------------------------------------------XX------------------------------------------------------------------------------------------------------------------------------------------------------------------------------------------------------------------------------XX-------------------------------------------------------X------------------------------------------------------XX------------------------------------------------
----S-----------------------------------------------------------------------------------------------------------------------------------------------------------------------------------------------------------------------------------------------------------------------------------------------------------------------------------------------------------------------------------------------------------------------------------------------------------------------------------------------------------------------------------------------------------------------------------------------------------------------SSS---------------------------------------------------------------------S-------------------------------------------------------S----------------------------------------------------------------------------------------------------------------------------------------------------------------------------------------------------------------------------------------------------------------------------------------------------------------------------------------------------------------------------------------------------------------------------------------------------------------------------------------------------------------------------------------------------------------------------------------------------------------------------------------------------S--------------S-----------------------
-----E--------------------------------------------------------------------S--------------------E-----SSS-------------------E------S--------------------E------S--------------------E----------------------S----E------S--------------------E-----SSS-------------------------SSS-------------------------SS--------------------------SS--------------------E------S--------------------------SS--------------------------SS--------------------E---------------------------E------S--------------------E-----SS--------------------------SSS-------------------E------S--------------------E------S---------------S---------SSSSS------------------------SSS-------------------E------S-------------SSS----------SSS-------------------------SS---------------S----------SSS--------------S----E---E--S--------------------------SSS--------------------------S--------------------E------S--------------------------SS---------------------------S--------------------------SSS-------------------E---------------------------E------S---------------S----------SS--------------------E-----SS--------------------E------S------------------------------------------------------SSS--------------------------S--------------------E------S--------------------------SSS-------------------------SSS-------------------------SSS--------------S----E-----SSS-------------------E------S--------------SS----------SSS------------SoS----------SSS--------
XX--SSS----------------------------------------------------------------------E----------------<>------------o-------------<>---------E----------------<>--------------------------<>-------------------------E<>---E-----E----------------<>---------o---------------------------o--o--------------E------------o---------------------------o--Q----------<>--<>-----E--o------------------------E--o--------------E------------o------------E<>--------------------------<>---------E----------------<>------------o--------------E--------------------------<>---E----------------------<>----------------------S--------------o--o-------------<>-------------------------E<>---------E----------S-S----E---------o--o-------------<>---------E------------S----E------------ooo----------E<>--<>-----E-------------------------------------------E---------------------------E<>---E-----E---------------E-----------E--o--------------E---------E----------------<>---------o--o-------------<>--------------------------<>---------E-----------------E---E-----o--o-------------<>------------o-------------<>---------E-----------------E------------o--Q-----------E-------------------------E-----------E----------------<>---------E--o------------------------o------X---------<>---E-----o--o------------------------o------------S---<>------------o-------------<>---------E------------S----E------------oo--X---S-S-----------------o--Q
----------------------------------------------------------------------------<>----------------[]---E----------------------[]---E----<>----------------[]--<>----------------------[]-------------------E----<>[]--<>----<>----------------[]------------------------------------------------------<>---E-----E---------------------E----------------------[]--[]----<>---------------------E-----E----------------<>---E-----E--------------<>[]---E-----E----------------[]---E----<>----------------[]---E-----E----------------<>--------------------------[]--<>-----E----------------[]---E--------------------------------------------------[]---E--------------------<>[]---E----<>----------------<>---E----------------------[]---E----<>---------------E<>---E--------------------<>[]--[]----<>---------------------E--------------------<>-----E--------------------<>[]--<>----<>--------------<>-----E----<>-----------------E---E----<>----------------[]---E----------------------[]---E---------------E------[]---E----<>---------------E<>--<>----------------------[]---E----------------------[]---E----<>----------------<>---E----------------------<>---E-----E--------------<>-----E----<>----------------[]---E----<>---------------E----------------------------[]--<>---------------E-------E---E----------------------[]---E----------------------[]---E----<>----------------<>---E---------------------------E------------
------E-------<>--------------------------------------------------<>--<>----[]----------------[]--<>----------------------[]--<>----[]----------------[]--[]----<>----------------[]------------------<>----[][]--[]----[]----------------[]--------------------------<>--------------------------[]--<>----<>----------------<>--<>----<>----------------[]--[]----[]--------------<>----<>----<>----------------[]--<>----<>--------------[][]--<>----<>----------------[]--<>----[]----------------[]--<>----<>----------------[]------------------------<>[]--[]----<>----------------[]--<>--------------------------------------------------[]--<>--------------------[][]--<>----[]----------------[]--<>----------------------[]--<>----[]--------------<>[]--<>--------------<>----[][]--[]----[]----------------<>--<>--------------------[]----<>----<>--------------[][]--[]----[]--------------[]----<>----[]--------------------<>----[]----------------[]--<>----------------------[]--<>--------------<>------[]--<>----[]--------------<>[]--[]----------------------[]--<>----------------------[]--<>----[]----------------[]--<>----------------------[]--<>----<>--------------[]----<>----[]----------------[]--<>----[]--------------<><>--------------------------[]--[]--------------<>------<>--<>----------------------[]--<>----------------------[]--<>----[]----------------[]--<>--------------------------<>------------
--------------[]---------------E------X-----------EE-E-----EE-E---[]--[]----[]---E--E--E------[]--[]-------E-EE---EE------[]--[]----[]-E-E--E-EE------[]--[]----[]------E-EE------[]-----------E-E----[]----[][]--[]----[]------E--E------[]-------------E--E--E------[]-------------E----EE------[]--[]----[]---EE----E------[]--[]----[]---EE---EE------[]--[]----[]--------EE----[]----[]----[]-E-E-----E------[]--[]----[]---E----EE----[][]--[]----[]-E-E--E--EE-E---[]--[]----[]-E-E----EE------[]--[]----[]---E--E-EE------[]-----------E-E----EE----[][]--[]----[]-E-EE----EE-E---[]--[]-------E-EE----E---------------------E-----E------[]--[]---------------E----[][]--[]----[]---E----EE------[]--[]---------E--E-EE------[]--[]----[]---E----EE-E--[][]--[]---------E----[]----[][]--[]----[]---------E------[]--[]---------E----EE----[]----[]----[]--------EE----[][]--[]----[]---EE----E----[]----[]----[]---E-----E--E----E--[]----[]-E-E----EE------[]--[]---------E----EE------[]--[]------EE-EE---[]------[]--[]----[]--------EE----[][]--[]------------E--EE-----[]--[]-------E-EE----E------[]--[]----[]---------EE-----[]--[]-------E-EE----EE-E---[]--[]----[]-E-EE---EE----[]----[]----[]-E-E-----EE-E---[]--[]----[]---E--E-EE----[][]-------------E----EE------[]--[]---------E----[]------[]--[]---------------E------[]--[]-------E-E--E-EE------[]--[]----[]-E-EE----E------[]--[]---------------E----------[]-------E-EE-
XXXXXXXXXXXXXXXXXXXXXXXXXXXXXXXXXXXXXXXX-XXXXXXXXXXXXXXXXXXXXXXXXXXXXXXXXXXXXXXXXXXXXXXXXXXXXXXXXXXXXXXXXXXXXXXXXXXXXXXXXXXXXXXXXXXXXXXXXXXXXXXXXXXXXXXXXXXXXXXXXXXXXXXXXXXXXXXXXXXXXXXXXXXXXXXXXXXXXXXXXXXXXXXXXXXXXXXXXXXXXXXXXXXXXXXXXXXXXXXXXXXXXXXXXXXXXXXXXXXXXXXXXXXXXXXXXXXXXXXXXXXXXXXXXXXXXXXXXXXXXXXXXXXXXXXXXXXXXXXXXXXXXXXXXXXXXXXXXXXXXXXXXXXXXXXXXXXXXXXXXXXXXXXXXXXXXXXXXXXXXXXXXXXXXXXXXXXXXXXXXXXXXXXXXXXXXXXXXXXXXXXXXXXXXXXXXXXXXXXXXXXXXXXXXXXXXXXXXXXXXXXXXXXXXXXXXXXXXXXXXXXXXXXXXXXXXXXXXXXXXXXXXXXXXXXXXXXXXXXXXXXXXXXXXXXXXXXXXXXXXXXXXXXXXXXXXXXXXXXXXXXXXXXXXXXXXXXXXXXXXXXXXXXXXXXXXXXXXXXXXXXXXXXXXXXXXXXXXXXXXXXXXXXXXXXXXXXXXXXXXXXXXXXXXXXXXXXXXXXXXXXXXXXXXXXXXXXXXXXXXXXXXXXXXXXXXXXXXXXXXXXXXXXXXXXXXXXXXXXXXXXXXXXXXXXXXXXXXXXXXXXXXXXXXXXXXXXXXXXXXXXXXXXXXXXXXXXXXXXXXXXXXXXXXXXXXXXXXXXXXXXXXXXXXXXXXXXXXXXXXXXXXXXXXXXXXXXXXXXXXXXXXXXXXXXXXXXXXXXXXXXXXXXXXXXXXXXXXXXXXXXXXXXXXXXXXXXXXXXXXXXXXXXXXXXXXXXXXXXXXXXXXXXXXXXXXXXXXXXXXXXXXXXXXXXXXXXXXXXXXXXXXXXXXXXXXXXXXXXXXXXXXXXXXXXXXXXXXXXXXXXXXXXXXXXXXXXXXXXXXXXXXXXXXXXXXXXXXXXXXXXXXXXXXXXXXXXXXXXXXXXXXXXXXXXXXXXXXXXXXXXXXXXXXXXXXXXXXXXXXXXXXXXXXXXXXXXXXXXXXXXXXXXXXXXXXXXXXXXXXXXXXXXXXXXXXXXXXXXXXXXXXXXXXXXXXXXXXXXXXXXXXXXXXXXXXXXXXXXXXXXXXXXXXXXXXXXXXXXXXXXXXXXXXXXXXXXXXXXXXXXXXXXXXXXXXXXXXXXXXXXXXXXXXXXXXXXXXXXXXXXXXXXXXXXXXXXXXXXXXXXXXXXXXXXXXXXXXXXXXXXXXXXXXXXXXXXXXXXXXXXXXXXXXXXXXXXXXXXXXXXXXXXXXXXXXXXXXXXXXXXXXXXXXXXXXXXXXXXX
