--------------------------------------------------------------------------------------------------------------------------------------------------------------------------------------------------------------------------------------------------------------------------------------------------------------------------------------------------------------------------------------------------------------------------------------------------------------------------------------------------------------------------------------------------------------------------------------------------------------------------------------------------------------------------------------------------------------------------------------------------------------------------------------------------------------------------------------------------------------------------------------------------------------------------------------------------------------------------------------------------------------------------------------------------------------------------------------------------------------------------------------------------------------------------------------------------------------------------------------------------------------------------------------------------------------------------------------------------------------------------------------------------------------------------------------------------------
--------------------------------------------------------------------------------------------------------------------------------------------------------------------------------------------------------------------------------------------------------------------------------------------------------------------------------------------------------------------------------------------------------------------------------------------------------------------------------------------------------------------------------------------------------------------------------------------------------------------------------------------------------------------------------------------------------------------------------------------------------------------------------------------------------------------------------------------------------------------------------------------------------------------------------------------------------------------------------------------------------------------------------------------------------------------------------------------------------------------------------------------------------------------------------------------------------------------------------------------------------------------------------------------------------------------------------------------------------------------------------------------------------------------------------------------------------
-------------------------------------------------SSS--SSSSSSSSSSSSSSSSSSSSSSSSSSSSSSSSSSSSSSSSSSSSSSSSSSSSSSSSSSSSSSSSSSSSSSSSSSSSSSSSSSSSSS----------------------------SSSSSSSSSSSSSSSSSSSSSSSSSSSSSSSSSSSSSSSSSSSSSSSSSSSSSSSSSSSSSSSSSSSSSSSSSSSSSSSSSSSSSSSSSSSSSSSSSSSSSSSSSSSSSSSS--------------------------------------------------------SSSSSSSSSSSSSSSSSSSSSSSSSSSSSSSSSSSSSSSSSSSSSSSSSSSSSSSSSSSSSSSSSSSSSSSSSSSSSSSSSSSSSSSSSSSSSSSSSSSSSSSSSSSSSSSSSSSSSSSSSSSSSSSSSSSSSSSSSSSSSSSSSSSSSSSSSSSSSSSSSSSSSSSSSSSSSSSSS-SSSSSS---SSSSSSSSSSSSSSSSSSSSSSSSSSSSSSSSSSSSSSSSSSSSSSSSSSSSSSSSSSSSSSSSSSSSSSSSSSSSSSSSSSSSSSSSSSSSSSSSSSSSSSSSSSSSSSSSSSSSSSSSSSSSSSSSSSSSSSSSSSSSSSSSSSSSSSSSSSSSSSSSSSSSSSSSSSSSSSSSSSSSSSSSSSSSSSSSSSSSSSSSSSSSSSSSSSSS----------------S--SSSSSSSSSSSSSSSSSSSSSSSSSSSSSSSSSSSSSSSSSSSSSSSSSSSSSSSSSSSSSSSSSSSSSSSSSSSSSSSSSSSSSSSSSSSSSSSSSSSSSSSSSSSSSSSSSSSSSSSSSSSSSSSSSSSSSSSSSSSSSSSSSSSSSSSSSSSSSSSSSSSSSSSSSSSSSSSSSSSSSSSSSSSSSSSSSSSSSSSSSSSSSSS--S-S-------SSS--SSSSSSSSSSSSSSSSSSSSSSSSSSSSSSSSSSSSSSSSSSSSSSSSSSSSSSSSSSSSSSSSSSSSSSSSSSSSSSSSSSSSSSSSSSSSSSSSSSSSSSSSSSSSSSSSSSSSSSSSSSSSSSSSSSSSSSSSSSSSSSS--------------------------SSSSSSSSSSSSSSSSSSSSSSSSSSSSSSSSSSSSSSSSSSSSSSSSSSSSSSSSSSSSSSSSSSSSSSSSSSSSSSSSSSSSSSSSSSSSSSSSSSSSSSSSSSSSSSSSSSSSSSSSSSSSSSSSSSSSSSSSSSSSSSSSSSSSSSSSSSSSSS--SSSSSSSSSS-----SS---SSSSS-------S--SSSSSSSSSSSSSSSSSSSSSSSSSSSSSSSSSSSSSSSSSSSSSSSSSSSSSSSSSS
--------------------------------------------------------SS------------------------------------------------------------------------------------------------------------------------------------------------------------------------------------------------------------------------------------------------------------------------------------------------------------------------------------------------------------------------------------------------------------------------------------------------------------------------------------------------------------------------------------------------------------------------------------------------------------------------------------------------------------------------------------------------------------------------------------------------------------------------------------------------------------------------------------------------------------------------------------------------------------------------------------------------------------------------------------------------------------------------------------------------------SSSSS-----------------------------------------------------------------------------------------------------------------------------------------------------------------------------------------------------------------------------------------------------------------------------------------------------------------------------------
--------------------------------------------------------SS------------------------------------------------------------------------------------------------------------------------------------------------------------------------------------------------------------------------------------------------------------------------------------------------------------------------------------------------------------------------------------------------------------------------------------------------------------------------------------------------------------------------------------------------------------------------------------------------------------------------------------------------------------------------------------------------------------------------------------------------------------------------------------------------------------------------------------------------------------------------------------------------------------------------------------------------------------------------------------------------------------------------------------------------------SSSSS-----------------------------------------------------------------------------------------------------------------------------------------------------------------------------------------------------------------------------------------------------------------------------------------------------------------------------------
--------------------------------------------------------S---S--------oooooo---------------------------------------------------------------------------------------------------------------------------------------------------------------------------------------------------------------------------------------------------------------------------------------------------------------------------------------------------------------------------------------------------------------------S-------------------------------------------------------S------------o------------------------------------------S-------------------------------------------------------------------------------------------------------------------------------------------------------------------------------------------------------------------------------------------------------------------------------------------------------------------S-----------------------------------------------------------------------------------------------------------------------------------------------------------------------S----SSS--------------------S-----------------------------------------------------------------------------------S---------------------------S-----------oo--------------S-------------------------------------------------------------------------------------------------------------------------------------------------------------------
--------------------------------------------------------S------------------------------------------------------------------------------------------------------------------------------------------------XXX-------------------------------------------------------------------------------------------------------------------------------------------------------------------------------------------------------------------------------------------------------------------------------------------------------------------------------------------------------------------------------------------------------X---------------------------X-----------------------------------------------------------------------------------X-----------------------------------------------------------------------------------------------------------------------------------------------------------------------------------------------------------------------------------------------------------------------------------------------------------------------------------------------------------------------------------------------------------------------------------------E---------------------------------------------------------------------------------------------------------X----------------------------------------------------------------------------------------------------------------------------------------------------------------
--------------------------------------------------------S---S--------SSSSSSS------------------------------------------------------------------------------------------------------------------------------------------------------------------------------------------------------------------------------------------------------------------------------------------------------------------------------------------------------------------------------------------------------------------------------------------------------------------------------------------------------------------------------------S---------------------------------------------------------------------------------------------------------------------------------------------------------------------------------------------------------------------------------------------------------------------------------------------------------------------------------------------------------------------------------------------------------------------------------------------------------------------------------------------------------------------------------------------------------------------------------------------------------------------------------------S------------S----------------------------------------------------------------------------------------------------------------------------------------------------------------------------------
--------------------------------------------------------S---So?------SSSSSSS-------------------E------S--------------------E------S--------------------E---------------------------------SS--------------------------SSS-------------------E------S--------------------------SS-----------------------------------------------------------------------------------S---------------------------S--------------------------SSS-------------------------SS--------------------------SSS--------------S----E-----SS--------------------E---------------------------------SS---------------------------S---------------S----------SSS-------------------------SSS--------------------------S---------------S----E------S--------------------------SSS-------------------E---------------------------------SS--------------------E------S--------------------E------S---------------------------S--------------------E------S---------------S----------SS--------------------------SS--------------------------S---------------------------S---------------------E-----SSS-------------------E----------------------------------S--------------------------SSS-------------------E-------S--------------------------S---------------S----E-----SSS------------SoS----------SSS--------------S----E-----SSS-------------------------SSS-------------------E------S------------------------------------------------------SS---------------------------S---------
----------------------------X---S----------------E----------SSS-------------------------------<>---------E----------------<>--------------------------<>-----E----------------------------------o---X--------------E-----o--ooo-----------<>---------E-----------------E---------E---------------E----------------------------<>-------------------------E-----------E--o--Q----------<>---E-----E---------------E-E------------o------------------------E--o--Q----------<>------------o---------S---<>------------o-------------<>---------E-----------------E------------o-------------<>------------o-------S-S---<>---------o--o-------------<>---------o----------------<>---------E---------------E<>---E-----E----------------<>--------------------------<>---------E---------------E-----E-----E--o-------------<>---E-----E----------------<>---------E-----------------E---------E--o-------------<>---E-----E---------------E-----------E--o--------------E------------o---------------------------------------------------------------------<>--------------------------<>-------------------------E--SS-------E---------------------------o--o-------------<>--------------------------<>---------E------------S---<>------------o-------S-S--------------o--oo--------S---<>--------------------------<>--------------------------<>---------E---------------------------E---------------------------E----------S----------------------Q
-------------------------------------------E----<>--------------------------------------------[]---E----<>----------------[]---E----------------------[]----<>---E-E-------------------E--------------------------<>----------------------[]---E----<>----------------<>---E----<>--------------<>-----------E----------------[]---E--------------------<>-----E----<>----------------[]--<>----<>--------------<><>---E---------------------------E-----E----------------[]---E----------------------[]---E-----E----------------[]---E----<>----------------<>--------------------------[]---E-----E----------------[]---E----------------------[]---E----------------------[]---E----<>---------E----<>[]--<>----<>----------------[]--------------------------[]---E----<>--------------<>----<>----<>----------------[]--<>----<>----------------[]---E----<>---------------E<>---E----<>----------------[]--<>----<>--------------<>-----E-----E----------------<>---E-----E---------------------E---------------------E----------------------------[]---E----------------------[]------------------------<>----------<>---------------------E----------------------[]--------------------------[]---E----<>----------------[]---E-----------------------E--------------------------[]---E-----E----------------[]--------------------------[]---E----<>---------------E-----E----<>---------------------E----<>---------------------E-----E------
------------------------------------------<>----[]------------E-------------------------------[]--<>----[]----------------[]--<>----X-----------------[]----[]--<><>------------------<>--------------------------[]----------------------[]--<>----[]----------------[]--<>----[]--------------[]----------<>----------------[]--<>--------------------[]----<>----[]----------------[]--[]----[]--------------[][]--<>--------------------------<>----<>----------------[]--<>----------------------[]--<>----<>----------------[]--<>----[]----------------[]--------------------------[]--<>----<>----------------[]--<>----------------------[]--<>----------------------[]--<>----[]--------<>----[][]--[]----[]----------------[]--------------------------[]--<>----[]--------------[]----[]----[]----------------[]--[]----[]----------------[]--<>----[]--------------<>[]--<>----[]----------------[]--[]----[]--------------[]----<>----<>----------------[]--<>----<>--------------------<>--------------------<><>--------------------------[]--<>----------------------[]----<>------------------[]----------[]--------------------<>----------------------[]--------------------------[]--<>----[]----------------[]--<>----------------------<>--------------------------[]--<>----<>----------------[]--------------------------[]--<>----[]--------------<>----<>----[]----------------<>--<>----[]--------------------<>----<>------
---------E--E-EE------EE----E--E----------[]----[]-E-E------E------------------E-E--E--EE-----[]--[]----[]---------EE-E---[]--[]----X-EE-EE---EE------[]----[]--[][]-E-----E----------[]----X----E-------------E--[]---------E--E--EE-E---[]--[]----[]-E-E--E--EE-E---[]--[]----[]---EE---EE----[]----------[]-E-EE----EE-E---[]--[]-------E-EE---EE----[]----[]----[]-E-EE----E------[]--[]----[]--------EE----[][]--[]---------E----EE----------[]----[]-E-EE-E-EE------[]--[]---------E--E-EE------[]--[]----[]-E-E-----EE-E---[]--[]----[]------E-EE------[]-----------E-E----EE------[]--[]----[]---EE---EE------[]--[]---------E-----E------[]--[]---------EE----E------[]--[]----[]--------[]----[][]--[]----[]---------E------[]-----------E-E----EE--E---[]--[]----[]-E-E----EE----[]----[]----[]---E-----EE-E---[]--[]----[]---------E------[]--[]----[]-E-EE---EE----[][]--[]----[]---E----EE------[]--[]----[]--------EE----[]----[]----[]---------E------[]--[]----[]---EE----E----------[]---------E--E-EE----[][]----------EE-E--E-EE------[]--[]-------E-E-----EE-----[]----[]------------EE-E--[]----------[]--------EE----------[]-------E-E----EE------[]-----------E------EE------[]--[]----[]------E-EE------[]--[]-------E-E--E--E------[]-------------E--E-EE------[]--[]----[]------E--EE-E---[]-----------E-EE----EE-E---[]--[]----[]-E-EE---EE--E-[]----[]----[]-E-EE----EE-E---[]--[]----[]---E-----EE---------[]----[]-E-EE-
XXXXXXXXXXXXXXXXXXXXXXXXXXXXXXXXXXXXXXXXXXXXXXXXXXXXXXXXXXXXXXXXXXXXXXXXXXXXXXXXXXXXXXXXXXXXXXXXXXXXXXXXXXXXXXXXXXXXXXXXXXXXXXXXXXXXXXXXXXXXXXXXXXXXXXXXXXXXXXXXXXXXXXXXXXXXXXXXXXXXXXXXXXXXXXXXXXXXXXXXXXXXXXXXXXXXXXXXXXXXXXXXXXXXXXXXXXXXXXXXXXXXXXXXXXXXXXXXXXXXXXXXXXXXXXXXXXXXXXXXXXXXXXXXXXXXXXXXXXXXXXXXXXXXXXXXXXXXXXXXXXXXXXXXXXXXXXXXXXXXXXXXXXXXXXXXXXXXXXXXXXXXXXXXXXXXXXXXXXXXXXXXXXXXXXXXXXXXXXXXXXXXXXXXXXXXXXXXXXXXXXXXXXXXXXXXXXXXXXXXXXXXXXXXXXXXXXXXXXXXXXXXXXXXXXXXXXXXXXXXXXXXXXXXXXXXXXXXXXXXXXXXXXXXXXXXXXXXXXXXXXXXXXXXXXXXXXXXXXXXXXXXXXXXXXXXXXXXXXXXXXXXXXXXXXXXXXXXXXXXXXXXXXXXXXXXXXXXXXXXXXXXXXXXXXXXXXXXXXXXXXXXXXXXXXXXXXXXXXXXXXXXXXXXXXXXXXXXXXXXXXXXXXXXXXXXXXXXXXXXXXXXXXXXXXXXXXXXXXXXXXXXXXXXXXXXXXXXXXXXXXXXXXXXXXXXXXXXXXXXXXXXXXXXXXXXXXXXXXXXXXXXXXXXXXXXXXXXXXXXXXXXXXXXXXXXXXXXXXXXXXXXXXXXXXXXXXXXXXXXXXXXXXXXXXXXXXXXXXXXXXXXXXXXXXXXXXXXXXXXXXXXXXXXXXXXXXXXXXXXXXXXXXXXXXXXXXXXXXXXXXXXXXXXXXXXXXXXXXXXXXXXXXXXXXXXXXXXXXXXXXXXXXXXXXXXXXXXXXXXXXXXXXXXXXXXXXXXXXXXXXXXXXXXXXXXXXXXXXXXXXXXXXXXXXXXXXXXXXXXXXXXXXXXXXXXXXXXXXXXXXXXXXXXXXXXXXXXXXXXXXXXXXXXXXXXXXXXXXXXXXXXXXXXXXXXXXXXXXXXXXXXXXXXXXXXXXXXXXXXXXXXXXXXXXXXXXXXXXXXXXXXXXXXXXXXXXXXXXXXXXXXXXXXXXXXXXXXXXXXXXXXXXXXXXXXXXXXXXXXXXXXXXXXXXXXXXXXXXXXXXXXXXXXXXXXXXXXXXXXXXXXXXXXXXXXXXXXXXXXXXXXXXXXXXXXXXXXXXXXXXXXXXXXXXXXXXXXXXXXXXXXXXXXXXXXXXXXXXXXXXXXXXXXXXXXXXXXXXXXXXXXXXXXXXXXXXXXXXXXXXXXXXXXXXXXXXXXXXXXXXXXXXXXXXXXXXXXXXXX
