--------------------------------------------------------------------------------------------------------------------------------------------------------------------------------------------------------------------------------------------------------------------------------------------------------------------------------------------------------------------------------------------------------------------------------------------------------------------------------------------------------------------------------------------------------------------------------------------------------------------------------------------------------------------------------------------------------------------------------------------------------------------------------------------------------------------------------------------------------------------------------------------------------------------------------------------------------------------------------------------------------------------------------------------------------------------------------------------------------------------------------------------------------------------------------------------------------------------------------------------------------------------------------------------------------------------------------------------------------------------------------------------------------------------------------------------------------
--------------------------------------------------------------------------------------------------------------------------------------------------------------------------------------------------------------------------------------------------------------------------------------------------------------------------------------------------------------------------------------------------------------------------------------------------------------------------------------------------------------------------------------------------------------------------------------------------------------------------------------------------------------------------------------------------------------------------------------------------------------------------------------------------------------------------------------------------------------------------------------------------------------------------------------------------------------------------------------------------------------------------------------------------------------------------------------------------------------------------------------------------------------------------------------------------------------------------------------------------------------------------------------------------------------------------------------------------------------------------------------------------------------------------------------------------------
SSSSSSSSSSSSSSSSSSSSSSSSS----------------SSSSSSSSSSSSSSSSSSSSSSSSSSSSSSSSSSSSSSSSSSSSSSSSSSSSSSSSSSSSSSSSSSSSSSSSSSSSSSSS--S-----------S--SSS------------SSSSSSSSSSSSSSSSSSSSSSSSSSSSSSSSSSSSSSSSSSSSSSSSSSSSSSSSSSSSSSSSSSSSSSSSSSSSSSSSSSSSSSSSSSSSSSSSSSSS--S-SSS---S-SSS-----SSS--SSSSSSSSSSSSSSSSSSSSSSSSSSSSSS----------------------------SSSSSSSSSSSSSSSSSSSSSSSSSSSSSSSSSSSSSSSSSSSS---SSSSSSSSS---------------------------SSSSSSSSSSSSSSSSSSSSSSSSSSSSSSSSSSSSSSSSSSSSSSSSSSSSSSSSSSSSSSSSSSSSSSSSSS--SSSSSSSSSSSSSSSSSSSSSSSSSSSSSSSSSSSSSSSSSSSSSSSSSSSSSSSSSSSSSSSSSSSSSSSSSSSSSSSSSSSSSSSSSSSSSSSSSSSSSS-SSSS---------S---SSSSSSSSSSSSSSSSSSSSSSSSSSSSSSSSSSSSSSSSSSSSSSSSSSSSSSSSSSSSSSSSSSSSSSSSSSSSSSSSSSSSSSSSSSSSSSSSSSSSSSSSSSSSSSSSSSSSSSSSSSSSSSSSSSSSSSSSSSSSSSSSSSSSSSSSSSSSSSSSSSSSSSSSSSSSSSSSSSSSSSSSSSSSSSSSSSSSSSSSSSSSSSSSSSSSSSSSSSSSSSSSSSSSSSSSSSSSSSSSSSSSSSSSSSSSSSSSSSSSSSSSSSSSSSSSSSSSSSSSSSSSSSSSSSSSSSSSSSSSSSSSSSSSSSSSSSSSSS-SSSSSS-----SSS--SSSSSSSSSSSSSSSSSSSSSSSSSSSSSSSSSSSSSSSSSSSSSSSSSSSSSSSSSSSSSSSSSSSSSSSSSSSSSSSSSSSSSSSSSSSSSSS-SSSSSSS-SSSSSSSSSSSSSSSSSSSSSSSSSSSSSSSSSSSSSSSSSSSSSSSSSSSSSSSSSSSSSSSSSSSSSSSSSSSSSSSSSSSSSSSSSSSSSSSSSSSSSSSSSSSSSSSSSSSSSSSSSSSSSSSSSSSSSSSSSSSSSSSSSSSSSSSSSSSSSSSSSSSSSSSSSSSSSSSSSSSSSSSSSSSSSSSSSSSSSSSSSSSSSSSSSSSSSSS-SSSSSSSSSSSSSSSSSSSSSSSSSSSSSSSSSSSSSSSSSSSSSSSSSSSSSSSSSSSSSSS-SSSSSSSSSSSSSSSSSSSSSSSSSSSSSSSSSSSSSSSSSSSSSSSSSSSSSSSSSSSSSSSSSS
----------------------------------------------------------------------------------------------------------------------------------------------------------------------------------------------------------------------------------------------------------------------------------------------------------------------------------------------------------------------------------------------------------------------------------------------------------------------------------------------------------------------------------------------------------------------------------------------------------------------------------------------------------------------------------------------------------------------------S---------------------------------------------------------------------------------------------------------------------------------------------------------------------------------------------------------------------------------------------------------------------------------------------------------------------------------------------------------------------------------------------------------------------------------------------------------------------------------------------------------------------------------------------------------------------------------------------------------------------------------------------------------------------------------------------------------------------------
----------------------------------------------------------------------------------------------------------------------------------------------------------------------------------------------------------------------------------------------------------------------------------------S-----------------------------------------------------------------------------------------------------------------------------------------------------------------------------------------------------------------------------------------------------------------------------------------------------------------------------------------------------------------------------------------------------------------------------------S--------SS-----------------------------------------------------------------------------------------------------------------------------------------------------------------------------------------------------------------------------------------------------------------------------------------------------------------------------------------------------------------------------------------------------------------------------------------------------------------------------------------------------------------------------------------------------------------------------------------------------------------------------------------------------------------------------------------------------------------
------------------------------------------------------------S-------------------------------------------------------------------------------------------------------------------------------------------------------------------------------------------------------------------------------------------oo-o----------------------------------------------------------------------------------------------------------------------------------------------------------------------------------------------------------------------------------------------------------------------------------------------------------------------------------------------------------------------------------------S-----------oo--------------S-----------oo------------------------------------------S-----------oo--------------S---------------------------------------------------------------------------------------------------------------------------------------------------------------------------------------------------------------------------------------------------------------------------------------------------------------------------------------------------------------------------S-----------oo------------------------------------------------------------------------------------------------------------------------------------------------------------------------------------------------------------------------------------------
---------------------------------------------------------------X---------------------------X-------------------------------------------------------------------------------------------------------------------------------------------------------------------------------------------------XXX------------------------------------------------------------------------------------------------------------------------------------------XX---------------------------------------------------------------------------------------------------------------------------------------------------------------------------------------------------------------------------------------------------------------------------------------X-----------------------------------------------------------------------------------------------------------------------------------------------------------------------------------------------------------------------------------------------------------------------------------------------------------------------------------------------------------------------------------------------------------------------------------------------------------------------------------------------------------------------------------------------------------------------------------------------------------------------------------------------------------------------------------------------------E--------------
------------------------------------------------------------S---------------------------------------------------------------------------------------------------------------------------------------------------------------------------------------------------------------------------------------------------------------------------------------------------------------------------------------------------------------------------------------------------------------------------------------------------------------------------------------------------------------------------------------------------------------------------------------------------------------------------------------S------------S----------------------------------------------------------------------S------------S-------------------------------------------------------------------------------------------------------------------------------------------------------------------------------------------------------------------------------------------------------------------------------------------------------------------------------------------------------------------------------------------------------S------------------------------------------------------------------------------------------------------------------------------------------------------------------------------------------------------------------------------------------
------------SSSSSS---------------E----------------------S---SoS----E-----SSS-------------------------SSS---------------------------------------------------------------------------------SSS--------------------------S--------------------------SSS------------------------------------------S---------SSSSS------------------E---------------------------------SS-----------------------X--S-------------------------------------------------------SSS-------------------------SSS--------------------------S--------------------E------S---------------S----------SS---------------------------S--------------------E-----SSS-----------------------------------------------E-----SSS------------SoS----------SSS-------------oS----E-----SSS-------------------E-----SS-------------SoS----------SSS-------------------------SSS-------------------E-----SSS-------------------E--X---S-------------------------------------------------------S--------------------------SS--------------------E------S--------------------E------S--------------------E-----SS--------------------E---------------------------E------S---------------------------S--------------------E-----SS---------------S----------SS------------------------E--S--------------------E-----SS--------------------------SS---------------------------S---------------S-----------S--------------------E------S--------------------------SS--------------------E------S---------
---ooo------------------<>--XX--SSS---------------------X---SSS---<>---------o-----------------E---------o---------------E-E---------E-----QX---S-----------------------X----------E---------o--o--------------E---------E--o--Q---------------------------------------E-------------------------------------o----------------<>--------------------------<>---------o--o----------------------------------------E-----------------------------E---------o--oo--------------------------------------------------------------------<>-------------------------E-----------E--o--------------E---------E----------------<>---------------------------E--------------------------<>---------o----------S-S-----------------o---------S---<>---------o--o-------------<>---------E--o-------S-S-----------------o-----------------------------------------<>-------------------------E<>-------------------------E-E---------E-----------------E---------E--------------------------------------------<>---E-----E----------------<>---------E----------------<>------------o------------E<>---------E----------------<>---------E----------------<>--------------------------<>------------o------------------------o--o--------------E--<>-----E--o-------------<>---------------------------E------------o------------------E-----E-----Q---------E-E---------E----------------<>---------E-----------------E--<>-----E--o-------------<>---------E------
-----E---------E--------[]----------------------------------------[]---E----------------------<>---E--------------------<><>---E-E--<>-------------------------------E------------<>---E---------------------E<>--------<>--------------------------------------------<>---E---------------------------E----------------------[]-----------E--------------[]---E---------------------E--------------------------<>----------------------------<>---E---------------------E-----E---------------------------E----------------------[]--<>---------------E----<>-----E----<>----------------<>--------<>----------------[]---E-----------------------E--------------------------[]---E--------------------------------------------------[]---E----------------------[]---E----<>---------------------E---------------------------E----------------------[]-------------------E----<>[]---E--------------------<><>---E----<>----------------<>---E----<>---------------E-----E----------------------[]--<>----<>----------------[]---E----<>----------------[]---------E--------------<>[]---E----<>----------------[]---E----<>----------------[]--------------------------[]---E---------------------------E---------------------E<>--[]----<>----------------[]---E-----E---------------E<>---E-----E---------------E----<>----<>--------------<><>---E----<>----------------[]---E----<>----------------<>--[]----<>----------------[]---E----<>------
--------------<>--------[]--------E-------X-----------------------[]--<>----------------------[]--<>--------------------[][]--<><>--[]------------------------------<>------------[]--<>--------------------<>[]--------[]--------------<>----<>----------------------[]--<>----------------------<>--<>----------------------[]----------<>--------------[]--<>--------------------<>--------------------------[]----------------------------[]--<>--------------------<>----<>--------------------------<>----------------------[]--[]--------------<>----[]----<>----[]----------------[]--<>----[]----------------[]--<>----------------------<>--------------------------[]--<>----------------------<>--<>----------------------[]--<>----------------------[]--<>----[]--------------------<>--------------------------<>----------------------[]------------------<>----[][]--<>--------------------[][]--<>----[]----------------[]--<>----[]--------------<><>--<>----<>----------------[]--[]----[]----------------[]--<>----[]----------------[]--------<>--------------[][]--<>----[]----------------[]--<>----[]----------------[]--<>----------------------[]--<>--------------------------<>--------------------<>[]--[]----[]----------------[]--<>----<>--------------<>[]--<>----<>--------------<>----[]----[]--------------[][]--<>----[]----------------[]--<>----[]----------------[]--[]----[]----------------[]--<>----[]------
--------------[]--E-----[]-----E-------E--X-------EE-E----EEE-----[]--[]------EE-E-----E------[]--[]---------EE---EE----[][]--[][]--[]---EE---EE----EE--------------[]-----E------[]--[]---------EE-E-EE----[][]--------[]---E----EE----[]----[]-------E-E--E-EEE-----[]--[]-------E-EE-----------[]--[]------------E--EE-E---[]----------[]-E--E--EE-----[]--[]---------E----EE----[]---------------EE---EE----[]-------------E-EE----E------[]--[]---------E----EE----[]----[]---------E----EE----------[]-------E-EE-E-EE------[]--[]-------E-E----[]----[]----[]----[]------E-EE------[]--[]----[]-E-E-----E------[]--[]-------E-EE-E-EE------[]-----------E-E--E--E------[]--[]-------E-EE-E-EE------[]--[]------------E-EE------[]--[]------------E-EE------[]--[]----[]---E--E--E----------[]-------E-E--E-EE-------E--[]------EE-E--E--E------[]-----------E-E----[]----[][]--[]--------------EE----[][]--[]----[]---E-----EE-----[]--[]----[]---E----EE----[][]--[]----[]---E--E-EE------[]--[]----[]-E-EE-E--E------[]--[]----[]-E-EE-E-EE------[]--------[]-E-E----EE----[][]--[]----[]---E--E--E------[]--[]----[]-E-EE-E--E------[]--[]-------E-E-----EE-----[]--[]---------EE----E----------[]--------------EE----[][]--[]----[]---------E------[]--[]----[]---E----EE----[][]--[]----[]---E----EE----[]----[]----[]-E-EE---EE----[][]--[]----[]---------EE-E---[]--[]----[]-E-EE----E------[]--[]----[]---E----EE------[]--[]----[]------
XXXXXXXXXXXXXXXXXXXXXXXXXXXXXXXXXXXXXXXXXXXXXXXXXXXXXXXXXXXXXXXXXXXXXXXXXXXXXXXXXXXXXXXXXXXXXXXXXXXXXXXXXXXXXXXXXXXXXXXXXXXXXXXXXXXXXXXXXXXXXXXXXXXXXXXXXXXXXXXXXXXXXXXXXXXXXXXXXXXXXXXXXXXXXXXXXXXXXXXXXXXXXXXXXXXXXXXXXXXXXXXXXXXXXXXXXXXXXXXXXXXXXXXXXXXXXXXXXXXXXXXXXXXXXXXXXXXXXXXXXXXXXXXXXXXXXXXXXXXXXXXXXXXXXXXXXXXXXXXXXXXXXXXXXXXXXXXXXXXXXXXXXXXXXXXXXXXXXXXXXXXXXXXXXXXXXXXXXXXXXXXXXXXXXXXXXXXXXXXXXXXXXXXXXXXXXXXXXXXXXXXXXXXXXXXXXXXXXXXXXXXXXXXXXXXXXXXXXXXXXXXXXXXXXXXXXXXXXXXXXXXXXXXXXXXXXXXXXXXXXXXXXXXXXXXXXXXXXXXXXXXXXXXXXXXXXXXXXXXXXXXXXXXXXXXXXXXXXXXXXXXXXXXXXXXXXXXXXXXXXXXXXXXXXXXXXXXXXXXXXXXXXXXXXXXXXXXXXXXXXXXXXXXXXXXXXXXXXXXXXXXXXXXXXXXXXXXXXXXXXXXXXXXXXXXXXXXXXXXXXXXXXXXXXXXXXXXXXXXXXXXXXXXXXXXXXXXXXXXXXXXXXXXXXXXXXXXXXXXXXXXXXXXXXXXXXXXXXXXXXXXXXXXXXXXXXXXXXXXXXXXXXXXXXXXXXXXXXXXXXXXXXXXXXXXXXXXXXXXXXXXXXXXXXXXXXXXXXXXXXXXXXXXXXXXXXXXXXXXXXXXXXXXXXXXXXXXXXXXXXXXXXXXXXXXXXXXXXXXXXXXXXXXXXXXXXXXXXXXXXXXXXXXXXXXXXXXXXXXXXXXXXXXXXXXXXXXXXXXXXXXXXXXXXXXXXXXXXXXXXXXXXXXXXXXXXXXXXXXXXXXXXXXXXXXXXXXXXXXXXXXXXXXXXXXXXXXXXXXXXXXXXXXXXXXXXXXXXXXXXXXXXXXXXXXXXXXXXXXXXXXXXXXXXXXXXXXXXXXXXXXXXXXXXXXXXXXXXXXXXXXXXXXXXXXXXXXXXXXXXXXXXXXXXXXXXXXXXXXXXXXXXXXXXXXXXXXXXXXXXXXXXXXXXXXXXXXXXXXXXXXXXXXXXXXXXXXXXXXXXXXXXXXXXXXXXXXXXXXXXXXXXXXXXXXXXXXXXXXXXXXXXXXXXXXXXXXXXXXXXXXXXXXXXXXXXXXXXXXXXXXXXXXXXXXXXXXXXXXXXXXXXXXXXXXXXXXXXXXXXXXXXXXXXXXXXXXXXXXXXXXXXXXXXXXXXXXXXXXXXXXXXXXXXXXXXXXXXXXX
