--------------------------------------------------------------------------------------------------------------------------------------------------------------------------------------------------------------------------------------------------------------------------------------------------------------------------------------------------------------------------------------------------------------------------------------------------------------------------------------------------------------------------------------------------------------------------------------------------------------------------------------------------------------------------------------------------------------------------------------------------------------------------------------------------------------------------------------------------------------------------------------------------------------------------------------------------------------------------------------------------------------------------------------------------------------------------------------------------------------------------------------------------------------------------------------------------------------------------------------------------------------------------------------------------------------------------------------------------------------------------------------------------------------------------------------------------------
--------------------------------------------------------------------------------------------------------------------------------------------------------------------------------------------------------------------------------------------------------------------------------------------------------------------------------------------------------------------------------------------------------------------------------------------------------------------------------------------------------------------------------------------------------------------------------------------------------------------------------------------------------------------------------------------------------------------------------------------------------------------------------------------------------------------------------------------------------------------------------------------------------------------------------------------------------------------------------------------------------------------------------------------------------------------------------------------------------------------------------------------------------------------------------------------------------------------------------------------------------------------------------------------------------------------------------------------------------------------------------------------------------------------------------------------------------
----------------------------SSSSSSSSSSSSSSSSSSSSSSSSSSSSS--------------------------SSSSSSSS----S-SS-------SSS-SSSSSSSSSSSSSSSSSSSSSSSSSSSSSSSSSSSSSSSSSSSSSSSSSSSSSSSSSSSSSSSSSSSSSSSSSSSSSSSSSSSSSSSSSSSSSSSSSSSSSSSSSSSSSSSSSSSSSSSSSSSSSSSSSSSSSSSSSSSSSSSSSSSSSSSSSSSSSSSSSSSSSSSSSSSSSSSSSSSSSSSSSSSSSSSSSSSSSSSSSS-S-----------------S--SSSSSSSSSSSSSSSSSSSSSSSSSSSSSSSSSSSSSSSSSSSSSSSSSSSSSSSSSSSSSSSSSSSSSSSSSSSSSSSSSSSSSSSSSSSSSSSSSSSSSSSSSSSSSSSSSSSSSSSSSSSSSSSSSSSSSSSSSSSSSSSSSSSSSSSSSSSSSSSSSSSSSSSSSSSSSSSSSSSSSSSSSSSSSSSSSSSSSSSSSSSSSSSSSSSSSSSSSSSSSSSSSSSSSSSSSSSSSSSSSSSSSSSSSSSSSSSSSSSSSSSSSSSSSSSSSSSSSSSSSSSSSSSSSSSSSSSSSSSSSSSSSSSSSSSSSSSSSSSSSSSSSSSSSSSSSSSSSSSSSSSSSSSSSSSSSSSSSSSSSSSSSSSSSSSSSSSSSSSSSSSSSSSSSSSSSSSSSSSSSSSSSSSSSSSSSSSSSSSSSSSSSSSSSSSSSSSSSSSSSSSSSSSSSSSSSSSSSSSSSSSSSSSSSSSSSSSSSSSSSSSSSSSSSSSSSSSSSSSSSSSSSSSSSSSSSSSSSSSSSSSSSSSSSSSSSSSSSSSSSSSSSSSSSSSSSSSSSSSSSSSSSSSSSSSSSSSSSSSSSSSSSSSSSSSSSSSSSSSSSSSSSSSSSSSSSSSSSSSSSSSSSSSSSSSSS-------SSS-SSSSSSSSSSSSSSSSSSSSSSSSSSSSSSSSSSSSSSSSSSSSSSSSSSSSSSSSSSSSSSSSSSSSSSSSSSSSSSSSSSSSSSSSSSSSSSSSSSSSSSSSSSSSSSSSSSSSSSSSSSSSSSSSSSS----SSSSSSSSSSSSSSSSSSSSSSSSSSSSSSSSSSSS---------------------------SSSSSSSSSSSSSSSSSSSSSSSSSSSS----------------------------SSSSSSSSSSSSSSSSSSSSSSSSSSSSSSSSSSSSSSSSSSSS---SSSSSSSSSSSSSSSSSS--S-SSS-----S-S--SSSSSSSSSSSSSSSSSSSSSSSSSSSSSSS-SS-SS----S-SSS---SSSSSSSSSSSSSSSSSSSSSSSSSSSSSSSSSSSSS
--------------------------------------------------------------------------------------------------------------------------------------------------------------------------------------------------------------------------------------------------------------------------------------------------------------------------------------------------------------------------------------------------------------------------------------------------------------------------------------------------------------------------------------------------------------------------------------------------------------------------------------------------------------------------------------------------------------------------------------------------------------------------------------------------------------------------------------------------------------------------------------------------------------------------------------------------------------------------------------------------------------------------------------------------------------------------------------------------------------------------------------------------------------------------------------------------------------------------------------------------------------------------------------------------------------------------------------------------------------------------------------------------------------------------------------------------------
--------------------------------------------------------------------------------------------------------------------------------------------------------------------------------------------------------------------------------------------------------------------------------------------------------------------------------------------------------------------------------------------------------------------------------------------------------------------------------------------------------------------------------------------------------------------------------------------------------------------------------------------------------------------------------------------------------------------------------------------------------------------------------------------------------------------------------------------------------------------------------------------------------------------------------------------------------------------------------------------------------------------------------------------------------------------------------------------------------------------------------------------------------------------------------------------------------------------------------------------------------------------------------------------------------------------------------------------------------------------------------------------------------------------------------------------------------
--------------------------------S-----------------------------------------------------------------------------------------------------------------------------------------------------------------------------------------------------------------------------------------------------------------------------------------------------------------------------------------------S-----------------------------------------------------------------------------------------------------------------------------------------------------------------------------------------------------------------------------------------------------------------------------------------------------------------------------------------------------------------------------------------------------------------------------------S-------------------------------------------------------------------------------------------------------------------------------------------S-------------------------------------------------------S-----------------------------------------------------------------------------------S-------------------------------------------------------------------------------------------------------------------------------------------------------------------------------------------------------------------------------------------------------------------------------------------------------------------S-----------------------
----------------------------S------X-------------------------------------------------------------------------------------------------------------------------------------------------------------------------------------------------------------------------------X---------------------------------------------------------------------------------------------------------------X-------------------------------------------------------------------------------------------------------------------------------------------------------------------------------------------------------------------------------------------------------------------------------------------------------------------------------------------------------------------------------------------------------------------------------------------------------------------------------------------------------------------------------------------------------------------------------X---------------------------------------------------------------------------------------------------------------------------------------------------------------------------------------------------------------------------------------------------------------------------------------------------------------------------------------------------------------------------------------------------------------------------------------------------------------X--------------------
--------------------------------S-----------------------------------------------------------------------------------------------------------------------------------------------------------------------------------------------------------------------------------------------------------------------------------------------------------------------------------------------------------------------------------------------------------------------------------------------------------------------------------------------------------------------------------------------------------------------------------------------------------------------------------------------------------------------------------------------------------------------------------------------------------------------------------------------------------------------------------------------------------------------------------------------------------------------------------------------------------------------------------------------------------------------------------------------------------------------------------------------------------------------------------------------------------------------------------------------------------------------------------------------------------------------------------------------------------------------------------------------------------------------------------------------S-----------------------
----------------------------SS--So-----------SSS-----------------------------------------------E---------------------------E------S---------------------------S--------------------E-----SS--------------------------SSS-------------------E------S--------------------------SS---------------------------S--------------------E------S---------------------------S---------------S----------SSS-------------------E------S--------------------E------S--------------------E------S--------------------------SS--------------------E------S--------------------------SS--------------------E---------------------------------SSS-------------------E------S--------------------E------S--------------------E-----SS--------------------E-----SS--------------------E-----SS--------------------E---------------------------------SSS-------------------E------S--------------------E------S--------------------------SSS-------------------E------S--------------------E-----SSS-------------------E---------------------------E-----SSS--------------------------S--------------------E-----SSS--------------S----E-----SSS-------------------E---------------------------E-----SS--------------------E---------------------------------SS------------------------------------------------------SSS--------------------------S---------------------------S---------------S----------SS------------------------------------------------------SSS--------
Q---------------------------XX--SSS--------------o--o--------------E--------------------------<>--------------------------<>---------E--o------------E-E---------E----------------<>---------------------------E--------------------------<>--------------------------<>---------E--o------------E<>---------E----------------<>-------------------------E-E---------E--o---------S----E---------o--o-------------<>--------------------------<>--<>-----E--o-------------<>---------E--o------------E-----------E--o-------------<>---------E------------------------------o-------------<>------------------------------------------------------<>---------E---------------E<>---E----------------------<>--------------------------<>------------o-------------<>---E-----E--o-------------<>----------------------S---<>---------o--o-------------<>---------E----------------<>---------E------X----------E------------o-------------<>----------------------S---<>---------o----------------<>---------E----------------<>------------o------------E<>--------------------------<>------------o---------S---<>------------o------------E<>---------E------X---------<>--------------------------<>-------------------------E--------------o--------------E---------E-----------------E-------------------------E<>---E-----E-----Q---------------E-----E---------------E-----------E-----------------E----------------X---S-S--------------o------
-----------------------------------------------------------------E<>---E-----E----------------[]---E----------------------[]---E----<>--------------<><>---E----<>----------------[]---E-----E----------------<>---E----------------------[]---E----------------------[]---E----<>--------------<>[]---E----<>----------------[]---E--------------------<><>--------<>----------------<>---E----------------------[]---E----------------------[]--[]----<>----------------[]---E----<>--------------<>-----E----<>----------------[]---E----<>--------------------------------------------[]---------------------------E---E----------------------[]---E----<>---------E----<>[]--<>-----E----------------[]--------------------------[]---E-----E----------------[]--<>-----E----------------[]---E-----E----------------[]---E----------------------[]---E----<>----------------[]---E----<>----------------<>---E----------------------[]---E-----E----------------[]---E----------------------[]---E----<>----------------[]------------------------<>[]---E-----E----------------[]---E----------------------[]---E--------------------<>[]---E-----E----------------[]---E----------------------[]---E--------------------<>----------------------------<>--------<>----------------<>---E--------------------<>[]--<>----<>--------------<>----<>----<>--------------<>-----E----<>----------------<>---------------------------E---E------------
--------------<>------------------------------------------------<>[]--<>----<>----------------[]--<>----<>----------------[]--<>----[]--------------[][]--<>----[]----------------[]--<>----<>----------------[]--<>----<>----------------[]--<>----------------------[]--<>----[]--------------[][]--<>----[]----------------[]--<>--------------------[][]--<>----[]----------------[]--<>----------------------[]--<>--------------<>------[]--[]----[]--------<>------[]--<>----[]--------------[]----<>----[]----------------[]--<>----[]--------------------------------------------[]--------------------------<>--<>----------------------[]--<>----[]--------<>----[][]--[]----<>----------------[]--------------------------[]--<>----<>----------------[]--[]----<>----------------[]--<>----<>----------------[]--<>----------------------[]--<>----[]----------------[]--<>----[]----------------[]--<>----------------------[]--<>----<>----------------[]--<>----------------------[]--<>----[]----------------[]------------------------[][]--<>----<>----------------[]--<>----------------------[]--<>--------------------<>[]--<>----<>----------------[]--<>----------------------[]--<>--------------------[]----<>----------------------[]--------[]----------------[]--<>--------------------[][]--[]----[]--------------[]----[]----[]--------------[]----<>----[]----------------[]--------------------------<>--<>------------
--------------[]-------E---------------------------E-EE---EE----[][]--[]----[]-E-EE----EE-E---[]--[]----[]-E-------EE-----[]--[]----[]---EE---EE----[][]--[]----[]-E-E--E-EE--E---[]--[]----[]-E-E--E--E------[]--[]----[]-E-E----EE------[]--[]---------E-----E------[]--[]----[]--------EE----[][]--[]----[]-E-E----EE------[]--[]---------EE-E-EE----[][]--[]----[]-E-E-----E------[]--[]-------E-EE---EE------[]--[]---------EE---[]------[]--[]----[]--------[]------[]--[]----[]--------EE-E--[]----[]----[]---E--E--EE-----[]--[]----[]-E-EE---EE---------------------E--E-EE------[]--X--------E-E-----E------[]--[]---------E--E-EE------[]--[]----[]-E-E----[]----[][]--[]----[]--------EE------[]------------------EE------[]--[]----[]---EE---EE------[]--[]----[]---EE-E-EE------[]--[]----[]-E-E--E--EE-----[]--[]-------E-E--E--E------[]--[]----[]--------EE------[]--[]----[]-E-E----EE------[]--[]-------E-EE----E------[]--[]----[]-E----E--E------[]--[]---------------E------[]--[]----[]-E-EE-E--E------[]-----------E-E----EE----[][]--[]----[]---E----EE------[]--[]---------E--E--E------[]--[]-------E-EE---EE----[][]--[]----[]-E-E----EE------[]--[]-------E-EE---EE------[]--[]-------E-E----EE----[]----[]---------EE---EE------[]--------[]-E-E--E--E------[]--[]-------E-E----EE----[][]--[]----[]---EE---EE--E-[]----[]----[]-E-E----EE----[]----[]----[]---E--E-EE------[]-----------E-E-----E------[]--[]---------E--
XXXXXXXXXXXXXXXXXXXXXXXXXXXX---XXXXXXXXXXXXXXXXXXXXXXXXXXXXXXXXXXXXXXXXXXXXXXXXXXXXXXXXXXXXXXXXXXXXXXXXXXXXXXXXXXXXXXXXXXXXXXXXXXXXXXXXXXXXXXXXXXXXXXXXXXXXXXXXXXXXXXXXXXXXXXXXXXXXXXXXXXXXXXXXXXXXXXXXXXXXXXXXXXXXXXXXXXXXXXXXXXXXXXXXXXXXXXXXXXXXXXXXXXXXXXXXXXXXXXXXXXXXXXXXXXXXXXXXXXXXXXXXXXXXXXXXXXXXXXXXXXXXXXXXXXXXXXXXXXXXXXXXXXXXXXXXXXXXXXXXXXXXXXXXXXXXXXXXXXXXXXXXXXXXXXXXXXXXXXXXXXXXXXXXXXXXXXXXXXXXXXXXXXXXXXXXXXXXXXXXXXXXXXXXXXXXXXXXXXXXXXXXXXXXXXXXXXXXXXXXXXXXXXXXXXXXXXXXXXXXXXXXXXXXXXXXXXXXXXXXXXXXXXXXXXXXXXXXXXXXXXXXXXXXXXXXXXXXXXXXXXXXXXXXXXXXXXXXXXXXXXXXXXXXXXXXXXXXXXXXXXXXXXXXXXXXXXXXXXXXXXXXXXXXXXXXXXXXXXXXXXXXXXXXXXXXXXXXXXXXXXXXXXXXXXXXXXXXXXXXXXXXXXXXXXXXXXXXXXXXXXXXXXXXXXXXXXXXXXXXXXXXXXXXXXXXXXXXXXXXXXXXXXXXXXXXXXXXXXXXXXXXXXXXXXXXXXXXXXXXXXXXXXXXXXXXXXXXXXXXXXXXXXXXXXXXXXXXXXXXXXXXXXXXXXXXXXXXXXXXXXXXXXXXXXXXXXXXXXXXXXXXXXXXXXXXXXXXXXXXXXXXXXXXXXXXXXXXXXXXXXXXXXXXXXXXXXXXXXXXXXXXXXXXXXXXXXXXXXXXXXXXXXXXXXXXXXXXXXXXXXXXXXXXXXXXXXXXXXXXXXXXXXXXXXXXXXXXXXXXXXXXXXXXXXXXXXXXXXXXXXXXXXXXXXXXXXXXXXXXXXXXXXXXXXXXXXXXXXXXXXXXXXXXXXXXXXXXXXXXXXXXXXXXXXXXXXXXXXXXXXXXXXXXXXXXXXXXXXXXXXXXXXXXXXXXXXXXXXXXXXXXXXXXXXXXXXXXXXXXXXXXXXXXXXXXXXXXXXXXXXXXXXXXXXXXXXXXXXXXXXXXXXXXXXXXXXXXXXXXXXXXXXXXXXXXXXXXXXXXXXXXXXXXXXXXXXXXXXXXXXXXXXXXXXXXXXXXXXXXXXXXXXXXXXXXXXXXXXXXXXXXXXXXXXXXXXXXXXXXXXXXXXXXXXXXXXXXXXXXXXXXXXXXXXXXXXXXXXXXXXXXXXXXXXXXXXXXXXXXXXXXXXXXXXXXXXXXXXXXXXXXXXXXXXXXXXXXX
