--------------------------------------------------------------------------------------------------------------------------------------------------------------------------------------------------------------------------------------------------------------------------------------------------------------------------------------------------------------------------------------------------------------------------------------------------------------------------------------------------------------------------------------------------------------------------------------------------------------------------------------------------------------------------------------------------------------------------------------------------------------------------------------------------------------------------------------------------------------------------------------------------------------------------------------------------------------------------------------------------------------------------------------------------------------------------------------------------------------------------------------------------------------------------------------------------------------------------------------------------------------------------------------------------------------------------------------------------------------------------------------------------------------------------------------------------------
-----------------------------------------------------------------------------------------------------------------------------------------------------------------------------------------------------------------------------------------------------------------------------------------------------------------------------------------------------------------------------------------------------------------------------------------------------------------------------------------------------------------------------------------------------------------------------------------------------------------------------------------------------------------------------------------------Q---------------------------------------------------------------------------------------------------------------------------------------------------------------------------------------------------Q----------------------------------------------------------------------------------------------------------------------------------------------------------------------------------------------------------------------------------------------------------------------------------------------------------------------------------------------------------------------------------------------------------------------------------------------------------------------------------------------------------------------------------------------------
---------------------------------------------------------------------------------------------------------------------------------------------------------------------------------------------------------------------------------------------------------------------------------------------oo---------------------------------------------------------------------------------------------------------S-S-SSSSS-SSSSS---------------------------------------------------------------------------------------------------------------------------------------------------------------------------------------------------------------------------------------------------------------------------------------------------------------------------------------------------------------------------------------------------------------------------------------------------------------------------------------------------------------------------------------------------------------------------------------------------------------------------------------------------------------------------------------------------------------------------------------------------------------------------------------------------------------------------------------------------------------------------------------------------------------------------------------------------------------------------------------------------------------------------------
--------------------------------------------------------------------------------------------------------------------------------------------------------------------------------------------------------------------------------------------------------------------------------------------XXXX-------------------E-------X----------------------------------------------------------------------------------------------------------------------------------------------------------------------------------------------------------------------------------------------------------------------------------------o-------------------------------------------------------------------------------------------------------------------------------------------------------------------------------------------------------------------------------o--------------------------X---------------------------------------------------------------------------------------------------------------------------------------------------------------------------------------------------------------------------------------------------------------------------------------------------------------------------------------E-----------------------------------------------------------------------------------------X--------------------------------------------------------------------------------------------------------------------------------------
---------------------------------------------------------------------------------------------------------------------------------------------------------------------------------------------------------------------------------------------------------------------------E----------------------------------------------------------------------------------------------------------------------------------------------------------------------------------------------------------------------------------------------------------------------------------------------------------------------------------------------------------------------------------------------------------------------------------------------------------------------------------------------------------------------------------------------------------------------------------------------------------------------------------------------------------------------------------------------------------------------------------------------------------------------------------------------------------------------------------------------------------------------------------------------------------------------------------------------------------------------------------------------------------------------------------------------------------------------------------------------------------------------------------------------------------------------------
-----------------------------------------------------SQQ-------------------------SSS---------SS?SSSS-----SSSSSSS-------------------E---------------------------------------------QQQE---------------------------------------S------------Q--------------------------------SQS-----SS---------------Q---------SQSSSS-----------------------QSSSS------------?SSSS-----SSS-----------------------------------------------------------------------------------------------------------------SSS-----------Q-QQQQ--------------------Q---SSSS--------------------?--E---------SSSSSS---------QQQ-------------------------?--E------------SS---------------------------SS---------?--E---------------o------?QQQQ-----------------------?-?QQ------------SSSS---------QQQQ------------------------?-EE---------QSSSSS---------Q-----------SQSSSSQ----------SS-S-------------S---------?------------SSSSSS-------------------------------------?-?QS-----------SQ----------?--E------------SS----------QQQQ-----------------------------------------S----------QQQ----------SSSSS-------------------------QQQQ-------?-?Q-E------------------------?-?ESSS-----------S---------?--E--------SSSSSSS---------Q-Q-----------SSSS--------?-QQQQ----------------------?QQQQQ------------------------Q-QQ----------SSSS------------------------SSSSS-------------SSS--------SSSS-------------------------------------Q-?QSSS---------------------Q-QQ---------------
--------------------------------------------------------------------------------------------------------------------------------------------------------------------------------------XXX----------------------------------------------------------------------------------------------------------------------------------------------------------------------------------------------------------------------------------------------------------------------------------------------------------------------------------------------------------------------XXXXXX--------------------------------------------------XXXXX---------------------------------------------------XXXXX-----------------------------------------------------XXX------------------------------------------------------XX-----------------------------------------------------------------------------------------------------------------------------------------XXX-----------------------XXXXXX--------------------------------------------------------------------------------------------------------------------------------------XXXXX-------------------------XXX--------------------------X-----------------------------------------------------------------------------------X-------------------------------------------------------------------------------------------------------------------------------------------XX--------------------------X-------------
---------------------------------------------------------------------------------------------------------------------------------------E--------------------------------------------------------------E---E-------------------------------------------------------------------------------------------------------------------------------------------------------------------------------------------------------------------------------------------------------E-------------------------------------------------------------------------------------------------------------------------------------------E---------------------------------------------------------------------------------------------------------------------------Q-------------------------------------------------------Q-------------------------------------------------------------------------------------------------------------------------------------------Q---------------------------------------------------------------------------------------------------------------------------------------------------------------------------------------------------Q-----------------------------------------------------------------------------------------------------------------------------------------------------------------------------------------------------------------------------------------------------------Q-----------------------------------------
------------------------E-------------------------------------------------E--------------------------------------------------------E-----------------E-----------E-----------------------------------<>--<>---------------------------------------E--E------------E--------------E--------E------------------E--------E---E-----------E---------------E---------------------------------------------E------------------------------------------------------------<>---------------E---------------------------------------E---E--------------E--------E------------------E---------------------------E-------<>------------------E--------E---------------------E--o--E---------------E------------------------------E--------E---------------E--E---------------------------E--?-----E---E-----------E--E--------E---------------E-----------E------------------E--------E---------------E-------------E-------------E-----------E--<>--------------E------------------------E--S--E-----E------------------E---------------------------E--------E---------------E--E--------E---------------E-----------E---E--------------E------------E-----------------------E---------------E---------------E--------------E--------E------------------E--------E------------------E--------E---------------E--E------------------------E--S---------------------------E-----------------------------E----------------------------E------------------------E------
-<>--------------------<>--------------QQ--------------S-----------------<>-----E--------------QQ---------------------------------<>---E------------<>-------E--<>---QQQ--------?QQQQ----Q-----------[]--[]------------------QQQ--------QQQ------<>-<>---QQ?-----<>---Q-Q-Q-----<>-------<>----Q------------<>---QQQ-<>--<>---Q-Q----<>------QQ?-----<>----QQQ---Q-Q--------------E----Q-----------<>------------------------------------------------------------[]--------------<>-----E----QQQ---Q--QQ--QQQQ---E-------<>--<>---QQQQ------<>---QQQ-<>---E--S-------<>-<>--E-----E---E--QQ---------<>---QQQ-[]----E?SQQQ-------<>-------<>----E----------E----<>----<>---E--SQ------<>--------?--E----Q?QQ-Q-------<>----Q--<>----E?SQQQ----<>-<>----Q?------E--SQQQQ------<>---QQQ-<>--<>--SQQQ----<>-<>---QQ?-<>---E--QQ------<>------Q?S-<>----E--Q---------<>-------<>----E---------<>-----E--S---<>---QQQQ-----<>----------<>--[]---QQQ----Q--<>---QQQ--E------SQQQ----<>----<>----<>---E--SQQQ-------<>---QQQ--E<>----QQ---------<>-------<>----E-QQ------<>-<>---Q?S-<>----E---------<>------QQ?-<>--<>--SQQQ----XX-<>---QQ?--E--<>--S----Q--<>-----E----<>----E-SQ------<>-----E--S--E--<>--SQQQ-------<>---QQQ-<>---E--SQQQ-------<>---QQQ-<>----E?SQQQ----Q--<>---QQQ-<>---E--QQQQ----<>-<>---QQ?-----------------<>-----E-----E----Q--Q---------<>---------------------------E<>----------EE--QQQQ---------<>-----E---EE?SQQQQ------<>------
-[]--------------------[]-----E-E----------------------------------------[]----<>-------------------------------------------------[]--<>------E-----[]------<>--[]--------E<>------------------------[]--[]-----------------------E<>------------[]-[]-----------[]-------------[]-------[]-----------------[]-------[]--[]----------[]--------------[]-------------------E------<>----------------[]------------------------------------------------------E-----[]--------------[]----<>-----------------------<>-------[]--[]-------------[]-------[]--<>----------[]-[]-<>----<>--<>-------------[]-------[]-----------------[]-------[]--------E-----<>----[]----[]--<>----------[]-----E----<>-----------------[]-------[]--------------[]-[]--------E--<>-------------[]-------[]--[]----------[]-[]-------[]--<>----------[]----------[]-----------------[]-------[]--------------[]----<>-----E[]------------[]----------[]--[]-------------[]-------<>--------------[]----[]----[]--<>-------------[]-------<>[]---------------[]--E----[]--------------[]-[]-------[]--------------[]--E-------[]--[]-------------[]-------<>--[]----------[]----<>----[]--------------[]----<>----<>--[]-------------[]-------[]--<>-------------[]-------[]-----------------[]-------[]--<>----------[]-[]-----------------------[]----<>----<>-----------------[]--------------------------<>[]------E--<>----------------[]----<>--<>-------------[]------
-[]--------------------[]----<><>----------------------------------------[]----[]-------------------------------------------------[]--[]------------[]------[]--[]-------<>[]------------------------[]--[]----------------------<>[]------------[]-[]-----------[]-------------[]-------[]-----------------[]-------[]--[]----------[]--------------[]------------------<>------[]----------------[]-----------------------------------------------------<>-----[]--------------[]-<>-[]-----------------------[]-------[]--[]-------------[]-------[]--[]----------[]-<>-[]----[]--[]-------------[]-------[]-----------------[]-------[]--------------[]----[]----[]--[]----------[]-<>-<>----[]-----------------[]-------[]--------------<--[]-------<>--[]-------------[]-------[]--[]----------[]-[]-------[]--[]----------[]-<>-------[]-----------------[]-------[]--------------[]----[]----<>[]------------[]----------[]--[]-------------[]-------[]<>------------[]----[]----[]--[]-------------[]-------[][]---------------[]-<>----[]--------------[]-[]-------[]--------------[]-<>-------[]--[]-------------[]-------[]--[]----------[]----[]----[]--------------[]----[]----[]--[]-------------[]-------[]--[]-------------[]-------[]-----------------[]-------[]--[]----------[]-[]-----------------------[]----[]----[]-----------------[]--------------------------[][]-----<>--[]----------------[]----[]--[]-------------[]------
-[]--E--------E-EE-E---[]----[][]---------E-EE---------------------E--E--[]----[]--------E--------E-EE-E---E-------EE-E---E-E-E---[]--[]-----XX--E--[]------[]--[]-------[][]--------EE-E--E---------[]--[]----E--E--E-----------[][]---------E--[]-[]-----------[]----E--------[]-------[]--------EE-E-----[]-------[]--[]----E--E--[]----------E---[]--------EE---EE---[]------[]------EE-E------[]--------------E--EE---------------E--E-EE--E-E--E----[]-----[]---E----E--E--[]-[]-[]------E----------EE----[]---E---[]--[]----E-E---E--[]-------[]--[]-------E--[]-[]-[]----[]--[]-------EE----[]----E--[]-----------E-EE--[]-------[]--E--------E--[]E---[]----[]--[]------EE--[]-[]-[]----[]--------E--E-----[]-------[]-----------E-EE--[]-------[]--[]-------EE----[]----E--[]--[]------EE--[]-[]-------[]--[]----E--E--[]-[]-------[]--------E--EE----[]-------[]--------E--E--XXE---[]----[][]--------EE--[]----------[]--[]-------E-E---[]-------[][]--------EE--[]----[]----[]--[]-------EE----[]-E--E--[][]--------EE-E---[]-[]----[]--------E--E--[]-[]-------[]--------E--E--[]-[]-------[]--[]------EE-----[]-------[]-E[]----E-E---XXX---[]----[]-----------E--[]-E--[]----[]--[]-------EE----[]-------[]--[]-------E-----[]-------[]-----------E-----[]-------[]--[]-------E--[]-[]-----------------E--E--[]----[]----[]--------EE-EE-E--[]-----------EE-----E-EE----[][]-----[]--[]------EE-EE-E---[]----[]--[]-------E-EE--[]-E----
-XXXXXXXXXXXXXXXXXXXXXXXXXXX-XXXXXXXXXXXXXXXXXXXXXXX-XXXXXXXXX--XXXXXXXXXXXXXXXXXXXXXXXXXXXXXXXXXXXXXXXXXXXXXXXXXXXXXXXXXXXXXXXXXXXXXXXXXXXXXXXXXXXXXXXXXXXXXXXXXXXXXXXXXXXXXXXXXXXXXXXXXXXXXXXXXXXX-XXXXXXXXXXXXXXXXXXXXXXXXXXXXXXXXXXXXXXXXXXXXXXXXXXXXXXXXXXXXXXXXXXXXXXXXXXXXXXXXXXX-XXXXXXXXXXXXXXXXXXXXXXXXXXXXXXXXXXXXXXXXXXXXXXXXXXXXXXXXXXXXXXXXXXXXXXXXXXXXXXXXXXXXXXXXXXXXXXXXXXXXXXXXXXXXXXXXX---XXXXXXXXXXXXXXXXXXXXXXXXXXXXXXXXXXXXXXXXXXXXXXXXXXX-XXXXXXXXXXXXXXXXXXXXXXXXXXXXXXXXXX--XXXXXXXXXXXXXXXXXXXXXXXXXXXXXXXXXXXXXXXXXXXXXXX-XXXXXXXXXXXXXXXXXXXXXXXXXXX-XXXXXXXXXXXXXXXXXXXXXXXXXXX-XXXXXXXXXXXXXXXXXXXXXXXXXXX-XXXXXXXXXXXXXXXXXXXXXXXXXXX-XXXXXXXXXXXXXXXXXXXXXXXXXXX-XXXXXXXXXXXXXXXXXXXXXXXXXXX-XXXXXXXXXXXXXXXXXXXXXXXXXXX-XXXXXXXXXXXXXXXXXXXXXXXXXXX-XXXXXXXXXXXXXXXXXXXXXXXXXXX-XXXXXXXXXXXXXXXXXXXXXXXXXXX-XXXXXXXXXXXXXXXXXXXXXXXXXXXXXXXXXXXXXXXXXXXXXXXXXXXXXXXXXXXXXXXXXXXXXXXXXXXXXXXXXXX-XXXXXXXXXXXXXXXXXXXXXXXXXXXXXXXXXXXXXXXXXXXXXXXXXXXXXXX-XXXXXXXXXXXXXXXXXXXXXXXXXXX-XXXXXXXXXXXXXXXXXXXXXXXXXXX-XXXXXXXXXXXXXXXXXXXXXXXXXXX-XXXXXXXXXXXXXXXXXXXXXXXXXXXXXXXXXXXXXXXXXXXXXXXXXXXXXXXXXXXXXXXXXXXXXXXXXXXXXXXXXXX-XXXXXXXXXXXXXXXXXXXXXXXXXXX-XXXXXXXXXXXXXXXXXXXXXXXXXXX-XXXXXXXXXXXXXXXXXXXXXXXXXXX-XXXXXXXXXXXXXXXXXXXXXXXXXXX-XXXXXXXXXXXXXXXXXXXXXXXXXXXXXXXXXXXXXXXXXXXXXXXXXXXXXXX-XXXXXXXXXXXXXXXXXXXXXXXXXXXXXXXXXXXXXXXXXXXXXXXXXXXXXXX-XXXXXXXXXXXXXXXXXXXXXXXXXXX-XXXXXXXXXXXXXXXXXXXXXXXXXXX
