--------------------------------------------------------------------------------------------------------------------------------------------------------------------------------------------------------------------------------------------------------------------------------------------------------------------------------------------------------------------------------------------------------------------------------------------------------------------------------------------------------------------------------------------------------------------------------------------------------------------------------------------------------------------------------------------------------------------------------------------------------------------------------------------------------------------------------------------------------------------------------------------------------------------------------------------------------------------------------------------------------------------------------------------------------------------------------------------------------------------------------------------------------------------------------------------------------------------------------------------------------------------------------------------------------------------------------------------------------------------------------------------------------------------------------------------------------
---------------------------------------------------------------------------------------------------------------Q-----------------------------------------------------------------------------------------------------------------------------------------------------------------------------------------------------------------------------------------------------------------------------------------------------------------------------------------------------------------------------------------------------------------------------------------------------------------------------------------------------------------------------------------------------------------------------------------------------------------------------------------------------------------------------------------------Q----------------------------------------------------------------------------------------------------------------------------------------------------------------------------------------------------------------------------------------------------------------------------------------------------------------------------------------------------------------------------------------------------------------------------------------------------------------------------------------------------------------------------------------------------------------------------------------------------------------------------------------
---------------------------------------------------------------------------------------------------------------------------------------------------------------------------------------------------------------------------------------------------------------------------------------------oo---------------------------------------------------------------------------------------------------------------------------------------------------------------------------------------------------------------------------------------------------------------------------------------------------------------------------------------------------------------------------------------------------------------------------------------------------------------------------------------------------------------------------------------------------------------------------------------------------------------------------------------------------------------------------------------------------------------------------------------------------------------------------------------------------------------------------------------------------------------------------------------------------------------------------------------------------------------------------------------------------------------------------------------------------------------------------------------------------------------------------------------------------------
--------------------------------------------------------------------------------------------------------------------------------------------------------------------------------------------------------------------------------------------------------------------------------------------XXXX-------------------------------------------------------------------------------------------------------------------------------------------------------------------------------------------------------------------------------------------------------------------------------------------------------------------------------------------------------------------------XXX--------------------------------------------------------------------------------------------------------------------------------------------------------------------------------------------------------------------------------------------------------------------------------------------------------------------------------------------------------------------------------------------------------------------------------------------------------------------------------------------------------------------------------------------------------------------------------------------------------------------------------------------------------------------------------------------------------------------------------------------X-------------------------------
----------------------------------------------------------------------------------------------------------------------------------------------------------------------------------------------------------------------------------------------------------------------------------------------------------------------------------------------------------------------------------------------------------------------------------------------------------------------------------------------------------------------------------------------------------------------------------------------------------------------------------------------------------------------------------------------------------------------------------------------------------------------------------------------------------------------------------------------------------------------------------------------------------------------------------------------------------------------------------------------------------------------------------------------------------------------------------------------------------------------------------------------------------------------------------------------------------------------------------------------------------------------------------------------------------------------------------------------------------------------------------------------------------------o---------------------------------------
-------?-Q--E------------SSS------------SSSS--------SSSS-------------------------SSS---------?--E-----------SSSS--------------SSS-------SSS----------?--E----------SSSSS-------------------------SQS-------------------------------------------------------S-----------------------------------?-QQ--------------SQ-------------------------------------------SSS--------SSS----------------------S-SSSS---------------------------S---------------------------------------------------------------------------------SSS----------------------------QQQQ--------------------XXXS-------------------------------------?--E---------------------------E----------SSSSS----------------------QSSSQQ-----------------------SSSSS-----------Q---S---------------------Q-QQ------------------------??-E-----------SSSS-----------------------SSSSSo--------Q-Q------------SSSS---------SS?SSSS-------SSS--------------SSSS----------QQ-----------?SSSS---------------------------------------S-----------------------SSSS--------------------------------------?----------------S--------------------------------------?-?E-----------SSSS---------QQQ------------SSSS-------------------------SSS------------E----------------------------SSS-------------------------------------SSS-----------------------------------------SSS----------------------SSSSS--------------------------------------------------------XXX---------S----------------------------
------------------------------------------------------------------------------------------------------------------------------------------------------------------------------------------------------------------------------------------------------------------------------------------E------------------------------------------------------------------------------------------------------------------------------------------------------------------------------------X--------------------------------------------------------------------------------------------XXX----------------------------------------XXXXXX------------------------------------------------------------------------------------------------------------------------------------------------------X--------------XX------------------------------------------------------------------------------------------------------------------------------------------XX----------------------------------------------------------------------------------------------E--------------------------------------------------------------------XXXXXX-------------------------------------------------------------------------------------------------------------------------------------------------------------------------------------------------------------------------------------------------------------------------------------------------------------------------------
--------------------------------------------------------------------------------------E-------------------------------------------------------E------------------------------------------------------------------------------------------------------------------------------------------<>-X------------------------------------------------------------------------------------------------------------------------------------------------------------------------------------------------------------------------------------------------------------------------------XXXX-------------------------------------------Q---------------------------------------------------------------------------------------------------------------------------------------Q---------X-----------------------------------------------------------------------------------------------------------------------------------------------------------------------------------------------------------------------------------------------------------XXXXXXXX------------------------------------------------------------------------------------------------------------------------------------------------------------------------------------------------------------------------------------------------------------------E---------------------------------E------------------------------------------------------------------------------------------------XXX
--E---------------------E--o--------------------------------E-------------E--E--------E---------------E-----E---------E--------------E-------<>---------------E--E-------------------------------------------------------oo-----------------------------------------------------------E--[]---------------E--E----------E-----------------------------------------E-------------E-------------E---------------------------E-----------E-----------------------------E-----------------------------------------------------------------------------------------------------XXXX----E---------------E--E------------E-----------------------E---------------E--S--------E---------------E--E--------E---------------E--S---------------------------E------------E--------------E--------E---------------E-----E---------------------E-----------E---E--------------E----------------------------------------------------------------E---E---------------------------------------E---------------------------------------------------------------------E----------------E----------E-------------------------E---------------------E-------E----------------E-----------------------------------------------------------------------------------o------------------------E--S------------------------E-----------E--<>--------------------------------------------------------------E-------o------------------Q----------------------------------------XXX
-<>----E?SQQQ-----E----<>-------E-------------------------E<>--Q--Q------<>-<>----E?-<>----E?S-------<>----<>-----E--<>---QQQ-------<>---QQQ-[]----E?SQ------<>---------------------------------------E------QQQQ----------------------QQ-----Q---------E----------------------------<>--[]----E?-Q------<>-<>---QQ----<>------QQQ---Q------------E--<>---Q------<>-----E-----E<>--Q--Q------<>--------S-----------------<>-----E----<>--------Q-------------Q----E<>-----QQQQ--Q---------------E-------------E-----E-----------------------<>------QQQQQQ---------------XXXXX---<>--------------<>-<>--------E--<>---QQQ-----------E----<>------S-------<>-----E----<>--------------<>-<>---Q?S-<>--------------<>-----E--S-----<>--QQQQQ------<>---QQQ--E--<>---QQQQ------<>---QQQ-<>-----?S-------<>----<>----------E-QQQQ----<>-----E----<>--<>---QQQ-------<>----------E----Q-------Q--Q------------------------------------<>--<>-------------------------X---------Q--<>-----E--------------------<>-----E-----E-------Q-Q----<>-----------E<>-----Q---------<>------o--<>-----------Q----------Q-<>---EE?S--------E----<>------<>---Q-----------<>------------------------------------E-----?S------------------------E----------Q---------------------------<>-----E--------------------<>----------<>--[]---Q-QQ-----------------------E------------------------------<>--------------------------XX----E-----E---------------------------XXXX
-[]--------------<>----[]-----E<>------------------------<>[]------------[]-[]-------[]--------------[]----[]----<>--[]-------------[]-------[]--------------[]--E-----------------------------------<>-----------------------------X------------------<>----E---------------------X-[]--[]--------------[]-[]---------[]------------------------<>--[]----------[]----<>----<>[]------------[]--------------------------[]----<>----[]--------------------------<>[]-------------------E-----E<>------------------<>----X---SS-------------[]---------------------------XXXXX---[]--------------[]-[]--E----<>--[]----------------<>----[]--------------[]----<>----[]--------------[]-[]-------[]--------------[]----<>-----E-E[]-------------[]-------<>--[]-------------[]-------[]--------------[]----[]----<>--------------[]----<>----[]--[]-------------[]---------<>----------------------------------------------------[]--[]-------------------------X------------[]----<>--------------------[]----------<>--<>----------[]----------<>[]---------------[]---------[]------------------------[]--<>----------------[]------[]---------------[]-----------------------------------<>---------------------------E--<>--------------------------------------[]----<>----E--XXXX-?-------[]-------X--[]--[]----------------------------X<>------------------------------[]-------------------E-----------<>----<>--------------------------XXXXX
-[]--------------[]----[]----<>[]----<>------------------[][]------------[]-[]-------[]--------------[]----[]----[]--[]-------------[]-------[]--------------[]-<>----------------------------<>-----[]-----------------------------X------------------[]----------------------------[]--[]--------------[]-[]---------[]----<>------------------[]--[]----------[]-<>-[]----[][]------------[]-X------------------------[]----[]----[]--------------------------[][]------------------<>----<>[]-------------?----[]---XX------------------[]--------------------------XXXXXX---[]--------------[]-[]-<>----[]--[]----------------[]----[]--------------[]----[]----[]--------------[]-[]-------<---------------[]----[]----<><>[]-------------[]-------[]--[]-------------[]-------[]--------------[]----[]----[]<>------------[]----[]----[]--[]-------------[]---------[]----<>----------------------------------------------[]--[]-----------------?-------X------------[]----[]--------------------[]--------X-[]--[]----------[]----------[][]---------------[]---------[]------------------------[]--[]----------------[]------[]---------------[]----------------------<>-----------[]--------------------------<>--[]-------------------------<>-----------[]----[]--------------------[]--------X-[]--[]----------------------------X[]------------------------------[]------------------<>-----------[]----[]-------------------------XXXXXX
-[]--------E--E--[]E---[]----[][]----[]--EE-EE-----------[][]--------E-E-[]-[]-------[]-----------E--[]-E--[]----[]--[]-------E-EE--[]-EE-E--[]-----------E--[]-[]------------E-------E-E-----[]-----[]----------EE-E---------------X------E--E--E-E---[]----------------E--E----E---[]--[]--------E-----[]-[]---------[]----[]-----EE-----E--E--[]--[]---EE-E---[]-[]-[]----[][]------E--E--[]-X--E---------EE-E---E-E--[]----[]----[]-----------E-EE--------E--[][]--------EE-E----E-[]-E--[][]-E-----E-E-EE-E---[]----X----E-----E-EE----[]-E---------EE------------XXXXXXX---[]--------E--E--[]-[]-[]----[]-E[]------EE-E--E---[]----[]-----E-----E--[]-E--[]----[]--------E--E--[]-[]-----------E--E-----E--[]----[]----[][][]-------EE----[]-E--E--[]--[]-------E-EE--[]----E--[]--E-EE-----E--[]-E--[]----[][]---------E-E[]----[]----[]--[]----E--E--E--[]-E-E---E-[]----[]---E-EE-----E--E----E--E-------E-EE-----------[]--[]-------E-EE--------------X-----EE-E---[]----[]----------------EE--[]-------XX-[]--[]----E-EE-E[]----------[][]-E-------E-EE--[]-E--E----[]--------E--EE-----EE-E--[]--[]-------E-EE-E---[]------[]-E-------E--E--[]-----------EE-----E-E-[]-----E-----[]--E-E------E-E------E-----[]--[]------E------------------[]----EE--E--[]----[]----------------E---[]--EE---XX-[]--[]----E-----E--E---------EE-E-X[]---------------E-------E------[]------------------[]---E----E--[]----[]-----------------E-EE---XXXXXXX
-XXXXXXXXXXXXXXXXXXXXXXXXXXX-XXXXXXXXXXXXXXXXXXXXXXXXXXX-XXXXXXXXXXXXXXXXXXXXXXXXXXX-XXXXXXXXXXXXXXXXXXXXXXXXXXXXXXXXXXXXXXXXXXXXXXXXXXXXXXX-XXXXXXXXXXXXXXXXXXXXXXXXXXXXXXXXXXXXXXXXXXXXXXXXXXXXXXX-XXXXXXXXXXXXXXXXXXXXX--XXXXXX--XXXXXXXXXXXXXXXXXXXXXXXXXXXXXX---XXXXXXXXXXXXXXX-XXX-XXXXXXXXXXXXXXXXXXXXXXXXXXXXXXXXXXXXXXXXXXXXXXXXXXXXXXXXXXXXXXXXXXXXXXXXXXXXXXXXXXX-XXXXXXXXXXXXXXXXXXXXXXXXXXXXXXXXXXXXXXXXXXXXXXXXXXXXXXX-XXXXXXXXXXXXXXXXXXXXXXXXXXX-XXXXXXXXXXXXXXXXXXXXXXXXXXX-XXXXXXXXXXXXXXXXXXXXXXXXXXXXXXXXXXXXXXXXXXXXXXXXXXXXXXXXXXXXXXXXXXXXX-X-XXXXXXXXXXX-XXXXX--XXXXXXXXXXXXXXXXXXXX-XXXXXXXXXXXXXXXXXXXXXXXXXXX-XXXXXXXXXXXXXXXXXXXXXXXXXXX-XXXXXXXXXXXXXXXXXXXXXXXXXXXXXXXXXXXXXXXXXXXXXXXXXXXXXXX-XXXXXXXXXXXXXXXXXXXXXXXXXXXXXXXXXXXXXXXXXXXXXXXXXXXXXXX-XXXXXXXXXXXXXXXXXXXXXXXXXXX-XXXXXXXXXXXXXXXXXXXXXXXXXXX-XXXXXXXXXXXXXXXXXXXXXXXXXXXXXXXXXXXXXXXXXXXXXXXXXXXXXXXXXXXXXXXXXXXXXXXXXXXXXXXXXXX-XXXXXXXXXXXXXXXXXXXXXXXXXXXXX-XXXXXXXXXXXXXXXXXXXXXXXXXXXXXXX---XXXXXXXXXXXXXXXXXXXXXXXXXXXXXXXXXXXXXXXXXXXXXXX-XXXXXXXXXXXXXXXXXXXXXXXXXXXXXXXXXXXXXXXXXXXXXXXXXXXXXXXXXXXXXXXXXXXXXXXXXXXXXXXXXXXXXXXXXXXXXXXXXXXXXXXXXXXXXXXXXXXXXXXXXXXXXXXXXXXXXXXXXXXXXXXXXXXXXXXXXXXXXXXXXXXXXXX-XXXXXXXXXXXXXXXXXXXXXXXXXXXXXXXXXXXXXXXXXXXXXXXXXXXXXXXXXXX-----XXXXXXXXXXXXXXXXXXXXXXXXXXXXXXXXXXXXXXXXXXXXXXXXXXXXXXXXXXX-X---XXXXXXXXXXXXXXXXX-XXXXXXXXXXXX-----XXXXXXXXXXXXXXXXXXXXXXXXXXXXXXXXXXXX-----XXXXXXXXXXXXXXXXXX-
