--------------------------------------------------------------------------------------------------------------------------------------------------------------------------------------------------------------------------------------------------------------------------------------------------------------------------------------------------------------------------------------------------------------------------------------------------------------------------------------------------------------------------------------------------------------------------------------------------------------------------------------------------------------------------------------------------------------------------------------------------------------------------------------------------------------------------------------------------------------------------------------------------------------------------------------------------------------------------------------------------------------------------------------------------------------------------------------------------------------------------------------------------------------------------------------------------------------------------------------------------------------------------------------------------------------------------------------------------------------------------------------------------------------------------------------------------------
--------------------------------------------------------------------------------------------------------------------------------------------------------------------------------------------------------------------------------------------------------------------------------------------------------------------------------------------------------------------------------------------------------------------------------------------------------------------------------------------------------------------------------------------------------------------------------------------------------------------------------------------------------------------------------------------------------------------------------------------------------------------------------------------------------------------------------------------------------------------------------------------------------------------------------------------------------------------------------------------------------------------------------------------------------------------------------------------------------------------------------------------------------------------------------------------------------------------------------------------------------------------------------------------------------------------------------------------------------------------------------------------------------------------------------------------------------
--------------------------------------------------------------------------------------------------------------------------------------------------------------------------------------------------------------------------------------------------------------------------------------------------------------------------------------------------------------------------------------------------------------------------------------------------------------------------------------------------------------------------------------------------------------------------------------------------------------------------------------------------------------------------------------------------------------------------------------------------------------------------------------------------------------------------------------------------------------------------------------------------------ooo------------------------------------------------------------------------------------------------------------------------------------------------------------------------------------------------------------------------------------------------------------------------------------------------------------------------------------------------------------------------------------------------------oo-------------------------------------------------------------------------------------------------------------------------------------
----------------------------------------------------------------o-----------------------------------------------------------------------------------------------------------------------------------------------------------------------------------------------------------------------------------------------------------------------------------------------------------------------------------------------o-------------------------------------------------------------------------------------------------------------------------------------------o-------------------------------------------------------------------------------------------------------------------------------------------------------------------------------------------------X--------------------E------------------------------------------------------------------------------------------------------------------X-XXXX---------------------------------------------------------------------------------XXX--------------------------------------------------------------------------------------------------------------------------------------------------------------------------------------------------------------------------------------------------------------------------------------------------------------XXXXXX------------------------------------------------------------------------------------------------------------------------------------
--------------------------------------------------------------------------------------------------------------------------------------------------------------------------------------------------------------------------------------------------------------------------------------------------------------------------------------------------------------------------------------------------------------------------------------------------------------------------------------------------------------------------------------------------------------------------------------------------------------------------------------------------------------------------------------------------------------------------------------------------------------------------------------------------------------------------------------------------------------------------------------------------------------------ooo-----------------------------------------------------------------------------------------------------------------------------------------------------------------------------------------------------------------------------------------------------------------------------------------------------------------------------------------------------------------------------------------------------oo--------------------------------------------------------------------------------------------------------------------------
---------Q----------------E----------Q-----------------S----------E---------------------------------------------------------------------SSSS---------------------------S--------------------------------------------------------------------------------SSSS----------------------------o--------QQQQ----------SSSSS-------------------------------------Q-QQ---------------o--------QQQ--------------S----------Q-QQ------------------------QQQQ------------------------Q--Q----------SSSS----------Q---------------SSSo------?-QQQQ----------S-------------?--E------------------------?--E-----------SSQ-----------------------SSSSSS----------S-----------------------------QSQS------QSSSS----------?--E----------------------Q-QQQ----------------------------------------SSS----------Q-?QS----------SSQ-------------E------------------------?------------SSSSSS------------------------SSSS----------------XXXX----SSQ--------------------------------------QQQQ------------------------?--E--------SSSSSSS---------Q-Q----S--------------------?--------------SSS----------?Q?Q------------SQS---------?-?-SSS---------------------QQ---------------QQ------------------------------------------------------SS----------------------------------------------------SSSS-------------------------SSS---------------XXXX----SSSSS---------QQQSS-----------------------Q-Q-------------------------?-?Q------------SSS-----------------------SSSSS
--------------------------------------------------------------------------------------------------------------------------------------------------------------------------------------------------------------------------------------------------------------------------------------------------------------------------------------------------------------------------XX------------------------------------------XX------------------------------------------------------XX-------------------------------------------------------------------X--------------X---------------------------X---------------------------------------------------------------------------------------------------------------X-----------------------------------------------------------------------------------X------------------------X--XX---o------XX-------------------------------------------------------------------------------------------------------o-----------------------------------------------XXXXX----------------------------------------------------------------------------------XX-----------------------------------------------------------------------------------------------------------------------------------------------------------------------------------------------------------------------------------------------------------------------------------------------------------------XXX----------------------------------------
----------------------------------------------------------E------<>-------------------------------------------------------------------------------------------------------------------------------------------------------------------------------------------XX----------------------------------------------------------------------------------------------------------------X-----------------------------------------------------E---------------------------------------Q---------------------------------------------------------------------------------------X-------------------------------------------------------------------------------------------------------------------------------------------------------------------------------------X---------------------------------------------------------------------XXX-XX----------------------------------------------------------------------------------------------------------XXXXXXXX-X------------------------------------------------------------------------------------------------------------------------------------------------------------------------------------------------------------------------------X-------------------------------------------------------------------------------------------------------------------------------------------------------------------------------------------------------------------------------------------------------------
----E-----------------------------------------E----------<>------[]----------------------o----------------------------------------------------E---------------E--S--------E------------------E----------------------------------------------------E------------------------------E----------E----------------E--------------------------------------E----------------E---------------------------E--------E--------------------------<>------------------E--------E------------------E-------<>------------------E------------E--------------E--------E---E--------------E---------------------------E------------------------E-----E------------------------E--------E--<>---------------------------------------------E------------------------E--------E---------------------------E------------------E------------E-----------------------E---E-----------E---------------------------E-----E---------------------E---------------E---------------------------E--------------E--?-----E---------------E-----E--?------E--------------E--------E---------------------------E-E----------------E--------E------------------E--------E---------------E--E------------------------------EXX-----------------------------------------------E-----------E---------------E---------------------------E-----------E---------------E--S---------------------------E------------------------------------E-E-------------------------E---------------E-----E---
--E<>--E?SQQ---------------------------------<>----------[]------[]------E---------------------------<>-------XX--E---E----------<>-----E----<>----E-QQ------<>-----E----<>--<>-------------<>------oo-----Q-QQ--------------------<>---QQ-------<>-----E--S---<>---?S-------E--<>---------<>--E?SQQQ-------<>----------E----Q--------------E-----E<>--E?SQQQ-------<>----QQ-------Q--QQQ-------<>-------<>----E?SQQQ------------QQQ-[]---E??SQQQ-------<>---QQQ-<>--<>--SQQQ-------<>-------[]----E?S----------<>--------E--<>---QQQQ---Q--<>---QQQ-<>--<>--SQQQ-------<>---QQQ--E--<>--QQQQ----<>-<>---QQQ--E------S-------<>----<>--S-------------E------<>-------<>--[]---QQQQ---Q-------QQQ--E---E---QQQ----------<>----------Q-QQ---------<>---QQQ-<>----Q--Q----------S-------<>---E--SQQQ-------<>---QQQ--E-E<>--SQQQ-------<>-------<>--<>-------Q--<>-------?S-----------------<>----<>--------------------<>-----------E--<>---QQQQ-------------------<>--QQQQQ------<>----QQ-<>---E--S-------<>----<>-----E--<>---QQQ-------<>----QQ-<>----E-S-------------------<><>--E?SQQQ-------<>-------<>----E-SQQQ----Q--<>---QQQ-<>----E?Q-------<>-<>---QQQ-----------------------<>XX---------------Q---------------E--------------<>----------<>--------------<>------E-------------------<>-----E--S-<>--------------<>-----E------------QQQQ-------<>-------------Q--QQQQ-------------Q-<>---E---QQQ----------------<>------S-------<>----<>---
-<>[]----------------------------------------[]----------[]------[]-----<>---------------------------[]-------XX-<>--<>----------[]----<>----[]--------------[]----<>----[]--[]-------------[]-------------------------------------[]------------[]----<>------[]-----------<>--[]---------[]---------------[]---------<>------------------<>----<>[]---------------[]---------oo---------------[]-------[]--------------------------[]--<>-------------[]-------[]--[]-------------[]-------[]-----------------[]-<>----<>--[]-------------[]-------[]--[]-------------[]-------<>--[]----------[]-[]-------<>--------------[]----[]----<>---------<>---E--[]-------[]--[]----------------------<>--<>----------------[]-----------------------[]-------[]--------------------------[]--<>-------------[]-------<><>[]-------------[]-------[]--[]----------[]--------------------------[]----[]--------------------[]----------<>--[]-----------------------E--[]-------------[]-------[]--<>----------[]----[]----<>--[]-------------[]-------[]------------------E-------[][]---------------[]-------[]<>---------------[]-------[]--------------[]-[]-------XX--------------------[]XXX-----------------------------<>--------------[]----------[]--------------[]--E-----------------------[]----<>----[]--------------[]----<>-----E-----------------[]--------E<>------------------------[]---------------------E----[]--------------[]----[]---
-[][]-----------------<>---------------------[]----<>----[]------[]-----[]---------------------------[]---E---XX-[]--[]----------[]----[]----[]--------------[]----[]----[]--[]-------------[]-----------------------------------<>[]------------[]----[]----<>[]-----------[]--[]-------<>[]---------------[]---------[]------------------[]----[][]---------------[]--------------------------[]-------[]-----------------<>-------[]--[]-------------[]-------[]--[]-------------[]-------[]-----------------[]-[]----[]--[]-------------[]-------[]--[]-------------[]-------[]--[]----------[]-[]-------[]--------------[]----[]----[]---------[]--<>--[]-------[]--[]----------------------[]--[]----------------[]----<>-----------------[]-------[]--------------------------[]--[]-------------[]-------[][][]-------------[]-------[]--[]----------[]--------------------------[]----[]----<>--------------[]----------[]--[]----------------------<><>[]-------------[]-------[]--[]----------[]----[]----[]--[]-------------[]-------[]-----------------<>-------[][]---------------[]-------[][]---------------[]-------[]--------------[]-[]------XXX--------------------[]XXX-----------------------------[]--------------[]-<>-------[]--------------[]-<>-----------------------[]----[]----[]--<>----------[]----[]----<>-----------------[]-------<>[]------------------------[]--------------------<>----[]--------------[]----[]---
-[][]---------E-EE----[]---------EE-EE-E--E--[]----[]----[]------[]---E-[]----EE-E----------------E--[]----E--X--[]--XX------EE-E[]-E--[]----[]-----------E--[]----[]----[]--[]-------EE-E--[]-E-E----------------EE------EE-----[][]------E--E--[]----[]----[]SS-E-------E-[]--[]-------[][]---------E--E--[]-E-E-----[]--------E--E------[]----[][]---------E-EE--[]-E--E---------------E-EE--[]-E-E---[]-----------E-EE--[]-------[]--[]-------E-E---[]----E--[]--[]------EE-EE--[]-------[]-----E--E--E-----[]-[]----[]--[]-------E-EE--[]----E--[]--[]-------E-E---[]-E-----[]--[]-------E--[]-[]-------[]--------E--E--[]-E--[]----[]--EE-----[]--[]--[]-------[]--[]-------E-EE-----------[]--[]------EE-E--E---[]----[]---------E-EE----[]-------[]--------E-EE-EE-----------[]--[]-------E--E--[]-------[][][]------EE-E---[]-------[]--[]---EE-----[]-----------------------E--[]----[]----[]------E----E--[]----------[]--[]------EE-E-----E------[][][]------EEE----[]-------[]--[]---EE--E--[]-E--[]----[]--[]-------EE----[]-E--E--[]-----------E-EE--[]-E-EE--[][]---------E-EE--[]-E-----[][]--------EE-EE--[]-------[]--------E--E--[]-[]------XXX----------EE--------[]XXX----------EE-E---E-EE--------[]----------EE--[]-[]-------[]-------EEE----[]-[]-----------------E--E--[]----[]----[]--[]---EE--E--[]----[]----[]-----------EE----[]-E-EE--[][]--------EE-E------EE-E--[]-Q-E------EE-EE-----[]----[]-------EE--E--[]----[]---
-XXXXXXXXXXXXXXXXXXXXXXXXXXXXXXXXXXXXXXXXXXXXXXXXXXXXXXX-XXXXXXXXXXXXXXXXXXXXXXXXXXXXXXXXX-XXXXXXXXXXXXXXXXXXXXXXXXXXXXXXXXXXXXXXXXXXXXXXXXX-XXXXXXXXXXXXXXXXXXXXXXXXXXXXXXXXXXXXXXXXXXXXXXXXXXXXXXXXXXXXXXXXXXXXXXXXXXXXXXXXXXX-XXXXXXXXXXXXXXXXXXXXXXXXXXXXXXXXXXXXXXXXXXXXXXXXXXXXXXX-XXXXXXXXXXXXXXXXXXXXXXXXXXXXXXXXX-XXXXXXXXXXXXXXXXXXXX--XXXXXXXXXXXXXXXXXXXXXXXXXXXXXXXXXXXXXXXXXXXXXXXXXXXXXXX-XXXXXXXXXXXXXXXXXXXXXXXXXXX-XXXXXXXXXXXXXXXXXXXXXXXXXXXXXXXXXXXXXXXXXXXXXXXXXXXXXXX-XXXXXXXXXXXXXXXXXXXXXXXXXXX-XXXXXXXXXXXXXXXXXXXXXXXXXXX-XXXXXXXXXXXXXXXXXXXXXXXXXXXXXXXXXXXXXXXXXXXXXXXXXXXXXXX-XXXXXXXXXXXXXXXXXXXXXXXXXXXXXXXXXXXXXXXXXXXXXXXXXXXXXXXXXXXXXXXXXXXXXXXXXXXXXXXXXXX-XXXXXXXXXXXXXXXXXXXXXXXXXXX-XXXXXXXXXXXXXXXXXXXXXXXXXXX-XXXXXXXXXXXXXXXXXXXXXXXXXXX-XXXXXXXXXXXXXXXXXXXXXXXXXXX-XXXXXXXXXXXXXXXXXXXXXXXXXXXXXXXXXXXXXXXXXXXXXXXXXXXXXXXXXXXX---XXXXXXXXXXXXXXXXXXXX-XX--XXXXXXXXXXXXXXXXXXXXXXXXXXXXXXXXXXXXXXXXXXXXXXXXXXX-XXXXXXXXXXXXXXXXXXXXXXXXXXX-XXXXXXXXXXXXXXXXXXXXXXXXXXX-XXXXXXXXXXXXXXXXXXXXXXXXXXX-XXXXXXXXXXXXXXXXXXXXXXXXXXX-XXXXXXXXXXXXXXXXXXXXXXXXXXXXXXXXXXXXXXXXXXXXXXXXXXXXXXX-XXXXXXXXXXXXXXXXXXXXXXXXXXXXXXXXX---XXXXXXXXXXXXXXXXXX-XXX-X-XXXXXXXXXXXXXXXXXXXXXX-XXXXXXXXXXXXXXXXXXXXXXXXXXX-XXXXXXXXXXXXXXXXXXXXXXXXXXXXXXX----XXXXXXXXXXXXXXXXXXXX-XXXXXXXXXXXXXXXXXXXXXXXXXXX-XXXXXXXXXXXXXXXXXXXXXXXXXXXXXXXXXXXXXXXXXXXXXXXXXXXXXXXXXXXXXXXXXXXXXXXXXXXXXXXXXXX-XXXXXXXXXXXXXXXXXXXXXXXXXXX
