--------------------------------------------------------------------------------------------------------------------------------------------------------------------------------------------------------------------------------------------------------------------------------------------------------------------------------------------------------------------------------------------------------------------------------------------------------------------------------------------------------------------------------------------------------------------------------------------------------------------------------------------------------------------------------------------------------------------------------------------------------------------------------------------------------------------------------------------------------------------------------------------------------------------------------------------------------------------------------------------------------------------------------------------------------------------------------------------------------------------------------------------------------------------------------------------------------------------------------------------------------------------------------------------------------------------------------------------------------------------------------------------------------------------------------------------------------
---------------------------------------------------------------------------------------------------------------------------------------------------------------------------------------------------------------------------------------------------------------------------------------------------------------------------------------------------------------------------------------------------------------------------------------------------------------------------------------------------------------------------------------------------------------------------------------------------------------------------------------------------------------------------------------------------------------------------------------------------------------------------------------------------------------------------------------------------------------------------------------------------------------------------------------------------------------------------------------------------------------------------------------------------------------------------------------------------------------------------------------------------------------Q-------------------------------------------------------------------------------------------------------------Q-Q-----------------------------------------------------------------------------------Q------------------------------------------------------------------------------------
---------------------------------------------------------------------------------------------------------------------------------------------------------------------------------------------------------------------------------------------------------------------------------------------------------------------------------------------------------------------------------------------------------------------------------------------------------------------------------------------------------------------------------------------------------oo---------------------------------------------------------------------------------------------------------------------------------------------------------------------------------------------------------------------------------------------------------------------------------------------------------------------------------------------------------------------------------------------------------------------------------------------------------------------------------------------------------------------------------------------------------------------------------------------------------------------------------------------------------------------------------------------------------------------------------------------------------------------------------------------------------------------------------------------------------------------------------------------
------------------------------------------------------------------------------------------------------------------------------------------------------------------------------------------------------------------------------------------------------------------------------------------------------------------------------------------------------------------------------------------------------------------------------------------------------------------------------------------------------------------------------------------------------X-XXXX--------------------------------------------------------------------------------------------------------------------------------------------------------------------------------------------------------------------------------------------------------------------------------------------------------------------------------------------------------------------------------------------------------o-----------------------------------------------------------------------------------------------------------------------------------------------------------------------------------------------------------------------------------------------------------------------------------------------------------------------------------------------------------------------------------------------------------------------------------------------------------------------------------
--------------------------------------------------------------------------------------------------------------------------------------------------------------------------------------------------------------------------------------------------------------------------------------------------------------------------------------------------------------------------------------------------------------------------------------------------------------------------------------------------------------------------------------------------------------------------------------------------------------------------------------------------------------------------------------------------------------------------------------------------------------------------------------------------------------------------------------------------------------------------------------------------------------------------------------------------------------------------------------------------------------------------------------------------------------------------------------------------------------------------------------------------------------------------------------------------------------------------------------------------------------------------------------------------------------------------------------------------------------------------------------------------------------------------------------------------------
-------?-Q---------------SSSo------QQQQQ-------------------------?-?Q----------------------?-QQ?Q--------SSSSSS------------------------------------------------------------------------------SS--SSS-----------------------SSSS--------------------------------------SS?SSSS-QQQ------------------------------------------------------------SSSQ-------------------------SS------------Q-------------------------------------------Q---------?--E------------SSS-------------------------SSS-------------------------SSS---------------------SSSSSSQ---------?--E---------QSSSS--------------------------------------Q-?-SSSS------------------?-?--E------------------------?-?QSSS---------SQ-----------------------------------------------------SSQQ------------------------SSSS---------?Q?QS---------SSSSS---------Q--E------------SQQ---------?--E------------------------?--E--------SSSSSSS-----------Q-------------QQQ---------?-Q-------------------------QQQQ------------------------?-QE------------------------Q--E------------SSS---------Q-QQ-----------SSSS------------E---------SSSSSS---------?--E--------SQSSSS--------------------------SQQ---------?--E--------SSSS------------QQQ------------SSS---------------SSS-----Q-SSSS---------Q-Q------------SSSS---------QQQQ-----------SSQQ---------Q-Q-------------------------?--E------------SQS------------E------------SSS---------Q--Q--S-------SSSSS-----------S----------------
--E------------------------------------------------------------------XXX--------------------------XXX---------------------------------------------------------------------------------------------------------------------------------------------------------------------------------------------------------------------------------------------------------------------------------------------------------------------------------------------XX-----------------------------------------------------------------------------------------------------------XXXXX----------------------------------------------------------------------------------X--------------------------XXX--------------------------------------------------------------------------------------------------------------XX---------------------------------------------------XXXXX--------------------------X------------------------------------------------------------o------XX--------------XX--------------------------XX------------------------------------------------------XX-----------------------------------------------------------------------------------------------------------XXXXX--------------------------------------------------------------------------------------------------------------X---------------------------------------------------------------------------------------------------------------XX----------------------------------------
-<>-------------------------------------------------------------------------------------------------------------------------------------------X-------------------------------------------------------------------------------------------------------------------------------------------------------------------------------------------------------------------------------------------------------------------------------------------------------------------------------------------------------------------------------------------------------------------------------------------------------------------------------------------E------------------------------------------------------------------------XX-----------------------------------------------------------------------------------------------------------------------------------------------------------------------------------------------------------------------------XXX---------------------Q---------------------------------------------------------------------------------------------------------------------------------------------------------------------------------------------------Q-------------------------------------------------------------------------------------------------------------------------------------------------------------------------------------------------------------------------------Q-----------------------------------------
-[]---------------E--E---------------------------E-----------<>--------------E--------E-------------------------------------------------------E-------------------------------E-----------E---------------------------------E---------------------------------E-----------------------------E-------------------E---------------------E-----------E----------------------------------------------E--------E---------------E-----------E---------------E-----E-----E---------------E-------------o-------------E-----E-------------------------------------E-------------------------E--------------------------------------------E-------<>---------------E---------------E--------------E------------E---------------------------------------E--E--------E---------------E-----------E---------------------------E---------------E---------------E-----------------------E---------------E-----E------------------------E------------E------------------------------------------E---------------------------E--------E---------------E---------------------------E--E------------E-----------E-----------E---E-----------E-----------E---------------E---------------E------------------------------------------E--?---------E--------------E--------E---------------E------------------------------E------------E--------------E--------E---------------E-------------E-------------E--S------------E--------------E-----------------------E-----E----
-[]-X--E?--------<>-<>--E------<>--QQQQQQ-------<>--------E--[]---QQQ----Q--<>---QQQ-<>----E?SQ-------------------------------------Q----Q-Q-<>------------------------------<>----------<>--------S------------------E----<>--------------------------------<>--X-----Q-----QQQ----------E<>----S----------E--<>--------------------<>------E?S-<>---------------------------E---E----QQ-------<>-----Q-<>--<>---QQQQ---<>----------<>-----?S-------<>----<>----<>--------------<>-----E-----E--------------<>----<>-----E---E----------<>--S---SSS--E--<>---QQQQ-------S-----?--E<>-------------------------E----E--QQQQ------<>---QQQ-[]----S?S-------<>-----------E--<>--S-Q--------<>---QQQ----E<>---QQQ-----------------E--------------<>-<>---E---<>--------------<>--------S-<>--<>--SSQQ----------------<>----E?SQQQ----<>-----------E-E<>---QQQQ---------------<>------S-------<>----<>-----------------------<>---QQQ--E--<>---QQQQ------<>-----Q--E---E--SQQQQ------<>----QQ--E<>----SQQQ----Q--<>-------<>---E--SQQQ----<>--------?--E--<>--SQQQ----<>-<>--------E-E<>--QQQQ----<>-----E----<>--<>---Q------<>------Q??-<>----E?Q-------<>------E?S-----<>--S--------------------E----E?SQQQ-------<>--------E--<>---Q---------<>-------<>----E-QQ------<>-----------E---E--SQQQ----Q--<>---QQQ--E--<>---QQQ-------<>---QQQ-<>-----?S-------<>-------Q?--E<>----Q-------<>-----E-----E--<>---QQQQ------<>----Q---E-------------<>----<>----
-[]--------------[]-[]-<>------[]---------------[]-------<>--[]-------------[]-------[]------------------------------------------------------[]--------------------E---------[]----------[]--------------------------<>----[]----E---------------------------[]--X-----------------------<>[]-----------E--<>--[]--------------------[]----------[]--------------------------<>--<>-------------[]-------[]--[]----------[]-----E----[]--------------[]----[]----[]--------------[]----<>----<>--------------[]----[]----<>--<>----------[]----------<>--[]----------------------<>[]------------------------<>-----------------[]-------[]--------------[]-----E----<>--[]-------------[]--------E<>[]----------------------<>--------------[]-[]-------[]--------------[]--E-------[]--[]----------------------[]-E------------[]----------<><>[]----------------------[]--------------[]----[]-----E-----------------[]-------<>--[]-------------[]-------<><><>-------------[]-------<>[]---------------[]-------[]--<>----------[]----------<>--[]----------[]-[]--E----<><>[]----------[]----<>----[]--[]----------[]----------[]--------------[]--E--E--------[]----------------------<><>---------------[]-------<>--[]-------------[]-------[]--------------[]----------<>--<>-------------[]-------<>--[]-------------[]-------[]--------------[]--E-------<>[]------------[]----<>----<>--[]-------------[]-------<>-------------[]----[]----
-[]--------------[]-<>-[]------[]---------------[]---Q?S-[]--[]-------------[]-------[]---------------------------------------------<>-------[]-------------<>----<>------E--[]----------[]--------------------------[]----[]-----o--------------------------[]--X----------------<>-----[][]----------<>--[]--[]----<>--------------[]----------[]-----------------<>-------[]--[]-------------[]-------[]--[]----------[]----<>----[]--------------[]----[]----[]--------------[]-<>-[]----[]--------------[]----[]----[]--[]----------[]----------[]--[]----------------------[][]------------------------[]-----------------[]-------[]--------------[]----<>----[]--[]-------------[]-------<>[][]--------------------X-[]--------------[]-[]-------[]--------------[]-<>-------[]--[]---------------<>-----[][]------------[]-<>-------[][][]----------------------[]--------------[]----[]----<>-----------------[]-------[]--[]-------------[]-------[][][]-------------[]-------[][][]-------------[]-------[]--[]----------[]-<>-------[]<>[]----------[]-[]-<>----[][][]----------[]----[]----[]--[]----------[]-<>-------[]--------------[]-<>-<>--------[]----------------------[][]---------------[]-------[]--[]-------------[]-------[]--------------[]-X--------[]--[]-------------[]-------[]--[]-------------[]-------[]--------------[]-<>-------[][]------------[]----[]----[]--[]-------------[]-------[]-------------[]----[]----
-[]-------EE-E---[]-[]-[]------[]---------EE----[]-E-----[]-E[]------EE-E---[]-------[]----------EE-E--E--------------EE------------[]-------[]--E-E------E-[]----[]---------[]----E-E---[]-----------------E---E-E--[]----[]-----------------EE-E-----E--E--[]--X-----------E----[]-----[][]--------E-[]--[]--[]----[]--------E-----[]----------[]--EE-----E-E-----[]-E-----[]--[]-------EE-E--[]-E-EE--[]--[]----E-EE-E[]----[]----[]----------EE--[]-E--[]----[]-------EE-----[]-[]-[]----[]-------EE--E--[]----[]----[]-E[]------E---[]---E------[]--[]------EE-EE-EE--------[][]---------E-E------------[]-----------E-EE--[]-E--E--[]-----E-----E--[]----[]----[]--[]------EE-----[]-------[][][]------EE-E----E----XX-[]------E-EE-EE-[]-[]-------[]--------E--E--[]-[]-------[]--[]----E--E-EE-E--[]-----[][]---------E--[]-[]-------[][][]------EE-E----E-------[]-------EE-----[]-E--[]----[]-----------E-EE--[]-------[]-E[]------EE-EE--[]--E-E--[][][]-------E-EE--[]-E--E--[][][]------EE-E---[]-------[]--[]-------E--[]-[]-------[][][]-------E--[]-[]-[]----[][][]------EE--[]----[]-X--[]--[]----E--E--[]-[]-------[]-----------E--[]-[]-[]-----E--[]------E--E--E---------[][]---------E-----[]----E--[]-E[]----E---E----[]-------[]--------E--E--[]-X--------[]--[]-------E-EE--[]-------[]--[]-------E-EE--[]--E-E--[]-----E-----E--[]-[]-------[][]--------EE--[]----[]----[]--[]------EE--E--[]-------[]--E------E---[]----[]----
-XXXXXXXXXXXXXXXXXXXXXXXXXXXXXXXXXXXXXXXXXXXXXXXXXXXXXXX-XXXXXXXXXXXXXXXXXXXXXXXXXXXXXXXXXXXXXXXXXXXXXXXXXXXXXXXXXXXXXXXXXXXXX---XXXXXXXXXXXXXXXXXXXXXXXXXXXXXXXXXXXXXXXXXXXXXXXXXXXXXXXXXXXXXXXXXXXXXX-XXXXXXXXXXXXXXXXXXXXXXXXXXXX-X---XXXXXXXXXXXXXXXXXXX-XX--XXXXXXXXXXXXXXXXXXXXXXX-XXXXXXXXXXXXXXXXXXXX--XXXXX-XXXXXXXXXXXXXXXXXXXXXXXXXXXXXXXXXXXXXXXXXXXXXXXXXXXXXXX-XXXXXXXXXXXXXXXXXXXXXXXXXXX-XXXXXXXXXXXXXXXXXXXXXXXXXXX-XXXXXXXXXXXXXXXXXXXXXXXXXXX-XXXXXXXXXXXXXXXXXXXXXXXXXXX-XXXXXXXXXXXXXXXXXXXXXXXXXXXXXXXXXXXXXXXXXXXXXXXXXXXXXXX-XXXXXXXXXXXXXXXXXXXXXXXXXXX-XXXXXXXXXXXXXXXXXXXXXXXXXXX-XXXXXXXXXXXXXXXXXXXXXXXXXXX-XXXXXXXXXXXXXXXXXXXXXXXXXXXXXXXXXXXXXXXXXXXXXXXXXXXXXXXXXXXXXXXXXXXXXXXXXXXXXXXXXXX-XXXXXXXXXXXXXXXXXXXXXX-XX-X-XXXXXXXXXXXXXXXXXXXXXXXXXXX-XXXXXXXXXXXXXXXXXXXXXXXXXXX-XXXXXXXXXXXXXXXXXXXXXXXXXXX-XXXXXXXXXXXXXXXXXXXXXXXXXXX-XXXXXXXXXXXXXXXXXXXXXXXXXXX-XXXXX--XXXXXXXXXXXXXXXXXXXX-XXXXXXXXXXXXXXXXXXXXXXXXXXX-XXXXXXXXXXXXXXXXXXXXXXXXXXX-XXXXXXXXXXXXXXXXXXXXXXXXXXX-XXXXXXXXXXXXXXXXXXXXXXXXXXXXXXXXXXXXXXXXXXXXXXXXXXXXXXXXXXXXXXXXXXXXXXXXXXXXXXXXXXX-XXXXXXXXXXXXXXXXXXXXXXXXXXX-XXXXXXXXXXXXXXXXXXXXXXXXXXXXXXXXXXXXXXXXXXXXXXXXXXXXXXX-XXXXXXXXXXXXXXXXXXXXXXXXXXX-XXXXXXXXXXXXXXXXXXXXXXXXXXX-XXXXXXXXXXXXXXXXXXXXXXXXXXXXXXXXXXXXXXXXXXXXXXXXXXXXXXXXXXXXXXXXXXXXXXXXXXXXXXXXXXX-XXXXXXXXXXXXXXXXXXXXXXXXXXX-XXXXXXXXXXXXXXXXXXXXXXXXXXX-XXXXXXXXXXXXXXXXXXXXXXXXXXX-XXXXXXXXXXXXXXXXXXXXXXXXXXX
